time,id,sentvn,mypparent,pparentrank,children,sentDIS,sentDIO,generatedDAO,forwardedDAO,generatedNPDAO,forwardedNPDAO,ttlsent,receivedDIS,receivedDIO,receivedDAO,ttlrcvd,total_energy,attack
120.96,8,240 ,1 ,256 ,0 ,1 ,5 ,3 ,0 ,0 ,0 ,9 ,0 ,12 ,1 ,13,142 , 0 
121.078,11,240 ,5 ,823 ,0 ,1 ,4 ,3 ,2 ,1 ,1 ,12 ,1 ,16 ,4 ,21,193 , 0 
121.124,2,240 ,1 ,256 ,0 ,1 ,5 ,4 ,16 ,0 ,1 ,27 ,0 ,23 ,18 ,41,159 , 0 
121.138,6,240 ,2 ,512 ,0 ,1 ,6 ,5 ,5 ,1 ,1 ,19 ,1 ,15 ,6 ,22,336 , 0 
121.214,18,240 ,19 ,512 ,0 ,1 ,4 ,2 ,0 ,0 ,0 ,7 ,1 ,13 ,0 ,14,115 , 0 
121.236,4,240 ,19 ,512 ,0 ,1 ,5 ,2 ,0 ,1 ,0 ,9 ,1 ,11 ,0 ,12,121 , 0 
121.289,7,240 ,16 ,933 ,0 ,1 ,5 ,6 ,0 ,1 ,0 ,13 ,0 ,13 ,0 ,13,155 , 0 
121.337,14,240 ,1 ,256 ,0 ,1 ,5 ,4 ,2 ,0 ,0 ,12 ,1 ,20 ,2 ,23,133 , 0 
121.35,15,240 ,11 ,1049 ,0 ,1 ,7 ,2 ,1 ,3 ,1 ,15 ,1 ,9 ,2 ,12,234 , 0 
121.359,20,240 ,5 ,829 ,0 ,1 ,4 ,4 ,0 ,0 ,0 ,9 ,2 ,8 ,0 ,10,163 , 0 
121.36,16,240 ,2 ,512 ,0 ,1 ,8 ,5 ,5 ,2 ,0 ,21 ,0 ,14 ,5 ,19,333 , 0 
121.459,10,240 ,14 ,649 ,0 ,1 ,5 ,3 ,0 ,0 ,0 ,9 ,1 ,8 ,0 ,9,130 , 0 
121.481,12,240 ,5 ,829 ,0 ,1 ,4 ,3 ,0 ,0 ,0 ,8 ,2 ,12 ,0 ,14,149 , 0 
121.596,9,240 ,5 ,823 ,0 ,1 ,6 ,3 ,0 ,0 ,0 ,10 ,1 ,18 ,2 ,21,204 , 0 
121.603,5,240 ,13 ,558 ,0 ,1 ,4 ,5 ,12 ,1 ,1 ,24 ,1 ,23 ,14 ,38,258 , 0 
121.606,19,240 ,1 ,256 ,0 ,1 ,5 ,4 ,4 ,0 ,0 ,14 ,1 ,26 ,4 ,31,133 , 0 
121.696,17,240 ,6 ,1263 ,0 ,1 ,4 ,4 ,0 ,0 ,0 ,9 ,0 ,13 ,0 ,13,128 , 0 
121.771,13,240 ,1 ,256 ,0 ,1 ,5 ,4 ,17 ,1 ,1 ,29 ,0 ,12 ,19 ,31,191 , 0 
121.786,3,240 ,1 ,256 ,0 ,1 ,5 ,3 ,0 ,0 ,0 ,9 ,0 ,9 ,0 ,9,112 , 0 
240.959,8,240 ,1 ,256 ,0 ,0 ,3 ,0 ,0 ,0 ,0 ,3 ,0 ,4 ,0 ,4,81 , 0 
241.077,11,240 ,5 ,863 ,0 ,0 ,3 ,1 ,2 ,0 ,0 ,6 ,0 ,9 ,2 ,11,87 , 0 
241.123,2,240 ,1 ,256 ,0 ,0 ,2 ,0 ,3 ,0 ,0 ,5 ,0 ,8 ,3 ,11,85 , 0 
241.137,6,240 ,2 ,512 ,0 ,0 ,2 ,0 ,1 ,0 ,0 ,3 ,0 ,5 ,1 ,6,73 , 0 
241.213,18,240 ,19 ,512 ,0 ,0 ,2 ,0 ,1 ,0 ,0 ,3 ,0 ,9 ,1 ,10,79 , 0 
241.235,4,240 ,19 ,531 ,0 ,0 ,3 ,1 ,0 ,0 ,0 ,4 ,0 ,3 ,0 ,3,73 , 0 
241.289,7,240 ,16 ,993 ,0 ,0 ,2 ,1 ,0 ,0 ,0 ,3 ,0 ,5 ,0 ,5,65 , 0 
241.337,14,240 ,1 ,256 ,0 ,0 ,2 ,0 ,2 ,0 ,0 ,4 ,0 ,4 ,2 ,6,75 , 0 
241.349,15,240 ,11 ,1193 ,0 ,0 ,3 ,2 ,0 ,0 ,0 ,5 ,0 ,3 ,0 ,3,74 , 0 
241.359,20,240 ,5 ,863 ,0 ,0 ,3 ,1 ,0 ,0 ,0 ,4 ,0 ,7 ,0 ,7,81 , 0 
241.36,16,240 ,2 ,512 ,0 ,0 ,1 ,0 ,1 ,0 ,0 ,2 ,0 ,5 ,1 ,6,72 , 0 
241.443,10,240 ,14 ,635 ,0 ,0 ,2 ,1 ,0 ,0 ,0 ,3 ,0 ,2 ,0 ,2,60 , 0 
241.481,12,240 ,18 ,790 ,0 ,0 ,6 ,2 ,0 ,1 ,0 ,9 ,0 ,7 ,0 ,7,116 , 0 
241.595,9,240 ,5 ,863 ,0 ,0 ,1 ,1 ,0 ,0 ,0 ,2 ,0 ,8 ,0 ,8,84 , 0 
241.602,5,240 ,13 ,529 ,0 ,0 ,2 ,1 ,6 ,1 ,1 ,11 ,0 ,14 ,7 ,21,101 , 0 
241.606,19,240 ,1 ,256 ,0 ,0 ,3 ,0 ,2 ,0 ,0 ,5 ,0 ,9 ,2 ,11,75 , 0 
241.696,17,240 ,6 ,1168 ,0 ,0 ,2 ,1 ,0 ,0 ,0 ,3 ,0 ,3 ,0 ,3,67 , 0 
241.771,13,240 ,1 ,256 ,0 ,0 ,2 ,0 ,7 ,1 ,1 ,11 ,0 ,6 ,9 ,15,80 , 0 
241.786,3,240 ,1 ,256 ,0 ,0 ,1 ,0 ,0 ,0 ,0 ,1 ,0 ,3 ,0 ,3,67 , 0 
360.96,8,240 ,1 ,256 ,0 ,0 ,1 ,1 ,0 ,0 ,0 ,2 ,0 ,3 ,0 ,3,203 , 0 
361.077,11,240 ,5 ,825 ,0 ,0 ,1 ,1 ,0 ,0 ,0 ,2 ,0 ,7 ,0 ,7,264 , 0 
361.123,2,240 ,1 ,256 ,0 ,0 ,2 ,1 ,8 ,0 ,1 ,12 ,0 ,4 ,9 ,13,241 , 0 
361.138,6,240 ,2 ,512 ,0 ,0 ,1 ,2 ,1 ,0 ,1 ,5 ,0 ,6 ,2 ,8,420 , 0 
361.213,18,240 ,19 ,512 ,0 ,0 ,2 ,0 ,1 ,0 ,0 ,3 ,0 ,3 ,1 ,4,188 , 0 
361.235,4,240 ,19 ,531 ,0 ,0 ,1 ,0 ,0 ,0 ,0 ,1 ,0 ,3 ,0 ,3,178 , 0 
361.289,7,240 ,16 ,930 ,0 ,0 ,3 ,1 ,0 ,0 ,0 ,4 ,0 ,10 ,0 ,10,231 , 0 
361.337,14,240 ,1 ,256 ,0 ,0 ,1 ,1 ,0 ,0 ,0 ,2 ,0 ,5 ,0 ,5,192 , 0 
361.35,15,240 ,11 ,1193 ,0 ,0 ,1 ,0 ,0 ,0 ,0 ,1 ,0 ,6 ,0 ,6,295 , 0 
361.359,20,240 ,5 ,825 ,0 ,0 ,1 ,1 ,0 ,0 ,0 ,2 ,0 ,4 ,0 ,4,240 , 0 
361.36,16,240 ,2 ,512 ,0 ,0 ,3 ,1 ,4 ,0 ,0 ,8 ,0 ,11 ,4 ,15,453 , 0 
361.443,10,240 ,14 ,635 ,0 ,0 ,3 ,0 ,0 ,0 ,0 ,3 ,0 ,0 ,0 ,0,190 , 0 
361.481,12,240 ,18 ,787 ,0 ,0 ,2 ,1 ,0 ,0 ,0 ,3 ,0 ,2 ,0 ,2,220 , 0 
361.595,9,240 ,16 ,913 ,0 ,0 ,6 ,2 ,0 ,1 ,0 ,9 ,0 ,4 ,0 ,4,319 , 0 
361.602,5,240 ,13 ,529 ,0 ,0 ,2 ,0 ,2 ,1 ,1 ,6 ,0 ,6 ,3 ,9,352 , 0 
361.606,19,240 ,1 ,256 ,0 ,0 ,1 ,1 ,1 ,0 ,0 ,3 ,0 ,5 ,1 ,6,197 , 0 
361.696,17,240 ,16 ,949 ,0 ,0 ,5 ,2 ,0 ,1 ,0 ,8 ,0 ,4 ,0 ,4,223 , 0 
361.771,13,240 ,1 ,256 ,0 ,0 ,2 ,1 ,2 ,1 ,1 ,7 ,0 ,3 ,4 ,7,276 , 0 
361.786,3,240 ,1 ,256 ,0 ,0 ,3 ,1 ,0 ,0 ,0 ,4 ,0 ,2 ,0 ,2,185 , 0 
480.96,8,243 ,1 ,256 ,0 ,0 ,6 ,2 ,3 ,2 ,2 ,15 ,0 ,11 ,6 ,17,254 , 0 
481.078,11,242 ,9 ,1685 ,0 ,0 ,5 ,2 ,3 ,2 ,1 ,13 ,0 ,13 ,6 ,19,328 , 0 
481.123,2,250 ,1 ,256 ,0 ,0 ,8 ,3 ,3 ,4 ,3 ,21 ,0 ,13 ,15 ,28,388 , 0 
481.138,6,250 ,2 ,512 ,0 ,0 ,5 ,2 ,4 ,4 ,3 ,18 ,0 ,15 ,8 ,23,370 , 0 
481.214,18,243 ,19 ,512 ,0 ,0 ,4 ,2 ,1 ,3 ,1 ,11 ,0 ,10 ,3 ,13,276 , 0 
481.235,4,243 ,19 ,512 ,0 ,0 ,8 ,4 ,0 ,4 ,0 ,16 ,0 ,8 ,0 ,8,388 , 0 
481.289,7,253 ,16 ,65535 ,0 ,0 ,7 ,0 ,0 ,1 ,0 ,8 ,0 ,11 ,13 ,24,204 , 1 
481.337,14,251 ,1 ,256 ,0 ,0 ,7 ,3 ,2 ,5 ,2 ,19 ,0 ,12 ,6 ,18,359 , 0 
481.35,15,250 ,7 ,1429 ,0 ,0 ,5 ,1 ,0 ,2 ,0 ,8 ,0 ,11 ,0 ,11,218 , 0 
481.359,20,243 ,5 ,768 ,0 ,0 ,4 ,4 ,0 ,5 ,0 ,13 ,0 ,9 ,0 ,9,358 , 0 
481.36,16,250 ,2 ,512 ,0 ,0 ,7 ,5 ,0 ,7 ,1 ,20 ,0 ,18 ,2 ,20,447 , 0 
481.444,10,243 ,14 ,592 ,0 ,0 ,5 ,3 ,0 ,3 ,0 ,11 ,0 ,6 ,0 ,6,218 , 0 
481.482,12,243 ,5 ,768 ,0 ,0 ,6 ,4 ,1 ,5 ,1 ,17 ,0 ,10 ,3 ,13,425 , 0 
481.596,9,250 ,7 ,1429 ,0 ,0 ,6 ,1 ,2 ,2 ,0 ,11 ,0 ,14 ,13 ,27,305 , 0 
481.603,5,250 ,19 ,512 ,0 ,0 ,8 ,2 ,7 ,4 ,5 ,26 ,0 ,16 ,19 ,35,466 , 0 
481.606,19,250 ,1 ,256 ,0 ,0 ,6 ,3 ,2 ,6 ,3 ,20 ,0 ,17 ,9 ,26,419 , 0 
481.696,17,250 ,6 ,978 ,0 ,0 ,7 ,1 ,5 ,3 ,2 ,18 ,0 ,11 ,10 ,21,418 , 0 
481.786,3,243 ,1 ,256 ,0 ,0 ,5 ,2 ,0 ,5 ,0 ,12 ,0 ,7 ,0 ,7,282 , 0 
481.813,13,250 ,1 ,256 ,0 ,0 ,6 ,3 ,2 ,4 ,2 ,17 ,0 ,12 ,5 ,17,317 , 0 
600.96,8,33 ,1 ,256 ,0 ,0 ,19 ,11 ,5 ,10 ,3 ,48 ,0 ,46 ,11 ,57,486 , 0 
601.078,11,34 ,5 ,768 ,0 ,0 ,23 ,1 ,0 ,2 ,1 ,27 ,0 ,70 ,2 ,72,608 , 0 
601.123,2,33 ,1 ,256 ,0 ,0 ,19 ,5 ,5 ,7 ,2 ,38 ,0 ,69 ,11 ,80,542 , 0 
601.138,6,33 ,2 ,512 ,0 ,0 ,21 ,4 ,1 ,2 ,1 ,29 ,0 ,54 ,4 ,58,774 , 0 
601.214,18,33 ,19 ,512 ,0 ,0 ,18 ,4 ,2 ,7 ,1 ,32 ,0 ,46 ,6 ,52,594 , 0 
601.289,7,39 ,16 ,65535 ,0 ,0 ,21 ,0 ,0 ,0 ,0 ,21 ,0 ,44 ,0 ,44,456 , 1 
601.303,4,33 ,8 ,512 ,0 ,0 ,18 ,8 ,1 ,8 ,1 ,36 ,0 ,30 ,3 ,33,538 , 0 
601.342,14,33 ,1 ,256 ,0 ,0 ,18 ,8 ,2 ,11 ,1 ,40 ,0 ,51 ,6 ,57,532 , 0 
601.35,15,34 ,11 ,1132 ,0 ,0 ,20 ,0 ,0 ,1 ,0 ,21 ,0 ,48 ,0 ,48,540 , 0 
601.36,20,33 ,5 ,793 ,0 ,0 ,20 ,2 ,0 ,3 ,0 ,25 ,0 ,44 ,0 ,44,560 , 0 
601.36,16,32 ,2 ,512 ,0 ,0 ,19 ,0 ,0 ,0 ,0 ,19 ,0 ,50 ,0 ,50,671 , 0 
601.453,10,33 ,14 ,557 ,0 ,0 ,17 ,3 ,0 ,7 ,0 ,27 ,0 ,32 ,0 ,32,492 , 0 
601.482,12,33 ,5 ,793 ,0 ,0 ,22 ,3 ,0 ,7 ,0 ,32 ,0 ,58 ,0 ,58,557 , 0 
601.596,9,33 ,5 ,793 ,0 ,0 ,21 ,1 ,0 ,2 ,0 ,24 ,0 ,63 ,0 ,63,598 , 0 
601.603,5,33 ,13 ,512 ,0 ,0 ,23 ,4 ,5 ,8 ,2 ,42 ,0 ,84 ,13 ,97,869 , 0 
601.607,19,33 ,1 ,256 ,0 ,0 ,19 ,7 ,10 ,10 ,6 ,52 ,0 ,75 ,20 ,95,573 , 0 
601.696,17,32 ,6 ,3072 ,0 ,0 ,20 ,0 ,0 ,1 ,0 ,21 ,0 ,40 ,0 ,40,430 , 0 
601.771,13,33 ,1 ,256 ,0 ,0 ,18 ,6 ,7 ,12 ,2 ,45 ,0 ,58 ,12 ,70,594 , 0 
601.787,3,33 ,1 ,256 ,0 ,0 ,18 ,11 ,0 ,10 ,0 ,39 ,0 ,39 ,0 ,39,411 , 0 
720.96,8,75 ,1 ,256 ,0 ,0 ,20 ,8 ,3 ,13 ,2 ,46 ,0 ,44 ,6 ,50,775 , 0 
721.078,11,76 ,5 ,768 ,0 ,0 ,21 ,0 ,0 ,0 ,0 ,21 ,0 ,77 ,0 ,77,568 , 0 
721.123,2,76 ,1 ,256 ,0 ,0 ,18 ,3 ,1 ,8 ,0 ,30 ,0 ,67 ,12 ,79,786 , 0 
721.138,6,76 ,2 ,534 ,0 ,0 ,20 ,0 ,0 ,3 ,0 ,23 ,0 ,43 ,0 ,43,682 , 0 
721.214,18,74 ,19 ,512 ,0 ,0 ,20 ,4 ,1 ,9 ,0 ,34 ,0 ,60 ,5 ,65,718 , 0 
721.236,4,74 ,0 ,0 ,0 ,0 ,17 ,7 ,0 ,11 ,0 ,35 ,0 ,41 ,3 ,44,1033 , 0 
721.289,7,81 ,16 ,65535 ,0 ,0 ,21 ,0 ,0 ,0 ,0 ,21 ,0 ,51 ,0 ,51,419 , 1 
721.338,14,76 ,1 ,256 ,0 ,0 ,18 ,7 ,2 ,12 ,2 ,41 ,0 ,52 ,12 ,64,730 , 0 
721.35,15,78 ,11 ,1132 ,0 ,0 ,23 ,0 ,0 ,0 ,0 ,23 ,0 ,52 ,0 ,52,440 , 0 
721.36,20,74 ,5 ,793 ,0 ,0 ,18 ,0 ,0 ,0 ,0 ,18 ,0 ,43 ,0 ,43,564 , 0 
721.36,16,76 ,2 ,512 ,0 ,0 ,18 ,0 ,0 ,0 ,0 ,18 ,0 ,54 ,0 ,54,657 , 0 
721.444,10,76 ,14 ,512 ,0 ,0 ,17 ,4 ,0 ,6 ,0 ,27 ,0 ,28 ,1 ,29,568 , 0 
721.482,12,78 ,18 ,768 ,0 ,0 ,20 ,1 ,0 ,1 ,0 ,22 ,0 ,56 ,0 ,56,698 , 0 
721.596,9,78 ,5 ,793 ,0 ,0 ,21 ,0 ,0 ,0 ,0 ,21 ,0 ,67 ,0 ,67,536 , 0 
721.603,5,78 ,19 ,512 ,0 ,0 ,22 ,2 ,0 ,5 ,0 ,29 ,0 ,92 ,0 ,92,932 , 0 
721.607,19,75 ,1 ,256 ,0 ,0 ,19 ,5 ,7 ,9 ,4 ,44 ,0 ,78 ,33 ,111,901 , 0 
721.696,17,76 ,6 ,3072 ,0 ,0 ,18 ,0 ,0 ,0 ,0 ,18 ,0 ,43 ,0 ,43,610 , 0 
721.771,13,76 ,1 ,256 ,0 ,0 ,17 ,6 ,0 ,9 ,1 ,33 ,0 ,59 ,2 ,61,699 , 0 
721.848,3,75 ,1 ,256 ,0 ,0 ,17 ,12 ,0 ,12 ,0 ,41 ,0 ,37 ,1 ,38,603 , 0 
840.96,8,83 ,1 ,256 ,0 ,0 ,10 ,4 ,1 ,5 ,0 ,20 ,0 ,21 ,2 ,23,703 , 0 
841.078,11,83 ,12 ,1104 ,0 ,0 ,16 ,8 ,11 ,4 ,3 ,42 ,0 ,43 ,18 ,61,1218 , 0 
841.123,2,83 ,1 ,256 ,0 ,0 ,9 ,1 ,19 ,3 ,5 ,37 ,0 ,25 ,26 ,51,994 , 0 
841.138,6,83 ,2 ,572 ,0 ,0 ,8 ,2 ,1 ,1 ,1 ,13 ,0 ,19 ,2 ,21,1118 , 0 
841.214,18,83 ,19 ,512 ,0 ,0 ,12 ,5 ,21 ,4 ,0 ,42 ,0 ,25 ,25 ,50,1266 , 0 
841.236,4,83 ,8 ,537 ,0 ,0 ,13 ,6 ,0 ,5 ,0 ,24 ,0 ,15 ,0 ,15,937 , 0 
841.289,7,83 ,15 ,1643 ,0 ,0 ,13 ,5 ,0 ,3 ,0 ,21 ,0 ,27 ,1 ,28,951 , 0 
841.337,14,83 ,1 ,256 ,0 ,0 ,8 ,3 ,2 ,3 ,0 ,16 ,0 ,20 ,4 ,24,738 , 0 
841.35,15,83 ,11 ,1302 ,0 ,0 ,13 ,9 ,1 ,4 ,0 ,27 ,0 ,33 ,3 ,36,1241 , 0 
841.36,20,83 ,5 ,1111 ,0 ,0 ,15 ,5 ,1 ,6 ,1 ,28 ,0 ,27 ,4 ,31,1166 , 0 
841.36,16,83 ,2 ,512 ,0 ,0 ,9 ,1 ,6 ,0 ,1 ,17 ,0 ,27 ,8 ,35,1194 , 0 
841.444,10,83 ,14 ,698 ,0 ,0 ,10 ,3 ,0 ,2 ,0 ,15 ,0 ,10 ,0 ,10,731 , 0 
841.482,12,83 ,18 ,840 ,0 ,0 ,13 ,7 ,10 ,3 ,0 ,33 ,0 ,31 ,13 ,44,1153 , 0 
841.596,9,83 ,11 ,1302 ,0 ,0 ,15 ,8 ,2 ,7 ,2 ,34 ,0 ,35 ,5 ,40,1287 , 0 
841.603,5,83 ,18 ,840 ,0 ,0 ,13 ,7 ,20 ,4 ,7 ,51 ,0 ,43 ,30 ,73,1688 , 0 
841.607,19,83 ,1 ,256 ,0 ,0 ,10 ,1 ,22 ,4 ,1 ,38 ,0 ,33 ,26 ,59,839 , 0 
841.697,17,83 ,16 ,1426 ,0 ,0 ,11 ,4 ,2 ,2 ,1 ,20 ,0 ,15 ,3 ,18,918 , 0 
841.771,13,83 ,1 ,256 ,0 ,0 ,9 ,1 ,0 ,2 ,0 ,12 ,0 ,21 ,0 ,21,820 , 0 
841.787,3,83 ,1 ,256 ,0 ,0 ,10 ,5 ,0 ,4 ,0 ,19 ,0 ,12 ,0 ,12,604 , 0 
960.96,8,83 ,1 ,256 ,0 ,0 ,2 ,1 ,2 ,0 ,0 ,5 ,0 ,8 ,2 ,10,852 , 0 
961.078,11,83 ,5 ,768 ,0 ,0 ,4 ,3 ,4 ,4 ,2 ,17 ,0 ,12 ,7 ,19,721 , 0 
961.123,2,83 ,1 ,256 ,0 ,0 ,2 ,1 ,4 ,1 ,0 ,8 ,0 ,7 ,4 ,11,868 , 0 
961.137,6,83 ,2 ,526 ,0 ,0 ,2 ,1 ,0 ,0 ,0 ,3 ,0 ,7 ,0 ,7,769 , 0 
961.214,18,83 ,19 ,512 ,0 ,0 ,3 ,2 ,12 ,1 ,3 ,21 ,0 ,11 ,19 ,30,981 , 0 
961.235,4,83 ,8 ,527 ,0 ,0 ,4 ,2 ,0 ,0 ,0 ,6 ,0 ,7 ,0 ,7,1127 , 0 
961.289,7,83 ,16 ,1300 ,0 ,0 ,7 ,1 ,0 ,1 ,0 ,9 ,0 ,7 ,0 ,7,528 , 0 
961.337,14,83 ,1 ,256 ,0 ,0 ,2 ,1 ,1 ,0 ,0 ,4 ,0 ,6 ,1 ,7,814 , 0 
961.35,15,83 ,11 ,1050 ,0 ,0 ,2 ,2 ,0 ,1 ,1 ,6 ,0 ,12 ,1 ,13,531 , 0 
961.359,20,83 ,5 ,768 ,0 ,0 ,3 ,2 ,0 ,0 ,0 ,5 ,0 ,8 ,0 ,8,653 , 0 
961.36,16,83 ,2 ,526 ,0 ,0 ,2 ,1 ,2 ,0 ,0 ,5 ,0 ,10 ,3 ,13,765 , 0 
961.443,10,83 ,14 ,679 ,0 ,0 ,2 ,1 ,0 ,0 ,0 ,3 ,0 ,3 ,0 ,3,639 , 0 
961.482,12,83 ,5 ,768 ,0 ,0 ,4 ,2 ,6 ,2 ,2 ,16 ,0 ,12 ,11 ,23,922 , 0 
961.595,9,83 ,5 ,768 ,0 ,0 ,5 ,3 ,0 ,1 ,0 ,9 ,0 ,14 ,0 ,14,670 , 0 
961.606,5,83 ,13 ,512 ,0 ,0 ,5 ,3 ,4 ,4 ,1 ,17 ,0 ,15 ,6 ,21,1126 , 0 
961.607,19,83 ,1 ,256 ,0 ,0 ,3 ,0 ,14 ,2 ,3 ,22 ,0 ,14 ,18 ,32,1015 , 0 
961.696,17,83 ,16 ,1300 ,0 ,0 ,3 ,1 ,0 ,1 ,0 ,5 ,0 ,7 ,0 ,7,693 , 0 
961.771,13,83 ,1 ,256 ,0 ,0 ,3 ,1 ,3 ,0 ,1 ,8 ,0 ,8 ,4 ,12,789 , 0 
961.786,3,83 ,1 ,256 ,0 ,0 ,2 ,1 ,0 ,0 ,0 ,3 ,0 ,5 ,0 ,5,672 , 0 
1080.96,8,83 ,1 ,256 ,0 ,0 ,1 ,1 ,0 ,0 ,0 ,2 ,0 ,5 ,0 ,5,781 , 0 
1081.078,11,83 ,5 ,768 ,0 ,0 ,5 ,3 ,4 ,1 ,0 ,13 ,0 ,11 ,4 ,15,1329 , 0 
1081.123,2,83 ,1 ,256 ,0 ,0 ,2 ,1 ,4 ,0 ,0 ,7 ,0 ,8 ,4 ,12,1090 , 0 
1081.138,6,83 ,2 ,519 ,0 ,0 ,2 ,1 ,0 ,0 ,0 ,3 ,0 ,6 ,0 ,6,1205 , 0 
1081.214,18,83 ,19 ,512 ,0 ,0 ,3 ,0 ,0 ,2 ,0 ,5 ,0 ,7 ,0 ,7,1348 , 0 
1081.235,4,83 ,8 ,527 ,0 ,0 ,2 ,0 ,0 ,0 ,0 ,2 ,0 ,2 ,0 ,2,1024 , 0 
1081.289,7,83 ,16 ,1169 ,0 ,0 ,1 ,1 ,0 ,0 ,0 ,2 ,0 ,7 ,0 ,7,1020 , 0 
1081.337,14,83 ,1 ,256 ,0 ,0 ,2 ,1 ,1 ,0 ,0 ,4 ,0 ,5 ,1 ,6,817 , 0 
1081.35,15,83 ,11 ,1032 ,0 ,0 ,2 ,4 ,0 ,0 ,0 ,6 ,0 ,8 ,0 ,8,1334 , 0 
1081.36,20,83 ,5 ,768 ,0 ,0 ,2 ,4 ,0 ,0 ,0 ,6 ,0 ,13 ,0 ,13,1264 , 0 
1081.36,16,83 ,2 ,526 ,0 ,0 ,2 ,0 ,3 ,0 ,0 ,5 ,0 ,7 ,3 ,10,1292 , 0 
1081.443,10,83 ,14 ,620 ,0 ,0 ,2 ,1 ,0 ,0 ,0 ,3 ,0 ,2 ,0 ,2,802 , 0 
1081.481,12,83 ,5 ,768 ,0 ,0 ,5 ,3 ,0 ,1 ,0 ,9 ,0 ,8 ,0 ,8,1265 , 0 
1081.596,9,83 ,5 ,768 ,0 ,0 ,5 ,3 ,0 ,0 ,0 ,8 ,0 ,10 ,0 ,10,1393 , 0 
1081.603,5,83 ,13 ,512 ,0 ,0 ,5 ,0 ,17 ,0 ,0 ,22 ,0 ,13 ,19 ,32,1862 , 0 
1081.606,19,83 ,1 ,256 ,0 ,0 ,1 ,1 ,0 ,2 ,0 ,4 ,0 ,8 ,2 ,10,948 , 0 
1081.696,17,83 ,16 ,1095 ,0 ,0 ,2 ,2 ,0 ,0 ,0 ,4 ,0 ,5 ,0 ,5,992 , 0 
1081.771,13,83 ,1 ,256 ,0 ,0 ,1 ,1 ,17 ,0 ,0 ,19 ,0 ,7 ,17 ,24,908 , 0 
1081.786,3,83 ,1 ,256 ,0 ,0 ,2 ,1 ,0 ,0 ,0 ,3 ,0 ,2 ,0 ,2,676 , 0 
1200.96,8,83 ,1 ,256 ,0 ,0 ,2 ,0 ,1 ,0 ,0 ,3 ,0 ,1 ,1 ,2,929 , 0 
1201.078,11,83 ,5 ,798 ,0 ,0 ,1 ,3 ,24 ,1 ,2 ,31 ,0 ,15 ,28 ,43,979 , 0 
1201.123,2,83 ,1 ,256 ,0 ,0 ,6 ,0 ,0 ,2 ,3 ,11 ,0 ,11 ,3 ,14,1079 , 0 
1201.138,6,83 ,16 ,637 ,0 ,0 ,5 ,3 ,0 ,1 ,0 ,9 ,0 ,12 ,0 ,12,942 , 0 
1201.214,18,83 ,19 ,512 ,0 ,0 ,0 ,0 ,0 ,0 ,0 ,0 ,0 ,5 ,0 ,5,1084 , 0 
1201.235,4,83 ,8 ,520 ,0 ,0 ,1 ,1 ,0 ,0 ,0 ,2 ,0 ,2 ,0 ,2,1237 , 0 
1201.29,7,83 ,16 ,637 ,0 ,0 ,11 ,6 ,89 ,7 ,1 ,114 ,0 ,25 ,103 ,128,1416 , 0 
1201.337,14,83 ,1 ,256 ,0 ,0 ,1 ,0 ,1 ,0 ,0 ,2 ,0 ,7 ,1 ,8,943 , 0 
1201.35,15,83 ,9 ,300 ,0 ,0 ,8 ,9 ,0 ,1 ,0 ,18 ,0 ,17 ,0 ,17,816 , 0 
1201.359,20,83 ,5 ,798 ,0 ,0 ,2 ,2 ,0 ,0 ,0 ,4 ,0 ,3 ,0 ,3,874 , 0 
1201.361,16,83 ,9 ,300 ,0 ,0 ,10 ,7 ,90 ,3 ,1 ,111 ,0 ,26 ,100 ,126,1647 , 0 
1201.443,10,83 ,14 ,599 ,0 ,0 ,2 ,1 ,0 ,0 ,0 ,3 ,0 ,5 ,0 ,5,705 , 0 
1201.481,12,83 ,5 ,794 ,0 ,0 ,2 ,3 ,0 ,0 ,0 ,5 ,0 ,4 ,0 ,4,1071 , 0 
1201.597,9,83 ,7 ,841 ,0 ,0 ,10 ,7 ,122 ,6 ,0 ,145 ,0 ,17 ,143 ,160,1790 , 1 
1201.603,5,83 ,9 ,300 ,0 ,0 ,6 ,7 ,31 ,2 ,3 ,49 ,0 ,12 ,35 ,47,1814 , 0 
1201.606,19,83 ,1 ,256 ,0 ,0 ,2 ,0 ,0 ,0 ,0 ,2 ,0 ,7 ,0 ,7,1132 , 0 
1201.696,17,83 ,16 ,637 ,0 ,0 ,7 ,5 ,0 ,2 ,0 ,14 ,0 ,20 ,2 ,22,1048 , 0 
1201.786,3,83 ,1 ,256 ,0 ,0 ,2 ,0 ,0 ,0 ,0 ,2 ,0 ,1 ,0 ,1,760 , 0 
1201.908,13,83 ,1 ,256 ,0 ,0 ,2 ,0 ,1 ,2 ,2 ,7 ,0 ,6 ,3 ,9,999 , 0 
1320.96,8,83 ,1 ,256 ,0 ,0 ,1 ,1 ,0 ,0 ,0 ,2 ,0 ,3 ,0 ,3,859 , 0 
1321.078,11,83 ,5 ,774 ,0 ,0 ,2 ,4 ,0 ,0 ,0 ,6 ,0 ,20 ,2 ,22,1516 , 0 
1321.123,2,83 ,1 ,256 ,0 ,0 ,2 ,0 ,0 ,1 ,0 ,3 ,0 ,10 ,0 ,10,1264 , 0 
1321.138,6,83 ,16 ,649 ,0 ,0 ,4 ,6 ,0 ,0 ,0 ,10 ,0 ,11 ,0 ,11,1482 , 0 
1321.214,18,83 ,19 ,512 ,0 ,0 ,3 ,1 ,0 ,0 ,0 ,4 ,0 ,5 ,0 ,5,1564 , 0 
1321.235,4,83 ,8 ,520 ,0 ,0 ,3 ,0 ,0 ,0 ,0 ,3 ,0 ,2 ,0 ,2,1112 , 0 
1321.29,7,83 ,9 ,65535 ,0 ,0 ,12 ,7 ,128 ,12 ,2 ,161 ,0 ,24 ,148 ,172,2204 , 0 
1321.337,14,83 ,1 ,256 ,0 ,0 ,2 ,0 ,0 ,0 ,0 ,2 ,0 ,2 ,0 ,2,950 , 0 
1321.35,15,83 ,9 ,300 ,0 ,0 ,7 ,5 ,1 ,3 ,1 ,17 ,0 ,16 ,5 ,21,1621 , 0 
1321.359,20,83 ,5 ,774 ,0 ,0 ,0 ,4 ,0 ,0 ,0 ,4 ,0 ,5 ,0 ,5,1414 , 0 
1321.361,16,83 ,9 ,300 ,0 ,0 ,7 ,8 ,137 ,1 ,3 ,156 ,0 ,22 ,143 ,165,2434 , 0 
1321.443,10,83 ,0 ,65535 ,0 ,0 ,1 ,0 ,0 ,1 ,0 ,2 ,0 ,1 ,0 ,1,945 , 0 
1321.481,12,83 ,5 ,774 ,0 ,0 ,1 ,3 ,0 ,0 ,0 ,4 ,0 ,5 ,0 ,5,1396 , 0 
1321.597,9,83 ,5 ,774 ,0 ,0 ,11 ,8 ,143 ,10 ,4 ,176 ,0 ,22 ,174 ,196,2594 , 1 
1321.603,5,83 ,13 ,512 ,0 ,0 ,5 ,9 ,13 ,1 ,2 ,30 ,0 ,11 ,17 ,28,2236 , 0 
1321.606,19,83 ,1 ,256 ,0 ,0 ,1 ,0 ,0 ,0 ,0 ,1 ,0 ,7 ,0 ,7,1064 , 0 
1321.697,17,83 ,16 ,649 ,0 ,0 ,7 ,6 ,0 ,0 ,0 ,13 ,0 ,15 ,0 ,15,1291 , 0 
1321.786,3,83 ,1 ,256 ,0 ,0 ,1 ,1 ,0 ,0 ,0 ,2 ,0 ,1 ,0 ,1,753 , 0 
1321.915,13,83 ,1 ,256 ,0 ,0 ,0 ,0 ,13 ,0 ,2 ,15 ,0 ,5 ,15 ,20,1037 , 0 
1440.96,8,83 ,1 ,256 ,0 ,0 ,0 ,0 ,0 ,0 ,0 ,0 ,0 ,1 ,0 ,1,984 , 0 
1441.078,11,83 ,5 ,771 ,0 ,0 ,1 ,2 ,0 ,0 ,0 ,3 ,0 ,27 ,0 ,27,1130 , 0 
1441.123,2,83 ,1 ,256 ,0 ,0 ,2 ,0 ,0 ,0 ,0 ,2 ,0 ,13 ,0 ,13,1177 , 0 
1441.138,6,83 ,16 ,587 ,0 ,0 ,2 ,8 ,1 ,0 ,0 ,11 ,0 ,19 ,1 ,20,1121 , 0 
1441.214,18,83 ,19 ,512 ,0 ,0 ,1 ,0 ,0 ,0 ,0 ,1 ,0 ,3 ,0 ,3,1148 , 0 
1441.235,4,83 ,8 ,520 ,0 ,0 ,0 ,0 ,0 ,0 ,0 ,0 ,0 ,2 ,0 ,2,1287 , 0 
1441.29,7,83 ,9 ,300 ,0 ,0 ,15 ,12 ,0 ,14 ,0 ,41 ,0 ,37 ,14 ,51,1851 , 0 
1441.337,14,83 ,1 ,256 ,0 ,0 ,1 ,0 ,0 ,0 ,0 ,1 ,0 ,7 ,0 ,7,1019 , 0 
1441.35,15,83 ,9 ,300 ,0 ,0 ,10 ,10 ,0 ,1 ,0 ,21 ,0 ,27 ,4 ,31,1093 , 0 
1441.359,20,83 ,5 ,771 ,0 ,0 ,2 ,2 ,0 ,0 ,0 ,4 ,0 ,2 ,0 ,2,978 , 0 
1441.361,16,83 ,9 ,300 ,0 ,0 ,11 ,15 ,17 ,1 ,0 ,44 ,0 ,34 ,17 ,51,2049 , 0 
1441.443,10,83 ,6 ,994 ,0 ,0 ,4 ,2 ,0 ,0 ,0 ,6 ,0 ,2 ,0 ,2,845 , 0 
1441.481,12,83 ,5 ,771 ,0 ,0 ,2 ,2 ,0 ,0 ,0 ,4 ,0 ,3 ,0 ,3,1193 , 0 
1441.596,9,83 ,5 ,771 ,0 ,0 ,18 ,7 ,21 ,18 ,1 ,65 ,0 ,31 ,66 ,97,2452 , 1 
1441.603,5,83 ,13 ,512 ,0 ,0 ,2 ,0 ,25 ,0 ,3 ,30 ,0 ,18 ,43 ,61,2135 , 0 
1441.606,19,83 ,1 ,256 ,0 ,0 ,2 ,0 ,0 ,0 ,0 ,2 ,0 ,3 ,0 ,3,1228 , 0 
1441.697,17,83 ,16 ,587 ,0 ,0 ,10 ,9 ,0 ,0 ,0 ,19 ,0 ,24 ,0 ,24,1304 , 0 
1441.771,13,83 ,1 ,256 ,0 ,0 ,1 ,0 ,23 ,0 ,3 ,27 ,0 ,3 ,26 ,29,1149 , 0 
1441.786,3,83 ,1 ,256 ,0 ,0 ,2 ,0 ,0 ,0 ,0 ,2 ,0 ,1 ,0 ,1,829 , 0 
1560.96,8,83 ,1 ,256 ,0 ,0 ,2 ,0 ,1 ,0 ,0 ,3 ,0 ,1 ,1 ,2,939 , 0 
1561.077,11,83 ,5 ,829 ,0 ,0 ,1 ,1 ,0 ,0 ,0 ,2 ,0 ,9 ,0 ,9,1637 , 0 
1561.123,2,83 ,1 ,256 ,0 ,0 ,1 ,0 ,9 ,0 ,0 ,10 ,0 ,9 ,11 ,20,1394 , 0 
1561.138,6,83 ,2 ,529 ,0 ,0 ,5 ,1 ,4 ,1 ,0 ,11 ,0 ,6 ,4 ,10,1607 , 0 
1561.214,18,83 ,19 ,512 ,0 ,0 ,1 ,0 ,0 ,0 ,0 ,1 ,0 ,1 ,0 ,1,1627 , 0 
1561.235,4,83 ,8 ,517 ,0 ,0 ,2 ,1 ,0 ,0 ,0 ,3 ,0 ,1 ,0 ,1,1205 , 0 
1561.289,7,83 ,15 ,596 ,0 ,0 ,7 ,1 ,0 ,2 ,1 ,11 ,0 ,10 ,3 ,13,2361 , 0 
1561.337,14,83 ,1 ,256 ,0 ,0 ,1 ,0 ,0 ,0 ,0 ,1 ,0 ,1 ,0 ,1,1034 , 0 
1561.35,15,83 ,9 ,1048 ,0 ,0 ,2 ,4 ,1 ,0 ,0 ,7 ,0 ,9 ,3 ,12,1813 , 0 
1561.359,20,83 ,5 ,829 ,0 ,0 ,1 ,1 ,0 ,0 ,0 ,2 ,0 ,3 ,0 ,3,1482 , 0 
1561.36,16,83 ,2 ,529 ,0 ,0 ,6 ,1 ,3 ,3 ,1 ,14 ,0 ,12 ,4 ,16,2654 , 0 
1561.444,10,83 ,6 ,1023 ,0 ,0 ,1 ,4 ,0 ,0 ,0 ,5 ,0 ,4 ,0 ,4,1019 , 0 
1561.481,12,83 ,5 ,829 ,0 ,0 ,2 ,1 ,0 ,0 ,0 ,3 ,0 ,4 ,0 ,4,1483 , 0 
1561.596,9,83 ,5 ,771 ,0 ,0 ,6 ,1 ,5 ,3 ,1 ,16 ,0 ,10 ,7 ,17,2801 , 0 
1561.603,5,83 ,13 ,512 ,0 ,0 ,2 ,0 ,9 ,0 ,1 ,12 ,0 ,5 ,11 ,16,2387 , 0 
1561.606,19,83 ,1 ,256 ,0 ,0 ,1 ,0 ,0 ,0 ,0 ,1 ,0 ,2 ,0 ,2,1163 , 0 
1561.696,17,83 ,16 ,932 ,0 ,0 ,2 ,3 ,0 ,0 ,0 ,5 ,0 ,13 ,0 ,13,1383 , 0 
1561.771,13,83 ,1 ,256 ,0 ,0 ,1 ,0 ,9 ,0 ,1 ,11 ,0 ,3 ,10 ,13,1156 , 0 
1561.786,3,83 ,1 ,256 ,0 ,0 ,0 ,0 ,0 ,0 ,0 ,0 ,0 ,1 ,0 ,1,814 , 0 
1680.96,8,83 ,1 ,256 ,0 ,0 ,1 ,1 ,0 ,0 ,0 ,2 ,0 ,3 ,0 ,3,1079 , 0 
1681.077,11,83 ,5 ,829 ,0 ,0 ,1 ,0 ,0 ,0 ,0 ,1 ,0 ,5 ,0 ,5,1204 , 0 
1681.123,2,83 ,1 ,256 ,0 ,0 ,3 ,1 ,4 ,0 ,2 ,10 ,0 ,8 ,6 ,14,1285 , 0 
1681.138,6,83 ,10 ,648 ,0 ,0 ,5 ,3 ,2 ,1 ,1 ,12 ,0 ,9 ,3 ,12,1276 , 0 
1681.214,18,83 ,19 ,512 ,0 ,0 ,2 ,0 ,0 ,0 ,0 ,2 ,0 ,3 ,0 ,3,1261 , 0 
1681.235,4,83 ,8 ,517 ,0 ,0 ,1 ,0 ,0 ,0 ,0 ,1 ,0 ,2 ,0 ,2,1352 , 0 
1681.289,7,83 ,9 ,1041 ,0 ,0 ,5 ,2 ,0 ,1 ,0 ,8 ,0 ,6 ,0 ,6,1975 , 0 
1681.337,14,83 ,1 ,256 ,0 ,0 ,2 ,1 ,4 ,0 ,0 ,7 ,0 ,6 ,4 ,10,1098 , 0 
1681.35,15,83 ,9 ,1041 ,0 ,0 ,2 ,2 ,0 ,0 ,0 ,4 ,0 ,7 ,1 ,8,1190 , 0 
1681.359,20,83 ,5 ,829 ,0 ,0 ,2 ,0 ,0 ,0 ,0 ,2 ,0 ,0 ,0 ,0,1055 , 0 
1681.36,16,83 ,2 ,512 ,0 ,0 ,3 ,1 ,1 ,0 ,0 ,5 ,0 ,14 ,1 ,15,2185 , 0 
1681.444,10,83 ,14 ,544 ,0 ,0 ,4 ,3 ,3 ,1 ,0 ,11 ,0 ,7 ,3 ,10,981 , 0 
1681.481,12,83 ,5 ,829 ,0 ,0 ,1 ,0 ,0 ,0 ,0 ,1 ,0 ,2 ,0 ,2,1259 , 0 
1681.596,9,83 ,5 ,771 ,0 ,0 ,3 ,0 ,4 ,0 ,0 ,7 ,0 ,6 ,4 ,10,2568 , 0 
1681.602,5,83 ,13 ,512 ,0 ,0 ,1 ,0 ,4 ,1 ,0 ,6 ,0 ,7 ,4 ,11,2237 , 0 
1681.606,19,83 ,1 ,256 ,0 ,0 ,2 ,1 ,0 ,0 ,0 ,3 ,0 ,5 ,0 ,5,1333 , 0 
1681.696,17,83 ,16 ,874 ,0 ,0 ,2 ,1 ,0 ,0 ,0 ,3 ,0 ,10 ,0 ,10,1391 , 0 
1681.771,13,83 ,1 ,256 ,0 ,0 ,1 ,1 ,4 ,1 ,0 ,7 ,0 ,5 ,5 ,10,1253 , 0 
1681.786,3,83 ,1 ,256 ,0 ,0 ,1 ,1 ,0 ,0 ,0 ,2 ,0 ,3 ,0 ,3,888 , 0 
1800.96,8,83 ,1 ,256 ,0 ,0 ,1 ,0 ,1 ,0 ,0 ,2 ,0 ,1 ,1 ,2,1001 , 0 
1801.077,11,83 ,5 ,782 ,0 ,0 ,2 ,0 ,0 ,0 ,0 ,2 ,0 ,4 ,0 ,4,1719 , 0 
1801.123,2,83 ,1 ,256 ,0 ,0 ,1 ,0 ,1 ,2 ,0 ,4 ,0 ,5 ,1 ,6,1508 , 0 
1801.138,6,83 ,10 ,675 ,0 ,0 ,3 ,2 ,0 ,1 ,0 ,6 ,0 ,5 ,0 ,5,1722 , 0 
1801.214,18,83 ,19 ,512 ,0 ,0 ,1 ,0 ,0 ,0 ,0 ,1 ,0 ,1 ,0 ,1,1722 , 0 
1801.235,4,83 ,8 ,513 ,0 ,0 ,1 ,1 ,0 ,0 ,0 ,2 ,0 ,1 ,0 ,1,1273 , 0 
1801.289,7,83 ,9 ,1041 ,0 ,0 ,2 ,0 ,0 ,0 ,0 ,2 ,0 ,4 ,0 ,4,2444 , 0 
1801.337,14,83 ,1 ,256 ,0 ,0 ,1 ,0 ,2 ,0 ,0 ,3 ,0 ,6 ,2 ,8,1139 , 0 
1801.35,15,83 ,9 ,1057 ,0 ,0 ,3 ,1 ,0 ,0 ,0 ,4 ,0 ,3 ,0 ,3,1913 , 0 
1801.359,20,83 ,5 ,782 ,0 ,0 ,2 ,0 ,0 ,0 ,0 ,2 ,0 ,2 ,0 ,2,1606 , 0 
1801.36,16,83 ,2 ,512 ,0 ,0 ,1 ,0 ,1 ,0 ,0 ,2 ,0 ,4 ,1 ,5,2801 , 0 
1801.444,10,83 ,14 ,544 ,0 ,0 ,3 ,0 ,2 ,0 ,0 ,5 ,0 ,2 ,3 ,5,1121 , 0 
1801.481,12,83 ,5 ,789 ,0 ,0 ,1 ,1 ,0 ,0 ,0 ,2 ,0 ,3 ,0 ,3,1567 , 0 
1801.595,9,83 ,5 ,782 ,0 ,0 ,1 ,0 ,1 ,0 ,0 ,2 ,0 ,5 ,1 ,6,2931 , 0 
1801.602,5,83 ,13 ,512 ,0 ,0 ,3 ,1 ,2 ,0 ,0 ,6 ,0 ,5 ,2 ,7,2526 , 0 
1801.606,19,83 ,1 ,256 ,0 ,0 ,1 ,0 ,0 ,0 ,0 ,1 ,0 ,5 ,0 ,5,1251 , 0 
1801.696,17,83 ,16 ,874 ,0 ,0 ,2 ,1 ,0 ,0 ,0 ,3 ,0 ,5 ,0 ,5,1460 , 0 
1801.771,13,83 ,1 ,256 ,0 ,0 ,2 ,0 ,3 ,0 ,0 ,5 ,0 ,1 ,3 ,4,1229 , 0 
1801.786,3,83 ,1 ,256 ,0 ,0 ,2 ,0 ,0 ,0 ,0 ,2 ,0 ,1 ,0 ,1,880 , 0 
1920.96,8,83 ,1 ,256 ,0 ,0 ,1 ,0 ,1 ,0 ,0 ,2 ,0 ,2 ,1 ,3,1151 , 0 
1921.077,11,83 ,5 ,782 ,0 ,0 ,1 ,1 ,0 ,0 ,0 ,2 ,0 ,4 ,0 ,4,1279 , 0 
1921.124,2,83 ,1 ,256 ,0 ,0 ,25 ,0 ,39 ,0 ,0 ,64 ,110 ,27 ,39 ,176,1611 , 0 
1921.214,18,83 ,19 ,512 ,0 ,0 ,1 ,0 ,0 ,0 ,0 ,1 ,0 ,4 ,0 ,4,1320 , 0 
1921.235,4,83 ,8 ,512 ,0 ,0 ,2 ,1 ,0 ,0 ,0 ,3 ,0 ,2 ,0 ,2,1437 , 0 
1921.27,6,83 ,2 ,512 ,0 ,120 ,5 ,14 ,0 ,1 ,0 ,140 ,0 ,92 ,0 ,92,2142 , 1 
1921.289,7,83 ,9 ,1062 ,0 ,0 ,2 ,1 ,0 ,0 ,0 ,3 ,0 ,49 ,0 ,49,2087 , 0 
1921.337,14,83 ,1 ,256 ,0 ,0 ,1 ,0 ,8 ,0 ,1 ,10 ,0 ,44 ,9 ,53,1199 , 0 
1921.35,15,83 ,9 ,1062 ,0 ,0 ,1 ,1 ,0 ,0 ,0 ,2 ,0 ,1 ,0 ,1,1263 , 0 
1921.359,20,83 ,5 ,782 ,0 ,0 ,2 ,1 ,0 ,0 ,0 ,3 ,0 ,1 ,0 ,1,1120 , 0 
1921.361,16,83 ,2 ,512 ,0 ,0 ,25 ,18 ,15 ,0 ,0 ,58 ,111 ,51 ,15 ,177,2696 , 0 
1921.444,10,83 ,14 ,544 ,0 ,0 ,25 ,0 ,8 ,0 ,1 ,34 ,111 ,4 ,9 ,124,1301 , 0 
1921.481,12,83 ,5 ,789 ,0 ,0 ,2 ,0 ,0 ,0 ,0 ,2 ,0 ,1 ,0 ,1,1320 , 0 
1921.596,9,83 ,5 ,782 ,0 ,0 ,2 ,1 ,2 ,0 ,0 ,5 ,0 ,26 ,2 ,28,2704 , 0 
1921.602,5,83 ,13 ,512 ,0 ,0 ,0 ,0 ,5 ,0 ,0 ,5 ,0 ,27 ,5 ,32,2349 , 0 
1921.606,19,83 ,1 ,256 ,0 ,0 ,1 ,0 ,0 ,0 ,0 ,1 ,0 ,25 ,0 ,25,1427 , 0 
1921.697,17,83 ,16 ,793 ,0 ,0 ,26 ,15 ,0 ,0 ,0 ,41 ,114 ,27 ,0 ,141,1740 , 0 
1921.771,13,83 ,1 ,256 ,0 ,0 ,1 ,0 ,5 ,0 ,0 ,6 ,0 ,22 ,5 ,27,1337 , 0 
1921.786,3,83 ,1 ,256 ,0 ,0 ,1 ,0 ,0 ,0 ,0 ,1 ,0 ,0 ,0 ,0,947 , 0 
2040.96,8,83 ,1 ,256 ,0 ,0 ,1 ,0 ,0 ,0 ,0 ,1 ,0 ,0 ,0 ,0,1077 , 0 
2041.077,11,83 ,5 ,782 ,0 ,0 ,2 ,0 ,0 ,0 ,0 ,2 ,0 ,1 ,0 ,1,1801 , 0 
2041.124,2,83 ,1 ,256 ,0 ,0 ,25 ,0 ,58 ,0 ,0 ,83 ,114 ,22 ,58 ,194,1858 , 0 
2041.214,18,83 ,19 ,512 ,0 ,0 ,0 ,0 ,0 ,0 ,0 ,0 ,0 ,2 ,0 ,2,1795 , 0 
2041.235,4,83 ,8 ,512 ,0 ,0 ,1 ,0 ,0 ,0 ,0 ,1 ,0 ,0 ,0 ,0,1341 , 0 
2041.273,6,83 ,2 ,512 ,0 ,120 ,1 ,17 ,0 ,0 ,0 ,138 ,0 ,95 ,0 ,95,2649 , 1 
2041.289,7,83 ,16 ,800 ,0 ,0 ,5 ,8 ,0 ,1 ,0 ,14 ,0 ,48 ,0 ,48,2658 , 0 
2041.342,14,83 ,1 ,256 ,0 ,0 ,1 ,0 ,1 ,1 ,0 ,3 ,0 ,44 ,2 ,46,1290 , 0 
2041.35,15,83 ,9 ,1062 ,0 ,0 ,1 ,0 ,0 ,0 ,0 ,1 ,0 ,2 ,0 ,2,1992 , 0 
2041.359,20,83 ,5 ,782 ,0 ,0 ,1 ,0 ,0 ,0 ,0 ,1 ,0 ,1 ,0 ,1,1675 , 0 
2041.365,16,83 ,2 ,512 ,0 ,0 ,27 ,15 ,26 ,0 ,0 ,68 ,111 ,50 ,26 ,187,3441 , 0 
2041.444,10,83 ,14 ,516 ,0 ,0 ,26 ,1 ,0 ,1 ,0 ,28 ,109 ,1 ,0 ,110,1383 , 0 
2041.481,12,83 ,5 ,785 ,0 ,0 ,0 ,0 ,0 ,0 ,0 ,0 ,0 ,2 ,0 ,2,1635 , 0 
2041.596,9,83 ,5 ,782 ,0 ,0 ,1 ,0 ,0 ,0 ,1 ,2 ,0 ,25 ,1 ,26,3041 , 0 
2041.606,19,83 ,1 ,256 ,0 ,0 ,1 ,0 ,0 ,0 ,0 ,1 ,0 ,25 ,0 ,25,1362 , 0 
2041.606,5,83 ,13 ,512 ,0 ,0 ,2 ,0 ,0 ,0 ,1 ,3 ,0 ,24 ,1 ,25,2625 , 0 
2041.697,17,83 ,16 ,800 ,0 ,0 ,25 ,18 ,0 ,0 ,0 ,43 ,107 ,26 ,0 ,133,1884 , 0 
2041.771,13,83 ,1 ,256 ,0 ,0 ,1 ,0 ,0 ,0 ,1 ,2 ,0 ,23 ,1 ,24,1363 , 0 
2041.786,3,83 ,1 ,256 ,0 ,0 ,1 ,0 ,0 ,0 ,0 ,1 ,0 ,0 ,0 ,0,945 , 0 
2160.96,8,83 ,1 ,256 ,0 ,0 ,1 ,0 ,0 ,0 ,0 ,1 ,0 ,1 ,0 ,1,1211 , 0 
2161.077,11,83 ,5 ,782 ,0 ,0 ,0 ,0 ,0 ,0 ,0 ,0 ,0 ,1 ,0 ,1,1349 , 0 
2161.14,2,83 ,1 ,256 ,0 ,0 ,24 ,0 ,68 ,0 ,0 ,92 ,106 ,19 ,68 ,193,1985 , 0 
2161.214,18,83 ,19 ,512 ,0 ,0 ,1 ,0 ,0 ,0 ,0 ,1 ,0 ,0 ,0 ,0,1392 , 0 
2161.235,4,83 ,8 ,512 ,0 ,0 ,1 ,0 ,0 ,0 ,0 ,1 ,0 ,0 ,0 ,0,1489 , 0 
2161.275,6,83 ,2 ,521 ,0 ,120 ,1 ,20 ,0 ,0 ,0 ,141 ,0 ,84 ,0 ,84,3052 , 1 
2161.289,7,83 ,16 ,777 ,0 ,0 ,1 ,16 ,0 ,0 ,0 ,17 ,0 ,42 ,0 ,42,2328 , 0 
2161.337,14,83 ,1 ,256 ,0 ,0 ,1 ,0 ,0 ,0 ,0 ,1 ,0 ,35 ,0 ,35,1285 , 0 
2161.35,15,83 ,9 ,1112 ,0 ,0 ,1 ,1 ,0 ,0 ,0 ,2 ,0 ,2 ,0 ,2,1365 , 0 
2161.359,20,83 ,5 ,782 ,0 ,0 ,1 ,0 ,0 ,0 ,0 ,1 ,0 ,1 ,0 ,1,1192 , 0 
2161.361,16,83 ,2 ,521 ,0 ,0 ,25 ,16 ,32 ,0 ,0 ,73 ,106 ,39 ,32 ,177,3406 , 0 
2161.444,10,83 ,14 ,516 ,0 ,0 ,25 ,0 ,0 ,0 ,0 ,25 ,112 ,1 ,0 ,113,1565 , 0 
2161.481,12,83 ,5 ,785 ,0 ,0 ,2 ,1 ,0 ,0 ,0 ,3 ,0 ,2 ,0 ,2,1455 , 0 
2161.596,9,83 ,5 ,782 ,0 ,0 ,1 ,0 ,1 ,1 ,0 ,3 ,0 ,23 ,1 ,24,2890 , 0 
2161.609,5,83 ,13 ,512 ,0 ,0 ,1 ,0 ,2 ,1 ,0 ,4 ,0 ,23 ,3 ,26,2536 , 0 
2161.612,19,83 ,1 ,256 ,0 ,0 ,1 ,0 ,0 ,0 ,0 ,1 ,0 ,26 ,0 ,26,1590 , 0 
2161.697,17,83 ,16 ,777 ,0 ,0 ,26 ,16 ,0 ,0 ,0 ,42 ,105 ,23 ,0 ,128,2164 , 0 
2161.771,13,83 ,1 ,256 ,0 ,0 ,2 ,0 ,2 ,1 ,0 ,5 ,0 ,23 ,3 ,26,1451 , 0 
2161.786,3,83 ,1 ,256 ,0 ,0 ,1 ,0 ,0 ,0 ,0 ,1 ,0 ,2 ,0 ,2,1013 , 0 
2280.96,8,83 ,1 ,256 ,0 ,0 ,1 ,0 ,0 ,0 ,0 ,1 ,0 ,1 ,0 ,1,1146 , 0 
2281.077,11,83 ,5 ,782 ,0 ,0 ,1 ,0 ,0 ,0 ,0 ,1 ,0 ,2 ,0 ,2,1864 , 0 
2281.124,2,83 ,1 ,256 ,0 ,0 ,7 ,0 ,20 ,0 ,0 ,27 ,1 ,5 ,20 ,26,1988 , 0 
2281.138,6,83 ,2 ,512 ,0 ,0 ,0 ,5 ,0 ,0 ,0 ,5 ,0 ,19 ,0 ,19,2740 , 0 
2281.214,18,83 ,19 ,512 ,0 ,0 ,1 ,0 ,0 ,0 ,0 ,1 ,0 ,0 ,0 ,0,1867 , 0 
2281.235,4,83 ,8 ,512 ,0 ,0 ,1 ,0 ,0 ,0 ,0 ,1 ,0 ,2 ,0 ,2,1429 , 0 
2281.289,7,83 ,16 ,768 ,0 ,0 ,2 ,5 ,0 ,0 ,0 ,7 ,0 ,9 ,0 ,9,2755 , 0 
2281.337,14,83 ,1 ,256 ,0 ,0 ,1 ,0 ,0 ,0 ,0 ,1 ,0 ,10 ,0 ,10,1369 , 0 
2281.35,15,83 ,9 ,1112 ,0 ,0 ,1 ,0 ,0 ,0 ,0 ,1 ,0 ,3 ,0 ,3,2071 , 0 
2281.359,20,83 ,5 ,782 ,0 ,0 ,1 ,0 ,0 ,0 ,0 ,1 ,0 ,0 ,0 ,0,1729 , 0 
2281.36,16,83 ,2 ,512 ,0 ,0 ,5 ,6 ,9 ,0 ,0 ,20 ,0 ,8 ,9 ,17,3649 , 0 
2281.444,10,83 ,14 ,516 ,0 ,0 ,5 ,0 ,0 ,0 ,0 ,5 ,0 ,0 ,0 ,0,1466 , 0 
2281.481,12,83 ,5 ,785 ,0 ,0 ,1 ,0 ,0 ,0 ,0 ,1 ,0 ,0 ,0 ,0,1700 , 0 
2281.595,9,83 ,5 ,782 ,0 ,0 ,1 ,0 ,0 ,0 ,0 ,1 ,0 ,6 ,0 ,6,3111 , 0 
2281.602,5,83 ,13 ,512 ,0 ,0 ,0 ,1 ,0 ,0 ,0 ,1 ,0 ,7 ,0 ,7,2691 , 0 
2281.606,19,83 ,1 ,256 ,0 ,0 ,1 ,0 ,0 ,0 ,0 ,1 ,0 ,6 ,0 ,6,1452 , 0 
2281.696,17,83 ,16 ,768 ,0 ,0 ,5 ,4 ,0 ,0 ,0 ,9 ,0 ,5 ,0 ,5,2003 , 0 
2281.771,13,83 ,1 ,256 ,0 ,0 ,1 ,0 ,1 ,0 ,0 ,2 ,0 ,4 ,1 ,5,1433 , 0 
2281.786,3,83 ,1 ,256 ,0 ,0 ,1 ,0 ,0 ,0 ,0 ,1 ,0 ,0 ,0 ,0,1006 , 0 
2400.96,8,83 ,1 ,256 ,0 ,0 ,1 ,0 ,0 ,0 ,0 ,1 ,0 ,0 ,0 ,0,1290 , 0 
2401.077,11,83 ,5 ,776 ,0 ,0 ,2 ,0 ,0 ,0 ,0 ,2 ,0 ,2 ,0 ,2,1419 , 0 
2401.123,2,83 ,1 ,256 ,0 ,0 ,2 ,0 ,5 ,0 ,0 ,7 ,0 ,2 ,5 ,7,2074 , 0 
2401.138,6,83 ,2 ,512 ,0 ,0 ,1 ,1 ,0 ,0 ,0 ,2 ,0 ,5 ,0 ,5,3127 , 0 
2401.214,18,83 ,19 ,512 ,0 ,0 ,1 ,0 ,0 ,0 ,0 ,1 ,0 ,1 ,0 ,1,1452 , 0 
2401.235,4,83 ,8 ,512 ,0 ,0 ,0 ,0 ,0 ,0 ,0 ,0 ,0 ,0 ,0 ,0,1541 , 0 
2401.289,7,83 ,16 ,768 ,0 ,0 ,1 ,1 ,0 ,0 ,0 ,2 ,0 ,3 ,0 ,3,2405 , 0 
2401.337,14,83 ,1 ,256 ,0 ,0 ,1 ,0 ,0 ,0 ,0 ,1 ,0 ,3 ,0 ,3,1356 , 0 
2401.35,15,83 ,9 ,1112 ,0 ,0 ,1 ,0 ,0 ,0 ,0 ,1 ,0 ,0 ,0 ,0,1424 , 0 
2401.359,20,83 ,5 ,782 ,0 ,0 ,1 ,0 ,0 ,0 ,0 ,1 ,0 ,1 ,0 ,1,1246 , 0 
2401.36,16,83 ,2 ,512 ,0 ,0 ,1 ,2 ,2 ,0 ,0 ,5 ,0 ,3 ,2 ,5,3519 , 0 
2401.444,10,83 ,14 ,516 ,0 ,0 ,2 ,0 ,0 ,0 ,0 ,2 ,0 ,0 ,0 ,0,1628 , 0 
2401.481,12,83 ,5 ,785 ,0 ,0 ,1 ,0 ,0 ,0 ,0 ,1 ,0 ,3 ,0 ,3,1532 , 0 
2401.595,9,83 ,5 ,782 ,0 ,0 ,1 ,0 ,0 ,0 ,0 ,1 ,0 ,2 ,0 ,2,2979 , 0 
2401.602,5,83 ,13 ,512 ,0 ,0 ,2 ,0 ,0 ,0 ,0 ,2 ,0 ,1 ,0 ,1,2637 , 0 
2401.606,19,83 ,1 ,256 ,0 ,0 ,1 ,0 ,0 ,0 ,0 ,1 ,0 ,0 ,0 ,0,1660 , 0 
2401.696,17,83 ,16 ,768 ,0 ,0 ,1 ,1 ,0 ,0 ,0 ,2 ,0 ,2 ,0 ,2,2237 , 0 
2401.771,13,83 ,1 ,256 ,0 ,0 ,1 ,0 ,0 ,0 ,0 ,1 ,0 ,2 ,0 ,2,1566 , 0 
2401.786,3,83 ,1 ,256 ,0 ,0 ,1 ,0 ,0 ,0 ,0 ,1 ,0 ,1 ,0 ,1,1090 , 0 
2520.96,8,83 ,1 ,256 ,0 ,0 ,1 ,0 ,0 ,0 ,0 ,1 ,0 ,0 ,0 ,0,1198 , 0 
2521.077,11,83 ,5 ,776 ,0 ,0 ,1 ,1 ,0 ,0 ,0 ,2 ,0 ,3 ,0 ,3,1940 , 0 
2521.123,2,83 ,1 ,256 ,0 ,0 ,1 ,0 ,2 ,0 ,0 ,3 ,0 ,1 ,2 ,3,2078 , 0 
2521.197,6,83 ,2 ,512 ,0 ,0 ,2 ,0 ,0 ,0 ,0 ,2 ,0 ,2 ,0 ,2,2820 , 0 
2521.214,18,83 ,19 ,512 ,0 ,0 ,1 ,0 ,0 ,0 ,0 ,1 ,0 ,2 ,0 ,2,1926 , 0 
2521.235,4,83 ,8 ,512 ,0 ,0 ,1 ,0 ,0 ,0 ,0 ,1 ,0 ,1 ,0 ,1,1485 , 0 
2521.289,7,83 ,16 ,768 ,0 ,0 ,2 ,1 ,0 ,0 ,0 ,3 ,0 ,5 ,0 ,5,2845 , 0 
2521.337,14,83 ,1 ,256 ,0 ,0 ,1 ,0 ,0 ,0 ,0 ,1 ,0 ,1 ,0 ,1,1439 , 0 
2521.35,15,83 ,9 ,1130 ,0 ,0 ,2 ,0 ,0 ,0 ,0 ,2 ,0 ,3 ,0 ,3,2158 , 0 
2521.359,20,83 ,5 ,782 ,0 ,0 ,1 ,0 ,0 ,0 ,0 ,1 ,0 ,1 ,0 ,1,1800 , 0 
2521.36,16,83 ,2 ,512 ,0 ,0 ,2 ,0 ,2 ,0 ,0 ,4 ,0 ,2 ,2 ,4,3751 , 0 
2521.444,10,83 ,14 ,516 ,0 ,0 ,1 ,0 ,0 ,0 ,0 ,1 ,0 ,1 ,0 ,1,1522 , 0 
2521.481,12,83 ,5 ,785 ,0 ,0 ,1 ,0 ,0 ,0 ,0 ,1 ,0 ,0 ,0 ,0,1769 , 0 
2521.595,9,83 ,5 ,782 ,0 ,0 ,3 ,0 ,0 ,0 ,0 ,3 ,0 ,4 ,0 ,4,3207 , 0 
2521.602,5,83 ,13 ,512 ,0 ,0 ,0 ,0 ,1 ,0 ,0 ,1 ,0 ,2 ,1 ,3,2787 , 0 
2521.606,19,83 ,1 ,256 ,0 ,0 ,0 ,0 ,0 ,0 ,0 ,0 ,0 ,0 ,0 ,0,1508 , 0 
2521.696,17,83 ,16 ,768 ,0 ,0 ,2 ,1 ,0 ,0 ,0 ,3 ,0 ,3 ,0 ,3,2082 , 0 
2521.771,13,83 ,1 ,256 ,0 ,0 ,0 ,0 ,1 ,0 ,0 ,1 ,0 ,0 ,1 ,1,1489 , 0 
2521.786,3,83 ,1 ,256 ,0 ,0 ,1 ,0 ,0 ,0 ,0 ,1 ,0 ,1 ,0 ,1,1062 , 0 
2640.96,8,83 ,1 ,256 ,0 ,0 ,1 ,0 ,0 ,0 ,0 ,1 ,0 ,3 ,0 ,3,1365 , 0 
2641.077,11,83 ,5 ,776 ,0 ,0 ,1 ,0 ,0 ,0 ,0 ,1 ,0 ,7 ,0 ,7,1510 , 0 
2641.124,2,83 ,1 ,256 ,0 ,0 ,5 ,0 ,10 ,0 ,2 ,17 ,0 ,7 ,12 ,19,2190 , 0 
2641.138,6,83 ,2 ,512 ,0 ,0 ,5 ,3 ,4 ,0 ,0 ,12 ,0 ,13 ,4 ,17,3275 , 0 
2641.214,18,83 ,19 ,512 ,0 ,0 ,2 ,0 ,0 ,0 ,0 ,2 ,0 ,0 ,0 ,0,1517 , 0 
2641.235,4,83 ,8 ,512 ,0 ,0 ,1 ,0 ,0 ,0 ,0 ,1 ,0 ,1 ,0 ,1,1618 , 0 
2641.289,7,83 ,9 ,1096 ,0 ,0 ,5 ,3 ,0 ,2 ,0 ,10 ,0 ,15 ,0 ,15,2528 , 0 
2641.337,14,83 ,1 ,256 ,0 ,0 ,1 ,0 ,0 ,0 ,0 ,1 ,0 ,6 ,0 ,6,1447 , 0 
2641.35,15,83 ,9 ,1096 ,0 ,0 ,4 ,3 ,0 ,0 ,0 ,7 ,0 ,9 ,0 ,9,1536 , 0 
2641.359,20,83 ,5 ,782 ,0 ,0 ,1 ,0 ,0 ,0 ,0 ,1 ,0 ,0 ,0 ,0,1309 , 0 
2641.36,16,83 ,2 ,512 ,0 ,0 ,4 ,3 ,0 ,0 ,2 ,9 ,0 ,22 ,2 ,24,3653 , 1 
2641.444,10,83 ,14 ,516 ,0 ,0 ,3 ,0 ,0 ,0 ,0 ,3 ,0 ,4 ,0 ,4,1721 , 0 
2641.481,12,83 ,5 ,785 ,0 ,0 ,1 ,0 ,0 ,0 ,0 ,1 ,0 ,1 ,0 ,1,1603 , 0 
2641.596,9,83 ,5 ,782 ,0 ,0 ,4 ,0 ,6 ,0 ,0 ,10 ,0 ,10 ,6 ,16,3136 , 0 
2641.602,5,83 ,13 ,512 ,0 ,0 ,1 ,0 ,6 ,0 ,0 ,7 ,0 ,8 ,6 ,14,2740 , 0 
2641.606,19,83 ,1 ,256 ,0 ,0 ,1 ,0 ,0 ,0 ,0 ,1 ,0 ,8 ,0 ,8,1789 , 0 
2641.696,17,83 ,6 ,768 ,0 ,0 ,5 ,4 ,0 ,1 ,0 ,10 ,0 ,10 ,1 ,11,2365 , 0 
2641.771,13,83 ,1 ,256 ,0 ,0 ,1 ,0 ,6 ,0 ,0 ,7 ,0 ,3 ,6 ,9,1661 , 0 
2641.786,3,83 ,1 ,256 ,0 ,0 ,2 ,0 ,0 ,0 ,0 ,2 ,0 ,0 ,0 ,0,1153 , 0 
2760.96,8,83 ,1 ,256 ,0 ,0 ,2 ,0 ,0 ,0 ,0 ,2 ,0 ,3 ,0 ,3,1258 , 0 
2761.077,11,83 ,5 ,776 ,0 ,0 ,2 ,0 ,0 ,0 ,0 ,2 ,0 ,7 ,0 ,7,2012 , 0 
2761.124,2,83 ,1 ,256 ,0 ,0 ,6 ,0 ,13 ,1 ,0 ,20 ,0 ,8 ,15 ,23,2237 , 0 
2761.138,6,83 ,2 ,512 ,0 ,0 ,8 ,4 ,6 ,0 ,0 ,18 ,0 ,15 ,6 ,21,3003 , 0 
2761.214,18,83 ,19 ,512 ,0 ,0 ,3 ,0 ,0 ,0 ,0 ,3 ,0 ,4 ,0 ,4,2014 , 0 
2761.235,4,83 ,8 ,512 ,0 ,0 ,3 ,0 ,0 ,0 ,0 ,3 ,0 ,1 ,0 ,1,1565 , 0 
2761.289,7,83 ,9 ,1102 ,0 ,0 ,7 ,4 ,0 ,0 ,0 ,11 ,0 ,18 ,0 ,18,2990 , 0 
2761.337,14,83 ,1 ,256 ,0 ,0 ,2 ,0 ,0 ,0 ,0 ,2 ,0 ,7 ,0 ,7,1529 , 0 
2761.35,15,83 ,9 ,1102 ,0 ,0 ,3 ,4 ,0 ,0 ,0 ,7 ,0 ,11 ,0 ,11,2260 , 0 
2761.359,20,83 ,5 ,782 ,0 ,0 ,1 ,0 ,0 ,0 ,0 ,1 ,0 ,0 ,0 ,0,1854 , 0 
2761.36,16,83 ,2 ,512 ,0 ,0 ,3 ,3 ,0 ,2 ,0 ,8 ,0 ,28 ,0 ,28,3915 , 1 
2761.444,10,83 ,14 ,516 ,0 ,0 ,1 ,0 ,0 ,0 ,0 ,1 ,0 ,7 ,0 ,7,1583 , 0 
2761.481,12,83 ,5 ,785 ,0 ,0 ,1 ,0 ,0 ,0 ,0 ,1 ,0 ,3 ,0 ,3,1829 , 0 
2761.596,9,83 ,5 ,782 ,0 ,0 ,4 ,0 ,8 ,0 ,0 ,12 ,0 ,8 ,8 ,16,3399 , 0 
2761.602,5,83 ,13 ,512 ,0 ,0 ,1 ,0 ,8 ,0 ,0 ,9 ,0 ,11 ,8 ,19,2936 , 0 
2761.606,19,83 ,1 ,256 ,0 ,0 ,2 ,0 ,0 ,0 ,0 ,2 ,0 ,9 ,0 ,9,1592 , 0 
2761.696,17,83 ,6 ,781 ,0 ,0 ,12 ,6 ,0 ,0 ,0 ,18 ,0 ,15 ,0 ,15,2259 , 0 
2761.771,13,83 ,1 ,256 ,0 ,0 ,2 ,0 ,8 ,0 ,0 ,10 ,0 ,5 ,8 ,13,1591 , 0 
2761.786,3,83 ,1 ,256 ,0 ,0 ,1 ,0 ,0 ,0 ,0 ,1 ,0 ,2 ,0 ,2,1114 , 0 
2880.96,8,83 ,1 ,256 ,0 ,0 ,2 ,0 ,0 ,0 ,0 ,2 ,0 ,0 ,0 ,0,1422 , 0 
2881.078,11,83 ,5 ,776 ,0 ,0 ,1 ,0 ,0 ,0 ,0 ,1 ,0 ,10 ,0 ,10,1585 , 0 
2881.123,2,83 ,1 ,256 ,0 ,0 ,4 ,0 ,8 ,0 ,0 ,12 ,0 ,6 ,8 ,14,2308 , 0 
2881.138,6,83 ,2 ,512 ,0 ,0 ,6 ,2 ,4 ,0 ,0 ,12 ,0 ,9 ,4 ,13,3423 , 0 
2881.214,18,83 ,19 ,512 ,0 ,0 ,0 ,0 ,0 ,0 ,0 ,0 ,0 ,1 ,0 ,1,1568 , 0 
2881.235,4,83 ,8 ,512 ,0 ,0 ,0 ,0 ,0 ,0 ,0 ,0 ,0 ,1 ,0 ,1,1667 , 0 
2881.289,7,83 ,9 ,1068 ,0 ,0 ,6 ,7 ,0 ,0 ,0 ,13 ,0 ,16 ,0 ,16,2689 , 0 
2881.337,14,83 ,1 ,256 ,0 ,0 ,0 ,0 ,0 ,0 ,0 ,0 ,0 ,4 ,0 ,4,1501 , 0 
2881.35,15,83 ,9 ,1068 ,0 ,0 ,2 ,6 ,0 ,0 ,0 ,8 ,0 ,11 ,0 ,11,1651 , 0 
2881.36,20,83 ,5 ,782 ,0 ,0 ,3 ,0 ,0 ,0 ,0 ,3 ,0 ,3 ,0 ,3,1386 , 0 
2881.36,16,83 ,2 ,512 ,0 ,0 ,3 ,2 ,0 ,0 ,0 ,5 ,0 ,25 ,0 ,25,3759 , 1 
2881.444,10,83 ,14 ,516 ,0 ,0 ,1 ,0 ,0 ,0 ,0 ,1 ,0 ,4 ,0 ,4,1778 , 0 
2881.481,12,83 ,5 ,785 ,0 ,0 ,2 ,0 ,0 ,0 ,0 ,2 ,0 ,2 ,0 ,2,1666 , 0 
2881.596,9,83 ,5 ,782 ,0 ,0 ,8 ,0 ,13 ,0 ,0 ,21 ,0 ,8 ,13 ,21,3360 , 0 
2881.603,5,83 ,13 ,512 ,0 ,0 ,1 ,0 ,13 ,0 ,0 ,14 ,0 ,11 ,13 ,24,2876 , 0 
2881.606,19,83 ,1 ,256 ,0 ,0 ,0 ,0 ,0 ,0 ,0 ,0 ,0 ,6 ,0 ,6,1848 , 0 
2881.696,17,83 ,6 ,789 ,0 ,0 ,7 ,4 ,0 ,0 ,0 ,11 ,0 ,11 ,0 ,11,2516 , 0 
2881.771,13,83 ,1 ,256 ,0 ,0 ,1 ,0 ,13 ,0 ,0 ,14 ,0 ,3 ,13 ,16,1730 , 0 
2881.786,3,83 ,1 ,256 ,0 ,0 ,1 ,0 ,0 ,0 ,0 ,1 ,0 ,1 ,0 ,1,1202 , 0 
3000.96,8,83 ,1 ,256 ,0 ,0 ,1 ,0 ,1 ,0 ,0 ,2 ,0 ,0 ,1 ,1,1331 , 0 
3001.077,11,83 ,5 ,776 ,0 ,0 ,2 ,0 ,0 ,0 ,0 ,2 ,0 ,2 ,0 ,2,2093 , 0 
3001.123,2,83 ,1 ,256 ,0 ,0 ,2 ,0 ,4 ,0 ,0 ,6 ,0 ,2 ,4 ,6,2330 , 0 
3001.138,6,83 ,2 ,512 ,0 ,0 ,1 ,2 ,1 ,0 ,0 ,4 ,0 ,6 ,1 ,7,3105 , 0 
3001.214,18,83 ,19 ,512 ,0 ,0 ,1 ,0 ,0 ,0 ,0 ,1 ,0 ,0 ,0 ,0,2088 , 0 
3001.235,4,83 ,8 ,512 ,0 ,0 ,1 ,1 ,0 ,0 ,0 ,2 ,0 ,2 ,0 ,2,1642 , 0 
3001.289,7,83 ,9 ,1059 ,0 ,0 ,2 ,1 ,0 ,0 ,0 ,3 ,0 ,5 ,0 ,5,3069 , 0 
3001.337,14,83 ,1 ,256 ,0 ,0 ,1 ,0 ,0 ,0 ,0 ,1 ,0 ,2 ,0 ,2,1613 , 0 
3001.35,15,83 ,9 ,1059 ,0 ,0 ,0 ,1 ,0 ,0 ,0 ,1 ,0 ,4 ,0 ,4,2326 , 0 
3001.359,20,83 ,5 ,782 ,0 ,0 ,1 ,0 ,0 ,0 ,0 ,1 ,0 ,1 ,0 ,1,1916 , 0 
3001.36,16,83 ,2 ,512 ,0 ,0 ,1 ,1 ,0 ,0 ,0 ,2 ,0 ,7 ,0 ,7,3986 , 0 
3001.444,10,83 ,14 ,516 ,0 ,0 ,1 ,0 ,0 ,0 ,0 ,1 ,0 ,1 ,0 ,1,1656 , 0 
3001.481,12,83 ,5 ,768 ,0 ,0 ,1 ,0 ,0 ,0 ,0 ,1 ,0 ,2 ,0 ,2,1898 , 0 
3001.595,9,83 ,5 ,782 ,0 ,0 ,2 ,0 ,2 ,0 ,0 ,4 ,0 ,2 ,2 ,4,3491 , 0 
3001.602,5,83 ,13 ,512 ,0 ,0 ,1 ,0 ,2 ,0 ,0 ,3 ,0 ,5 ,2 ,7,3028 , 0 
3001.606,19,83 ,1 ,256 ,0 ,0 ,2 ,0 ,0 ,0 ,0 ,2 ,0 ,2 ,0 ,2,1698 , 0 
3001.696,17,83 ,6 ,786 ,0 ,0 ,4 ,1 ,0 ,0 ,0 ,5 ,0 ,2 ,0 ,2,2351 , 0 
3001.771,13,83 ,1 ,256 ,0 ,0 ,0 ,0 ,2 ,0 ,0 ,2 ,0 ,2 ,2 ,4,1670 , 0 
3001.786,3,83 ,1 ,256 ,0 ,0 ,0 ,0 ,0 ,0 ,0 ,0 ,0 ,0 ,0 ,0,1168 , 0 
3120.96,8,83 ,1 ,256 ,0 ,0 ,1 ,0 ,0 ,0 ,0 ,1 ,0 ,0 ,0 ,0,1494 , 0 
3121.077,11,83 ,5 ,776 ,0 ,0 ,2 ,0 ,0 ,0 ,0 ,2 ,0 ,1 ,0 ,1,1677 , 0 
3121.123,2,83 ,1 ,256 ,0 ,0 ,2 ,0 ,5 ,0 ,0 ,7 ,0 ,4 ,5 ,9,2412 , 0 
3121.138,6,83 ,2 ,512 ,0 ,0 ,3 ,1 ,2 ,0 ,0 ,6 ,0 ,3 ,2 ,5,3514 , 0 
3121.214,18,83 ,19 ,512 ,0 ,0 ,1 ,0 ,0 ,0 ,0 ,1 ,0 ,2 ,0 ,2,1660 , 0 
3121.235,4,83 ,8 ,512 ,0 ,0 ,1 ,0 ,0 ,0 ,0 ,1 ,0 ,0 ,0 ,0,1736 , 0 
3121.289,7,83 ,16 ,771 ,0 ,0 ,6 ,2 ,0 ,1 ,0 ,9 ,0 ,5 ,0 ,5,2827 , 0 
3121.337,14,83 ,1 ,256 ,0 ,0 ,2 ,0 ,0 ,0 ,0 ,2 ,0 ,2 ,0 ,2,1575 , 0 
3121.35,15,83 ,9 ,1099 ,0 ,0 ,1 ,2 ,0 ,0 ,0 ,3 ,0 ,6 ,0 ,6,1745 , 0 
3121.359,20,83 ,5 ,782 ,0 ,0 ,1 ,0 ,0 ,0 ,0 ,1 ,0 ,1 ,0 ,1,1462 , 0 
3121.36,16,83 ,2 ,512 ,0 ,0 ,2 ,1 ,1 ,0 ,0 ,4 ,0 ,8 ,1 ,9,3866 , 0 
3121.444,10,83 ,14 ,512 ,0 ,0 ,0 ,0 ,0 ,0 ,0 ,0 ,0 ,1 ,0 ,1,1828 , 0 
3121.481,12,83 ,5 ,768 ,0 ,0 ,1 ,1 ,0 ,0 ,0 ,2 ,0 ,1 ,0 ,1,1784 , 0 
3121.596,9,83 ,5 ,782 ,0 ,0 ,2 ,0 ,3 ,0 ,1 ,6 ,0 ,6 ,4 ,10,3515 , 0 
3121.602,5,83 ,13 ,512 ,0 ,0 ,0 ,0 ,4 ,0 ,1 ,5 ,0 ,3 ,5 ,8,3026 , 0 
3121.606,19,83 ,1 ,256 ,0 ,0 ,1 ,0 ,0 ,0 ,0 ,1 ,0 ,1 ,0 ,1,1919 , 0 
3121.696,17,83 ,6 ,776 ,0 ,0 ,2 ,2 ,0 ,0 ,0 ,4 ,0 ,7 ,0 ,7,2604 , 0 
3121.771,13,83 ,1 ,256 ,0 ,0 ,1 ,0 ,4 ,0 ,1 ,6 ,0 ,3 ,5 ,8,1818 , 0 
3121.786,3,83 ,1 ,256 ,0 ,0 ,1 ,0 ,0 ,0 ,0 ,1 ,0 ,1 ,0 ,1,1283 , 0 
3240.96,8,83 ,1 ,256 ,0 ,0 ,2 ,0 ,0 ,0 ,0 ,2 ,0 ,2 ,0 ,2,1399 , 0 
3241.077,11,83 ,5 ,776 ,0 ,0 ,0 ,0 ,0 ,0 ,0 ,0 ,0 ,5 ,0 ,5,2153 , 0 
3241.123,2,83 ,1 ,256 ,0 ,0 ,1 ,0 ,0 ,0 ,0 ,1 ,0 ,2 ,0 ,2,2412 , 0 
3241.138,6,83 ,2 ,512 ,0 ,0 ,2 ,0 ,0 ,0 ,0 ,2 ,0 ,2 ,0 ,2,3178 , 0 
3241.214,18,83 ,19 ,512 ,0 ,0 ,1 ,0 ,0 ,0 ,0 ,1 ,0 ,0 ,0 ,0,2143 , 0 
3241.235,4,83 ,8 ,512 ,0 ,0 ,2 ,0 ,0 ,0 ,0 ,2 ,0 ,0 ,0 ,0,1723 , 0 
3241.289,7,83 ,16 ,771 ,0 ,0 ,2 ,0 ,0 ,0 ,0 ,2 ,0 ,2 ,0 ,2,3137 , 0 
3241.337,14,83 ,1 ,256 ,0 ,0 ,0 ,0 ,0 ,0 ,0 ,0 ,0 ,3 ,0 ,3,1700 , 0 
3241.35,15,83 ,9 ,1081 ,0 ,0 ,2 ,0 ,0 ,0 ,0 ,2 ,0 ,3 ,0 ,3,2390 , 0 
3241.359,20,83 ,5 ,782 ,0 ,0 ,1 ,0 ,0 ,0 ,0 ,1 ,0 ,0 ,0 ,0,1980 , 0 
3241.36,16,83 ,2 ,512 ,0 ,0 ,1 ,0 ,0 ,0 ,0 ,1 ,0 ,4 ,0 ,4,4053 , 0 
3241.444,10,83 ,14 ,512 ,0 ,0 ,2 ,0 ,0 ,0 ,0 ,2 ,0 ,1 ,0 ,1,1718 , 0 
3241.481,12,83 ,5 ,768 ,0 ,0 ,1 ,0 ,0 ,0 ,0 ,1 ,0 ,0 ,0 ,0,1956 , 0 
3241.595,9,83 ,5 ,782 ,0 ,0 ,2 ,0 ,0 ,1 ,0 ,3 ,0 ,3 ,0 ,3,3564 , 0 
3241.602,5,83 ,13 ,520 ,0 ,0 ,1 ,0 ,0 ,1 ,0 ,2 ,0 ,3 ,1 ,4,3114 , 0 
3241.606,19,83 ,1 ,256 ,0 ,0 ,2 ,0 ,0 ,0 ,0 ,2 ,0 ,3 ,0 ,3,1783 , 0 
3241.696,17,83 ,6 ,776 ,0 ,0 ,0 ,0 ,0 ,0 ,0 ,0 ,0 ,2 ,0 ,2,2402 , 0 
3241.771,13,83 ,1 ,256 ,0 ,0 ,1 ,0 ,0 ,1 ,0 ,2 ,0 ,0 ,1 ,1,1756 , 0 
3241.786,3,83 ,1 ,256 ,0 ,0 ,1 ,0 ,0 ,0 ,0 ,1 ,0 ,0 ,0 ,0,1226 , 0 
3360.96,8,83 ,1 ,256 ,0 ,0 ,1 ,0 ,0 ,0 ,0 ,1 ,0 ,1 ,0 ,1,1556 , 0 
3361.077,11,83 ,5 ,776 ,0 ,0 ,1 ,0 ,0 ,0 ,0 ,1 ,0 ,0 ,0 ,0,1745 , 0 
3361.123,2,83 ,1 ,256 ,0 ,0 ,2 ,0 ,2 ,0 ,0 ,4 ,0 ,2 ,2 ,4,2493 , 0 
3361.138,6,83 ,2 ,512 ,0 ,0 ,1 ,1 ,0 ,0 ,0 ,2 ,0 ,3 ,0 ,3,3590 , 0 
3361.214,18,83 ,19 ,512 ,0 ,0 ,1 ,0 ,0 ,0 ,0 ,1 ,0 ,0 ,0 ,0,1723 , 0 
3361.235,4,83 ,8 ,512 ,0 ,0 ,0 ,0 ,0 ,0 ,0 ,0 ,0 ,1 ,0 ,1,1785 , 0 
3361.289,7,83 ,16 ,771 ,0 ,0 ,2 ,0 ,0 ,0 ,0 ,2 ,0 ,2 ,0 ,2,2910 , 0 
3361.337,14,83 ,1 ,256 ,0 ,0 ,1 ,0 ,0 ,0 ,0 ,1 ,0 ,1 ,0 ,1,1638 , 0 
3361.35,15,83 ,9 ,1081 ,0 ,0 ,1 ,0 ,0 ,0 ,0 ,1 ,0 ,1 ,0 ,1,1819 , 0 
3361.359,20,83 ,5 ,782 ,0 ,0 ,1 ,0 ,0 ,0 ,0 ,1 ,0 ,0 ,0 ,0,1515 , 0 
3361.36,16,83 ,2 ,512 ,0 ,0 ,1 ,1 ,0 ,0 ,0 ,2 ,0 ,5 ,0 ,5,3946 , 1 
3361.444,10,83 ,14 ,512 ,0 ,0 ,1 ,0 ,0 ,0 ,0 ,1 ,0 ,0 ,0 ,0,1883 , 0 
3361.481,12,83 ,5 ,768 ,0 ,0 ,1 ,0 ,0 ,0 ,0 ,1 ,0 ,2 ,0 ,2,1869 , 0 
3361.595,9,83 ,5 ,782 ,0 ,0 ,0 ,0 ,0 ,0 ,0 ,0 ,0 ,1 ,0 ,1,3571 , 0 
3361.602,5,83 ,13 ,520 ,0 ,0 ,1 ,0 ,0 ,0 ,0 ,1 ,0 ,2 ,0 ,2,3111 , 0 
3361.606,19,83 ,1 ,256 ,0 ,0 ,0 ,0 ,0 ,0 ,0 ,0 ,0 ,4 ,0 ,4,1996 , 0 
3361.696,17,83 ,6 ,776 ,0 ,0 ,3 ,0 ,0 ,0 ,0 ,3 ,0 ,3 ,0 ,3,2697 , 0 
3361.771,13,83 ,1 ,256 ,0 ,0 ,1 ,0 ,0 ,0 ,0 ,1 ,0 ,1 ,0 ,1,1886 , 0 
3361.786,3,83 ,1 ,256 ,0 ,0 ,1 ,0 ,0 ,0 ,0 ,1 ,0 ,1 ,0 ,1,1335 , 0 
3480.96,8,83 ,1 ,256 ,0 ,0 ,2 ,0 ,0 ,0 ,0 ,2 ,0 ,1 ,0 ,1,1461 , 0 
3481.077,11,83 ,5 ,776 ,0 ,0 ,1 ,0 ,0 ,0 ,0 ,1 ,0 ,2 ,0 ,2,2226 , 0 
3481.123,2,83 ,1 ,256 ,0 ,0 ,1 ,0 ,0 ,0 ,0 ,1 ,0 ,1 ,0 ,1,2489 , 0 
3481.138,6,83 ,2 ,512 ,0 ,0 ,1 ,0 ,0 ,0 ,0 ,1 ,0 ,0 ,0 ,0,3242 , 0 
3481.214,18,83 ,19 ,512 ,0 ,0 ,1 ,0 ,0 ,0 ,0 ,1 ,0 ,2 ,0 ,2,2209 , 0 
3481.235,4,83 ,8 ,512 ,0 ,0 ,2 ,0 ,0 ,0 ,0 ,2 ,0 ,2 ,0 ,2,1811 , 0 
3481.289,7,83 ,16 ,771 ,0 ,0 ,2 ,0 ,0 ,0 ,0 ,2 ,0 ,3 ,0 ,3,3226 , 0 
3481.337,14,83 ,1 ,256 ,0 ,0 ,2 ,0 ,0 ,0 ,0 ,2 ,0 ,2 ,0 ,2,1784 , 0 
3481.35,15,83 ,9 ,1081 ,0 ,0 ,2 ,0 ,0 ,0 ,0 ,2 ,0 ,1 ,0 ,1,2476 , 0 
3481.359,20,83 ,5 ,782 ,0 ,0 ,1 ,0 ,0 ,0 ,0 ,1 ,0 ,0 ,0 ,0,2042 , 0 
3481.36,16,83 ,2 ,512 ,0 ,0 ,1 ,0 ,0 ,0 ,0 ,1 ,0 ,1 ,0 ,1,4140 , 1 
3481.444,10,83 ,14 ,512 ,0 ,0 ,1 ,0 ,0 ,0 ,0 ,1 ,0 ,1 ,0 ,1,1769 , 0 
3481.481,12,83 ,5 ,768 ,0 ,0 ,1 ,0 ,0 ,0 ,0 ,1 ,0 ,1 ,0 ,1,2035 , 0 
3481.595,9,83 ,5 ,776 ,0 ,0 ,1 ,1 ,0 ,0 ,0 ,2 ,0 ,4 ,0 ,4,3691 , 0 
3481.602,5,83 ,13 ,520 ,0 ,0 ,1 ,0 ,1 ,0 ,0 ,2 ,0 ,2 ,1 ,3,3218 , 0 
3481.606,19,83 ,1 ,256 ,0 ,0 ,2 ,0 ,0 ,0 ,0 ,2 ,0 ,2 ,0 ,2,1866 , 0 
3481.696,17,83 ,6 ,776 ,0 ,0 ,1 ,0 ,0 ,0 ,0 ,1 ,0 ,1 ,0 ,1,2455 , 0 
3481.771,13,83 ,1 ,256 ,0 ,0 ,1 ,0 ,1 ,0 ,0 ,2 ,0 ,2 ,1 ,3,1837 , 0 
3481.786,3,83 ,1 ,256 ,0 ,0 ,1 ,0 ,0 ,0 ,0 ,1 ,0 ,1 ,0 ,1,1295 , 0 
3600.96,8,83 ,1 ,256 ,0 ,0 ,1 ,0 ,1 ,0 ,0 ,2 ,0 ,2 ,1 ,3,1632 , 0 
3601.077,11,83 ,5 ,776 ,0 ,0 ,1 ,0 ,0 ,0 ,0 ,1 ,0 ,4 ,0 ,4,1810 , 0 
3601.123,2,83 ,1 ,256 ,0 ,0 ,1 ,0 ,0 ,0 ,1 ,2 ,0 ,2 ,1 ,3,2568 , 0 
3601.138,6,83 ,2 ,512 ,0 ,0 ,0 ,0 ,0 ,0 ,0 ,0 ,0 ,4 ,0 ,4,3654 , 0 
3601.214,18,83 ,19 ,512 ,0 ,0 ,2 ,0 ,0 ,0 ,0 ,2 ,0 ,2 ,0 ,2,1805 , 0 
3601.235,4,83 ,8 ,512 ,0 ,0 ,1 ,1 ,0 ,0 ,0 ,2 ,0 ,2 ,0 ,2,1856 , 0 
3601.289,7,83 ,16 ,4000 ,0 ,0 ,1 ,0 ,0 ,1 ,0 ,2 ,0 ,2 ,0 ,2,2970 , 0 
3601.337,14,83 ,1 ,256 ,0 ,0 ,0 ,0 ,0 ,0 ,0 ,0 ,0 ,2 ,0 ,2,1707 , 0 
3601.35,15,83 ,9 ,1081 ,0 ,0 ,1 ,0 ,0 ,0 ,0 ,1 ,0 ,1 ,0 ,1,1876 , 0 
3601.359,20,83 ,5 ,782 ,0 ,0 ,2 ,0 ,0 ,0 ,0 ,2 ,0 ,2 ,0 ,2,1588 , 0 
3601.36,16,83 ,2 ,512 ,0 ,0 ,2 ,0 ,0 ,0 ,1 ,3 ,0 ,2 ,1 ,3,4018 , 1 
3601.444,10,83 ,14 ,512 ,0 ,0 ,1 ,0 ,0 ,0 ,0 ,1 ,0 ,0 ,0 ,0,1955 , 0 
3601.481,12,83 ,5 ,768 ,0 ,0 ,1 ,0 ,0 ,0 ,0 ,1 ,0 ,2 ,0 ,2,1929 , 0 
3601.595,9,83 ,5 ,776 ,0 ,0 ,2 ,0 ,0 ,0 ,0 ,2 ,0 ,2 ,0 ,2,3636 , 0 
3601.602,5,83 ,13 ,520 ,0 ,0 ,1 ,0 ,0 ,0 ,0 ,1 ,0 ,4 ,0 ,4,3182 , 0 
3601.606,19,83 ,1 ,256 ,0 ,0 ,1 ,0 ,0 ,0 ,0 ,1 ,0 ,3 ,0 ,3,2074 , 0 
3601.696,17,83 ,6 ,776 ,0 ,0 ,2 ,0 ,0 ,0 ,0 ,2 ,0 ,2 ,0 ,2,2753 , 0 
3601.771,13,83 ,1 ,256 ,0 ,0 ,0 ,0 ,0 ,0 ,0 ,0 ,0 ,0 ,0 ,0,1955 , 0 
3601.786,3,83 ,1 ,256 ,0 ,0 ,2 ,0 ,0 ,0 ,0 ,2 ,0 ,0 ,0 ,0,1407 , 0 
3720.96,8,83 ,1 ,256 ,0 ,0 ,1 ,0 ,0 ,0 ,0 ,1 ,0 ,2 ,0 ,2,1517 , 0 
3721.077,11,83 ,5 ,776 ,0 ,0 ,2 ,0 ,0 ,0 ,0 ,2 ,0 ,0 ,0 ,0,2293 , 0 
3721.123,2,83 ,1 ,256 ,0 ,0 ,0 ,0 ,2 ,1 ,0 ,3 ,0 ,2 ,3 ,5,2577 , 0 
3721.138,6,83 ,2 ,512 ,0 ,0 ,2 ,0 ,2 ,0 ,0 ,4 ,0 ,2 ,2 ,4,3342 , 0 
3721.214,18,83 ,19 ,512 ,0 ,0 ,1 ,0 ,0 ,0 ,0 ,1 ,0 ,2 ,0 ,2,2266 , 0 
3721.235,4,83 ,8 ,512 ,0 ,0 ,2 ,0 ,0 ,0 ,0 ,2 ,0 ,1 ,0 ,1,1870 , 0 
3721.289,7,83 ,17 ,1048 ,0 ,0 ,4 ,1 ,0 ,0 ,0 ,5 ,0 ,1 ,0 ,1,3327 , 0 
3721.337,14,83 ,1 ,256 ,0 ,0 ,1 ,0 ,0 ,0 ,0 ,1 ,0 ,1 ,0 ,1,1852 , 0 
3721.35,15,83 ,9 ,1081 ,0 ,0 ,1 ,0 ,0 ,0 ,0 ,1 ,0 ,5 ,0 ,5,2542 , 0 
3721.359,20,83 ,5 ,782 ,0 ,0 ,1 ,0 ,0 ,0 ,0 ,1 ,0 ,2 ,0 ,2,2104 , 0 
3721.36,16,83 ,2 ,512 ,0 ,0 ,2 ,0 ,0 ,1 ,0 ,3 ,0 ,7 ,0 ,7,4227 , 0 
3721.444,10,83 ,14 ,512 ,0 ,0 ,1 ,0 ,0 ,0 ,0 ,1 ,0 ,1 ,0 ,1,1823 , 0 
3721.481,12,83 ,5 ,768 ,0 ,0 ,1 ,0 ,0 ,0 ,0 ,1 ,0 ,3 ,0 ,3,2132 , 0 
3721.595,9,83 ,5 ,776 ,0 ,0 ,1 ,0 ,0 ,0 ,0 ,1 ,0 ,6 ,0 ,6,3768 , 0 
3721.602,5,83 ,13 ,520 ,0 ,0 ,1 ,0 ,0 ,0 ,0 ,1 ,0 ,1 ,0 ,1,3311 , 0 
3721.606,19,83 ,1 ,256 ,0 ,0 ,1 ,0 ,0 ,0 ,0 ,1 ,0 ,1 ,0 ,1,1936 , 0 
3721.696,17,83 ,6 ,770 ,0 ,0 ,2 ,1 ,1 ,0 ,0 ,4 ,0 ,6 ,1 ,7,2561 , 0 
3721.771,13,83 ,1 ,256 ,0 ,0 ,1 ,0 ,0 ,0 ,0 ,1 ,0 ,1 ,0 ,1,1906 , 0 
3721.786,3,83 ,1 ,256 ,0 ,0 ,0 ,0 ,0 ,0 ,0 ,0 ,0 ,0 ,0 ,0,1344 , 0 
3840.96,8,83 ,1 ,256 ,0 ,0 ,2 ,0 ,0 ,0 ,0 ,2 ,0 ,1 ,0 ,1,1691 , 0 
3841.077,11,83 ,5 ,776 ,0 ,0 ,1 ,0 ,0 ,0 ,0 ,1 ,0 ,3 ,0 ,3,1889 , 0 
3841.123,2,83 ,1 ,256 ,0 ,0 ,1 ,0 ,1 ,0 ,1 ,3 ,0 ,2 ,3 ,5,2652 , 0 
3841.138,6,83 ,2 ,512 ,0 ,0 ,1 ,0 ,0 ,1 ,1 ,3 ,0 ,0 ,2 ,2,3766 , 0 
3841.214,18,83 ,19 ,512 ,0 ,0 ,2 ,0 ,0 ,0 ,0 ,2 ,0 ,2 ,0 ,2,1870 , 0 
3841.235,4,83 ,8 ,512 ,0 ,0 ,1 ,0 ,0 ,0 ,0 ,1 ,0 ,1 ,0 ,1,1908 , 0 
3841.289,7,83 ,16 ,768 ,0 ,0 ,5 ,1 ,0 ,1 ,0 ,7 ,0 ,3 ,0 ,3,3078 , 0 
3841.337,14,83 ,1 ,256 ,0 ,0 ,2 ,0 ,0 ,0 ,0 ,2 ,0 ,2 ,0 ,2,1767 , 0 
3841.35,15,83 ,9 ,1053 ,0 ,0 ,0 ,1 ,0 ,0 ,0 ,1 ,0 ,6 ,0 ,6,1969 , 0 
3841.359,20,83 ,5 ,782 ,0 ,0 ,1 ,0 ,0 ,0 ,0 ,1 ,0 ,1 ,0 ,1,1650 , 0 
3841.36,16,83 ,2 ,512 ,0 ,0 ,2 ,0 ,1 ,0 ,0 ,3 ,0 ,7 ,1 ,8,4124 , 0 
3841.444,10,83 ,14 ,512 ,0 ,0 ,1 ,0 ,0 ,0 ,0 ,1 ,0 ,1 ,0 ,1,2009 , 0 
3841.481,12,83 ,5 ,768 ,0 ,0 ,2 ,0 ,0 ,0 ,0 ,2 ,0 ,1 ,0 ,1,1997 , 0 
3841.595,9,83 ,5 ,776 ,0 ,0 ,2 ,0 ,1 ,0 ,0 ,3 ,0 ,5 ,1 ,6,3734 , 0 
3841.602,5,83 ,13 ,520 ,0 ,0 ,1 ,0 ,1 ,0 ,0 ,2 ,0 ,3 ,1 ,4,3302 , 0 
3841.606,19,83 ,1 ,256 ,0 ,0 ,1 ,0 ,0 ,0 ,0 ,1 ,0 ,0 ,0 ,0,2150 , 0 
3841.696,17,83 ,6 ,770 ,0 ,0 ,1 ,0 ,0 ,1 ,1 ,3 ,0 ,5 ,1 ,6,2824 , 0 
3841.771,13,83 ,1 ,256 ,0 ,0 ,1 ,0 ,1 ,0 ,0 ,2 ,0 ,2 ,1 ,3,2020 , 0 
3841.786,3,83 ,1 ,256 ,0 ,0 ,2 ,0 ,0 ,0 ,0 ,2 ,0 ,3 ,0 ,3,1463 , 0 
3960.96,8,83 ,1 ,256 ,0 ,0 ,1 ,0 ,0 ,0 ,0 ,1 ,0 ,0 ,0 ,0,1578 , 0 
3961.077,11,83 ,5 ,776 ,0 ,0 ,1 ,0 ,0 ,0 ,0 ,1 ,0 ,1 ,0 ,1,2357 , 0 
3961.123,2,83 ,1 ,256 ,0 ,0 ,2 ,0 ,2 ,0 ,0 ,4 ,0 ,1 ,2 ,3,2658 , 0 
3961.138,6,83 ,2 ,512 ,0 ,0 ,2 ,1 ,0 ,0 ,0 ,3 ,0 ,1 ,0 ,1,3422 , 0 
3961.214,18,83 ,19 ,512 ,0 ,0 ,0 ,0 ,0 ,0 ,0 ,0 ,0 ,0 ,0 ,0,2324 , 0 
3961.235,4,83 ,8 ,512 ,0 ,0 ,1 ,0 ,0 ,0 ,0 ,1 ,0 ,0 ,0 ,0,1951 , 0 
3961.289,7,83 ,16 ,768 ,0 ,0 ,2 ,0 ,0 ,0 ,0 ,2 ,0 ,1 ,0 ,1,3400 , 0 
3961.337,14,83 ,1 ,256 ,0 ,0 ,1 ,0 ,0 ,0 ,0 ,1 ,0 ,3 ,0 ,3,1949 , 0 
3961.35,15,83 ,9 ,1050 ,0 ,0 ,1 ,1 ,0 ,0 ,0 ,2 ,0 ,2 ,0 ,2,2615 , 0 
3961.359,20,83 ,5 ,782 ,0 ,0 ,2 ,0 ,0 ,0 ,0 ,2 ,0 ,1 ,0 ,1,2176 , 0 
3961.36,16,83 ,2 ,512 ,0 ,0 ,1 ,1 ,0 ,0 ,0 ,2 ,0 ,4 ,0 ,4,4297 , 0 
3961.444,10,83 ,14 ,512 ,0 ,0 ,1 ,0 ,0 ,0 ,0 ,1 ,0 ,1 ,0 ,1,1890 , 0 
3961.481,12,83 ,5 ,768 ,0 ,0 ,1 ,0 ,0 ,0 ,0 ,1 ,0 ,1 ,0 ,1,2185 , 0 
3961.595,9,83 ,5 ,776 ,0 ,0 ,1 ,0 ,1 ,0 ,0 ,2 ,0 ,2 ,1 ,3,3839 , 0 
3961.602,5,83 ,13 ,520 ,0 ,0 ,0 ,0 ,1 ,0 ,0 ,1 ,0 ,2 ,1 ,3,3377 , 0 
3961.606,19,83 ,1 ,256 ,0 ,0 ,1 ,0 ,0 ,0 ,0 ,1 ,0 ,4 ,0 ,4,2031 , 0 
3961.696,17,83 ,6 ,770 ,0 ,0 ,1 ,0 ,0 ,0 ,0 ,1 ,0 ,2 ,0 ,2,2631 , 0 
3961.771,13,83 ,1 ,256 ,0 ,0 ,1 ,0 ,1 ,0 ,0 ,2 ,0 ,2 ,1 ,3,2006 , 0 
3961.786,3,83 ,1 ,256 ,0 ,0 ,0 ,0 ,0 ,0 ,0 ,0 ,0 ,0 ,0 ,0,1399 , 0 
4080.96,8,100 ,1 ,256 ,0 ,0 ,11 ,5 ,1 ,6 ,1 ,24 ,0 ,28 ,4 ,32,1929 , 0 
4081.078,11,107 ,5 ,998 ,0 ,0 ,15 ,1 ,0 ,3 ,0 ,19 ,0 ,42 ,3 ,45,2227 , 0 
4081.142,6,107 ,2 ,512 ,0 ,0 ,14 ,2 ,0 ,7 ,1 ,24 ,0 ,28 ,1 ,29,4130 , 0 
4081.185,2,107 ,1 ,256 ,0 ,0 ,12 ,3 ,6 ,7 ,4 ,32 ,0 ,37 ,17 ,54,3108 , 0 
4081.214,18,100 ,19 ,512 ,0 ,0 ,14 ,5 ,3 ,9 ,2 ,33 ,0 ,31 ,5 ,36,2377 , 0 
4081.236,4,100 ,19 ,512 ,0 ,0 ,10 ,6 ,0 ,8 ,0 ,24 ,0 ,18 ,0 ,18,2324 , 0 
4081.292,7,110 ,16 ,65535 ,0 ,0 ,14 ,0 ,1 ,1 ,0 ,16 ,0 ,22 ,9 ,31,3314 , 1 
4081.338,14,103 ,1 ,256 ,0 ,0 ,12 ,7 ,2 ,11 ,2 ,34 ,0 ,27 ,4 ,31,2183 , 0 
4081.35,15,105 ,7 ,1052 ,0 ,0 ,14 ,0 ,0 ,2 ,0 ,16 ,0 ,31 ,2 ,33,2166 , 0 
4081.36,20,107 ,5 ,998 ,0 ,0 ,12 ,3 ,1 ,5 ,0 ,21 ,0 ,30 ,2 ,32,2032 , 0 
4081.39,16,109 ,2 ,512 ,0 ,0 ,13 ,1 ,0 ,3 ,0 ,17 ,0 ,31 ,8 ,39,4401 , 0 
4081.444,10,103 ,14 ,512 ,0 ,0 ,9 ,3 ,0 ,4 ,0 ,16 ,0 ,17 ,1 ,18,2308 , 0 
4081.482,12,100 ,18 ,998 ,0 ,0 ,12 ,4 ,1 ,4 ,1 ,22 ,0 ,36 ,5 ,41,2491 , 0 
4081.596,9,109 ,7 ,1052 ,0 ,0 ,13 ,1 ,1 ,2 ,4 ,21 ,0 ,35 ,5 ,40,4021 , 0 
4081.608,19,100 ,1 ,256 ,0 ,0 ,12 ,5 ,6 ,11 ,3 ,37 ,0 ,37 ,20 ,57,2624 , 0 
4081.619,5,100 ,2 ,512 ,0 ,0 ,15 ,3 ,1 ,7 ,4 ,30 ,0 ,51 ,11 ,62,3845 , 0 
4081.697,17,107 ,7 ,1052 ,0 ,0 ,14 ,1 ,0 ,2 ,0 ,17 ,0 ,30 ,0 ,30,3042 , 0 
4081.771,13,100 ,1 ,256 ,0 ,0 ,13 ,5 ,0 ,8 ,2 ,28 ,0 ,29 ,4 ,33,2477 , 0 
4081.787,3,100 ,1 ,256 ,0 ,0 ,10 ,6 ,1 ,6 ,1 ,24 ,0 ,15 ,2 ,17,1667 , 0 
4200.961,8,152 ,1 ,256 ,0 ,0 ,15 ,9 ,5 ,11 ,4 ,44 ,0 ,53 ,10 ,63,1868 , 0 
4201.078,11,151 ,12 ,1024 ,0 ,0 ,20 ,1 ,0 ,2 ,0 ,23 ,0 ,69 ,0 ,69,2618 , 0 
4201.124,2,152 ,1 ,256 ,0 ,0 ,19 ,6 ,3 ,8 ,3 ,39 ,0 ,73 ,8 ,81,2991 , 0 
4201.194,6,151 ,10 ,768 ,0 ,0 ,19 ,2 ,0 ,3 ,0 ,24 ,0 ,47 ,2 ,49,3773 , 0 
4201.214,18,151 ,19 ,768 ,0 ,0 ,18 ,3 ,2 ,8 ,0 ,31 ,0 ,53 ,7 ,60,2734 , 0 
4201.236,4,147 ,0 ,0 ,0 ,0 ,18 ,9 ,1 ,10 ,1 ,39 ,0 ,32 ,3 ,35,2351 , 0 
4201.29,7,154 ,16 ,65535 ,0 ,0 ,22 ,0 ,0 ,0 ,0 ,22 ,0 ,44 ,0 ,44,3620 , 1 
4201.338,14,152 ,1 ,256 ,0 ,0 ,17 ,9 ,2 ,11 ,2 ,41 ,0 ,54 ,7 ,61,2301 , 0 
4201.35,15,153 ,7 ,1052 ,0 ,0 ,20 ,0 ,0 ,0 ,0 ,20 ,0 ,46 ,0 ,46,2820 , 0 
4201.36,20,151 ,5 ,1024 ,0 ,0 ,19 ,3 ,0 ,3 ,0 ,25 ,0 ,40 ,0 ,40,2478 , 0 
4201.361,16,153 ,2 ,512 ,0 ,0 ,19 ,0 ,0 ,0 ,0 ,19 ,0 ,52 ,0 ,52,4514 , 0 
4201.444,10,152 ,0 ,0 ,0 ,0 ,17 ,3 ,1 ,6 ,0 ,27 ,0 ,26 ,2 ,28,2189 , 0 
4201.482,12,151 ,18 ,1024 ,0 ,0 ,19 ,3 ,0 ,5 ,0 ,27 ,0 ,51 ,3 ,54,2554 , 0 
4201.596,9,153 ,7 ,1052 ,0 ,0 ,21 ,0 ,0 ,0 ,0 ,21 ,0 ,62 ,0 ,62,4070 , 0 
4201.602,5,152 ,0 ,0 ,0 ,0 ,20 ,2 ,3 ,6 ,1 ,32 ,0 ,83 ,7 ,90,3809 , 0 
4201.607,19,152 ,8 ,512 ,0 ,0 ,20 ,4 ,9 ,8 ,4 ,45 ,0 ,72 ,26 ,98,2431 , 0 
4201.697,17,153 ,7 ,1052 ,0 ,0 ,21 ,0 ,0 ,0 ,0 ,21 ,0 ,42 ,0 ,42,2847 , 0 
4201.771,13,152 ,1 ,256 ,0 ,0 ,19 ,7 ,0 ,7 ,0 ,33 ,0 ,59 ,1 ,60,2288 , 0 
4201.787,3,152 ,1 ,256 ,0 ,0 ,16 ,12 ,0 ,11 ,0 ,39 ,0 ,35 ,3 ,38,1752 , 0 
4320.96,8,186 ,1 ,256 ,0 ,0 ,15 ,9 ,9 ,8 ,5 ,46 ,0 ,40 ,15 ,55,2259 , 0 
4321.078,11,187 ,12 ,1024 ,0 ,0 ,21 ,0 ,0 ,0 ,0 ,21 ,0 ,60 ,0 ,60,2465 , 0 
4321.124,2,185 ,1 ,256 ,0 ,0 ,18 ,5 ,7 ,8 ,3 ,41 ,0 ,62 ,17 ,79,3540 , 0 
4321.138,6,187 ,2 ,512 ,0 ,0 ,20 ,3 ,2 ,3 ,2 ,30 ,0 ,46 ,6 ,52,4476 , 0 
4321.214,18,187 ,19 ,768 ,0 ,0 ,18 ,4 ,1 ,8 ,1 ,32 ,0 ,45 ,2 ,47,2777 , 0 
4321.236,4,184 ,0 ,0 ,0 ,0 ,14 ,9 ,2 ,6 ,1 ,32 ,0 ,27 ,3 ,30,2771 , 0 
4321.29,7,192 ,16 ,65535 ,0 ,0 ,19 ,0 ,0 ,0 ,0 ,19 ,0 ,41 ,0 ,41,3519 , 1 
4321.338,14,185 ,1 ,256 ,0 ,0 ,15 ,8 ,3 ,9 ,3 ,38 ,0 ,40 ,7 ,47,2480 , 0 
4321.35,15,187 ,7 ,1052 ,0 ,0 ,18 ,0 ,0 ,0 ,0 ,18 ,0 ,37 ,0 ,37,2355 , 0 
4321.36,20,185 ,5 ,768 ,0 ,0 ,19 ,1 ,0 ,2 ,0 ,22 ,0 ,36 ,0 ,36,2305 , 0 
4321.361,16,187 ,2 ,512 ,0 ,0 ,19 ,1 ,0 ,4 ,0 ,24 ,0 ,42 ,0 ,42,4733 , 0 
4321.444,10,185 ,14 ,512 ,0 ,0 ,13 ,3 ,0 ,4 ,1 ,21 ,0 ,20 ,1 ,21,2549 , 0 
4321.482,12,185 ,5 ,768 ,0 ,0 ,21 ,2 ,0 ,3 ,0 ,26 ,0 ,41 ,0 ,41,2778 , 0 
4321.596,9,187 ,5 ,1228 ,0 ,0 ,20 ,0 ,0 ,1 ,0 ,21 ,0 ,51 ,0 ,51,4292 , 0 
4321.606,5,187 ,19 ,512 ,0 ,0 ,21 ,2 ,1 ,9 ,1 ,34 ,0 ,72 ,8 ,80,4313 , 0 
4321.612,19,186 ,1 ,256 ,0 ,0 ,17 ,8 ,7 ,12 ,5 ,49 ,0 ,67 ,21 ,88,3101 , 0 
4321.697,17,187 ,6 ,822 ,0 ,0 ,19 ,1 ,0 ,2 ,0 ,22 ,0 ,32 ,0 ,32,3305 , 0 
4321.778,13,187 ,0 ,0 ,0 ,0 ,17 ,8 ,0 ,8 ,0 ,33 ,0 ,48 ,3 ,51,2824 , 0 
4321.8,3,185 ,0 ,0 ,0 ,0 ,14 ,9 ,2 ,9 ,1 ,35 ,0 ,27 ,4 ,31,1918 , 0 
4440.96,8,194 ,1 ,256 ,0 ,0 ,6 ,3 ,1 ,4 ,0 ,14 ,0 ,15 ,2 ,17,2055 , 0 
4441.078,11,194 ,12 ,1102 ,0 ,0 ,11 ,7 ,6 ,4 ,2 ,30 ,0 ,34 ,9 ,43,3169 , 0 
4441.124,2,194 ,1 ,256 ,0 ,0 ,9 ,3 ,16 ,2 ,4 ,34 ,0 ,37 ,23 ,60,3319 , 0 
4441.138,6,194 ,17 ,1852 ,0 ,0 ,15 ,5 ,0 ,6 ,0 ,26 ,0 ,28 ,2 ,30,4184 , 0 
4441.214,18,194 ,19 ,662 ,0 ,0 ,11 ,6 ,13 ,5 ,2 ,37 ,0 ,21 ,19 ,40,3317 , 0 
4441.236,4,194 ,8 ,588 ,0 ,0 ,11 ,6 ,0 ,5 ,0 ,22 ,0 ,14 ,0 ,14,2722 , 0 
4441.29,7,194 ,16 ,1217 ,0 ,0 ,11 ,4 ,1 ,2 ,0 ,18 ,0 ,22 ,1 ,23,4045 , 0 
4441.338,14,194 ,1 ,256 ,0 ,0 ,9 ,3 ,7 ,2 ,3 ,24 ,0 ,25 ,12 ,37,2701 , 0 
4441.35,15,194 ,11 ,1188 ,0 ,0 ,10 ,5 ,2 ,1 ,2 ,20 ,0 ,20 ,4 ,24,3230 , 0 
4441.36,20,194 ,12 ,1102 ,0 ,0 ,12 ,6 ,6 ,3 ,2 ,29 ,0 ,20 ,8 ,28,2945 , 0 
4441.361,16,194 ,2 ,525 ,0 ,0 ,10 ,4 ,7 ,0 ,1 ,22 ,0 ,24 ,10 ,34,4991 , 0 
4441.444,10,194 ,14 ,512 ,0 ,0 ,11 ,5 ,0 ,3 ,0 ,19 ,0 ,14 ,1 ,15,2482 , 0 
4441.482,12,194 ,18 ,1047 ,0 ,0 ,7 ,5 ,8 ,1 ,2 ,23 ,0 ,23 ,14 ,37,3054 , 0 
4441.606,9,194 ,7 ,2005 ,0 ,0 ,16 ,7 ,1 ,7 ,0 ,31 ,0 ,27 ,1 ,28,4747 , 0 
4441.607,19,194 ,1 ,256 ,0 ,0 ,7 ,3 ,23 ,2 ,5 ,40 ,0 ,31 ,34 ,65,2749 , 0 
4441.61,5,194 ,19 ,662 ,0 ,0 ,13 ,8 ,9 ,7 ,0 ,37 ,0 ,39 ,17 ,56,4441 , 0 
4441.697,17,194 ,16 ,1217 ,0 ,0 ,11 ,3 ,2 ,2 ,0 ,18 ,0 ,19 ,5 ,24,3243 , 0 
4441.771,13,194 ,14 ,512 ,0 ,0 ,9 ,5 ,0 ,3 ,0 ,17 ,0 ,23 ,2 ,25,2602 , 0 
4441.787,3,194 ,1 ,256 ,0 ,0 ,10 ,6 ,0 ,3 ,0 ,19 ,0 ,12 ,0 ,12,1987 , 0 
4560.96,8,194 ,1 ,256 ,0 ,0 ,3 ,2 ,0 ,0 ,0 ,5 ,0 ,9 ,0 ,9,2358 , 0 
4561.078,11,194 ,12 ,1133 ,0 ,0 ,4 ,2 ,3 ,0 ,0 ,9 ,0 ,21 ,3 ,24,2595 , 0 
4561.124,2,194 ,1 ,256 ,0 ,0 ,1 ,2 ,4 ,2 ,1 ,10 ,0 ,11 ,6 ,17,3640 , 0 
4561.138,6,194 ,17 ,1596 ,0 ,0 ,2 ,1 ,0 ,0 ,0 ,3 ,0 ,5 ,0 ,5,4548 , 0 
4561.214,18,194 ,19 ,515 ,0 ,0 ,3 ,2 ,8 ,1 ,1 ,15 ,0 ,9 ,10 ,19,2957 , 0 
4561.235,4,194 ,8 ,588 ,0 ,0 ,3 ,0 ,0 ,0 ,0 ,3 ,0 ,3 ,0 ,3,2849 , 0 
4561.289,7,194 ,16 ,1010 ,0 ,0 ,2 ,2 ,0 ,1 ,1 ,6 ,0 ,10 ,1 ,11,3645 , 0 
4561.35,15,194 ,11 ,1510 ,0 ,0 ,2 ,2 ,1 ,0 ,0 ,5 ,0 ,9 ,1 ,10,2463 , 0 
4561.355,14,194 ,1 ,256 ,0 ,0 ,3 ,1 ,5 ,0 ,0 ,9 ,0 ,5 ,5 ,10,2573 , 0 
4561.36,20,194 ,12 ,1133 ,0 ,0 ,8 ,4 ,0 ,4 ,0 ,16 ,0 ,7 ,0 ,7,2539 , 0 
4561.36,16,194 ,2 ,525 ,0 ,0 ,2 ,0 ,4 ,1 ,1 ,8 ,0 ,8 ,6 ,14,4884 , 0 
4561.444,10,194 ,14 ,512 ,0 ,0 ,2 ,3 ,0 ,0 ,0 ,5 ,0 ,4 ,0 ,4,2635 , 0 
4561.482,12,194 ,18 ,855 ,0 ,0 ,3 ,2 ,6 ,1 ,1 ,13 ,0 ,14 ,7 ,21,2940 , 0 
4561.596,9,194 ,15 ,1635 ,0 ,0 ,7 ,1 ,0 ,1 ,0 ,9 ,0 ,9 ,0 ,9,4419 , 0 
4561.603,5,194 ,19 ,515 ,0 ,0 ,4 ,1 ,3 ,1 ,2 ,11 ,0 ,20 ,5 ,25,4504 , 0 
4561.607,19,194 ,1 ,256 ,0 ,0 ,4 ,1 ,14 ,1 ,2 ,22 ,0 ,13 ,19 ,32,3233 , 0 
4561.696,17,194 ,16 ,1065 ,0 ,0 ,2 ,1 ,1 ,0 ,0 ,4 ,0 ,4 ,1 ,5,3374 , 0 
4561.771,13,194 ,14 ,512 ,0 ,0 ,2 ,2 ,0 ,0 ,0 ,4 ,0 ,7 ,0 ,7,2915 , 0 
4561.786,3,194 ,1 ,256 ,0 ,0 ,2 ,2 ,0 ,0 ,0 ,4 ,0 ,5 ,0 ,5,2002 , 0 
4680.96,8,194 ,1 ,256 ,0 ,0 ,1 ,0 ,1 ,0 ,0 ,2 ,0 ,3 ,1 ,4,2119 , 0 
4681.078,11,194 ,12 ,1133 ,0 ,0 ,1 ,0 ,1 ,1 ,1 ,4 ,0 ,11 ,3 ,14,3254 , 0 
4681.123,2,194 ,1 ,256 ,0 ,0 ,2 ,0 ,5 ,0 ,0 ,7 ,0 ,4 ,5 ,9,3400 , 0 
4681.138,6,194 ,17 ,1568 ,0 ,0 ,2 ,1 ,0 ,0 ,0 ,3 ,0 ,6 ,0 ,6,4293 , 0 
4681.214,18,194 ,19 ,515 ,0 ,0 ,2 ,0 ,3 ,1 ,1 ,7 ,0 ,3 ,5 ,8,3453 , 0 
4681.235,4,194 ,8 ,550 ,0 ,0 ,2 ,1 ,0 ,0 ,0 ,3 ,0 ,3 ,0 ,3,2798 , 0 
4681.289,7,194 ,16 ,947 ,0 ,0 ,2 ,0 ,1 ,0 ,0 ,3 ,0 ,9 ,1 ,10,4119 , 0 
4681.337,14,194 ,1 ,256 ,0 ,0 ,1 ,0 ,0 ,0 ,0 ,1 ,0 ,4 ,0 ,4,2776 , 0 
4681.35,15,194 ,11 ,1306 ,0 ,0 ,2 ,1 ,0 ,1 ,1 ,5 ,0 ,7 ,1 ,8,3317 , 0 
4681.36,20,194 ,12 ,1071 ,0 ,0 ,4 ,1 ,0 ,0 ,0 ,5 ,0 ,3 ,0 ,3,3029 , 0 
4681.36,16,194 ,2 ,512 ,0 ,0 ,2 ,1 ,4 ,0 ,0 ,7 ,0 ,9 ,4 ,13,5096 , 0 
4681.444,10,194 ,14 ,512 ,0 ,0 ,2 ,0 ,0 ,0 ,0 ,2 ,0 ,2 ,0 ,2,2552 , 0 
4681.482,12,194 ,18 ,800 ,0 ,0 ,1 ,1 ,2 ,1 ,1 ,6 ,0 ,6 ,4 ,10,3166 , 0 
4681.596,9,194 ,7 ,1502 ,0 ,0 ,6 ,1 ,0 ,1 ,0 ,8 ,0 ,8 ,0 ,8,4865 , 0 
4681.603,5,194 ,19 ,515 ,0 ,0 ,2 ,0 ,0 ,1 ,0 ,3 ,0 ,13 ,0 ,13,4568 , 0 
4681.606,19,194 ,1 ,256 ,0 ,0 ,1 ,0 ,3 ,1 ,1 ,6 ,0 ,6 ,6 ,12,2866 , 0 
4681.696,17,194 ,16 ,947 ,0 ,0 ,2 ,2 ,1 ,0 ,0 ,5 ,0 ,4 ,1 ,5,3343 , 0 
4681.771,13,194 ,14 ,512 ,0 ,0 ,2 ,0 ,0 ,0 ,0 ,2 ,0 ,3 ,0 ,3,2679 , 0 
4681.786,3,194 ,1 ,256 ,0 ,0 ,2 ,0 ,0 ,0 ,0 ,2 ,0 ,2 ,0 ,2,2057 , 0 
4800.96,8,194 ,1 ,256 ,0 ,0 ,3 ,0 ,0 ,0 ,0 ,3 ,0 ,1 ,0 ,1,2439 , 0 
4801.078,11,194 ,9 ,300 ,0 ,0 ,6 ,2 ,0 ,2 ,1 ,11 ,0 ,22 ,1 ,23,2817 , 0 
4801.123,2,194 ,1 ,256 ,0 ,0 ,1 ,0 ,0 ,1 ,1 ,3 ,0 ,9 ,1 ,10,3800 , 0 
4801.138,6,194 ,17 ,976 ,0 ,0 ,1 ,1 ,0 ,0 ,0 ,2 ,0 ,6 ,0 ,6,4707 , 0 
4801.214,18,194 ,19 ,515 ,0 ,0 ,2 ,0 ,2 ,2 ,3 ,9 ,0 ,3 ,7 ,10,3138 , 0 
4801.235,4,194 ,8 ,546 ,0 ,0 ,2 ,0 ,0 ,0 ,0 ,2 ,0 ,2 ,0 ,2,2985 , 0 
4801.337,14,194 ,1 ,256 ,0 ,0 ,2 ,0 ,2 ,0 ,0 ,4 ,0 ,1 ,2 ,3,2660 , 0 
4801.35,15,194 ,9 ,300 ,0 ,0 ,10 ,5 ,0 ,3 ,0 ,18 ,0 ,11 ,9 ,20,2812 , 0 
4801.36,20,194 ,12 ,1071 ,0 ,0 ,7 ,3 ,0 ,2 ,0 ,12 ,0 ,3 ,0 ,3,2842 , 0 
4801.361,16,194 ,9 ,300 ,0 ,0 ,6 ,6 ,138 ,1 ,1 ,152 ,0 ,10 ,139 ,149,6220 , 0 
4801.368,7,194 ,16 ,594 ,0 ,0 ,6 ,4 ,134 ,0 ,1 ,145 ,0 ,15 ,139 ,154,4736 , 0 
4801.444,10,194 ,14 ,512 ,0 ,0 ,1 ,1 ,0 ,0 ,0 ,2 ,0 ,1 ,0 ,1,2707 , 0 
4801.482,12,194 ,18 ,800 ,0 ,0 ,3 ,0 ,2 ,2 ,3 ,10 ,0 ,6 ,6 ,12,3208 , 0 
4801.597,9,194 ,7 ,866 ,0 ,0 ,7 ,5 ,141 ,3 ,1 ,157 ,0 ,16 ,159 ,175,5502 , 1 
4801.603,5,194 ,9 ,300 ,0 ,0 ,5 ,6 ,1 ,1 ,1 ,14 ,0 ,13 ,2 ,15,4780 , 0 
4801.606,19,194 ,1 ,256 ,0 ,0 ,1 ,0 ,2 ,3 ,4 ,10 ,0 ,2 ,8 ,10,3373 , 0 
4801.696,17,194 ,16 ,594 ,0 ,0 ,1 ,5 ,1 ,0 ,0 ,7 ,0 ,10 ,1 ,11,3653 , 0 
4801.771,13,194 ,14 ,512 ,0 ,0 ,1 ,2 ,0 ,0 ,0 ,3 ,0 ,5 ,0 ,5,3025 , 0 
4801.786,3,194 ,1 ,256 ,0 ,0 ,1 ,0 ,0 ,0 ,0 ,1 ,0 ,3 ,0 ,3,2058 , 0 
4920.96,8,194 ,1 ,256 ,0 ,0 ,0 ,1 ,1 ,0 ,0 ,2 ,0 ,4 ,1 ,5,2210 , 0 
4921.078,11,194 ,9 ,300 ,0 ,0 ,5 ,2 ,2 ,0 ,1 ,10 ,0 ,12 ,3 ,15,3486 , 0 
4921.123,2,194 ,1 ,256 ,0 ,0 ,2 ,1 ,0 ,0 ,0 ,3 ,0 ,7 ,0 ,7,3617 , 0 
4921.138,6,194 ,17 ,976 ,0 ,0 ,2 ,0 ,0 ,0 ,0 ,2 ,0 ,2 ,0 ,2,4399 , 0 
4921.214,18,194 ,19 ,512 ,0 ,0 ,2 ,1 ,0 ,2 ,2 ,7 ,0 ,5 ,3 ,8,3654 , 0 
4921.235,4,194 ,8 ,546 ,0 ,0 ,2 ,1 ,0 ,0 ,0 ,3 ,0 ,1 ,0 ,1,2960 , 0 
4921.29,7,194 ,16 ,566 ,0 ,0 ,2 ,0 ,312 ,0 ,1 ,315 ,0 ,6 ,315 ,321,5636 , 0 
4921.337,14,194 ,1 ,256 ,0 ,0 ,1 ,1 ,0 ,0 ,0 ,2 ,0 ,4 ,0 ,4,2916 , 0 
4921.35,15,194 ,9 ,300 ,0 ,0 ,3 ,2 ,0 ,1 ,0 ,6 ,0 ,4 ,0 ,4,3571 , 0 
4921.36,20,194 ,5 ,795 ,0 ,0 ,9 ,3 ,1 ,2 ,0 ,15 ,0 ,6 ,2 ,8,3371 , 0 
4921.368,16,194 ,9 ,300 ,0 ,0 ,2 ,2 ,311 ,0 ,1 ,316 ,0 ,4 ,312 ,316,6522 , 0 
4921.444,10,194 ,14 ,512 ,0 ,0 ,2 ,0 ,0 ,0 ,0 ,2 ,0 ,0 ,0 ,0,2649 , 0 
4921.482,12,194 ,20 ,1368 ,0 ,0 ,4 ,4 ,0 ,4 ,1 ,13 ,0 ,10 ,1 ,11,3463 , 0 
4921.603,5,194 ,9 ,300 ,0 ,0 ,2 ,2 ,4 ,1 ,1 ,10 ,0 ,17 ,5 ,22,4881 , 0 
4921.606,19,194 ,1 ,256 ,0 ,0 ,2 ,1 ,1 ,2 ,2 ,8 ,0 ,5 ,4 ,9,3113 , 0 
4921.752,9,194 ,7 ,1026 ,0 ,0 ,3 ,1 ,320 ,0 ,1 ,325 ,0 ,5 ,326 ,331,6183 , 1 
4921.771,13,194 ,14 ,512 ,0 ,0 ,2 ,0 ,0 ,0 ,0 ,2 ,0 ,5 ,0 ,5,2798 , 0 
4921.784,17,194 ,16 ,566 ,0 ,0 ,2 ,1 ,0 ,0 ,0 ,3 ,0 ,4 ,0 ,4,3528 , 0 
4921.786,3,194 ,1 ,256 ,0 ,0 ,2 ,1 ,0 ,0 ,0 ,3 ,0 ,1 ,0 ,1,2147 , 0 
5040.96,8,194 ,1 ,256 ,0 ,0 ,2 ,0 ,1 ,0 ,0 ,3 ,0 ,2 ,1 ,3,2596 , 0 
5041.078,11,194 ,9 ,300 ,0 ,0 ,2 ,1 ,0 ,1 ,0 ,4 ,0 ,9 ,0 ,9,3003 , 0 
5041.123,2,194 ,1 ,256 ,0 ,0 ,1 ,0 ,0 ,0 ,0 ,1 ,0 ,1 ,0 ,1,3927 , 0 
5041.138,6,194 ,17 ,984 ,0 ,0 ,1 ,1 ,0 ,0 ,0 ,2 ,0 ,2 ,0 ,2,4874 , 0 
5041.214,18,194 ,19 ,512 ,0 ,0 ,1 ,0 ,1 ,0 ,0 ,2 ,0 ,4 ,1 ,5,3319 , 0 
5041.235,4,194 ,8 ,553 ,0 ,0 ,1 ,1 ,0 ,0 ,0 ,2 ,0 ,1 ,0 ,1,3081 , 0 
5041.29,7,194 ,16 ,566 ,0 ,0 ,2 ,1 ,271 ,0 ,1 ,275 ,0 ,2 ,273 ,275,6166 , 0 
5041.337,14,194 ,1 ,256 ,0 ,0 ,1 ,0 ,0 ,0 ,0 ,1 ,0 ,0 ,0 ,0,2740 , 0 
5041.35,15,194 ,9 ,300 ,0 ,0 ,2 ,1 ,0 ,0 ,0 ,3 ,0 ,3 ,0 ,3,3025 , 0 
5041.36,20,194 ,5 ,795 ,0 ,0 ,2 ,0 ,1 ,1 ,1 ,5 ,0 ,2 ,2 ,4,2937 , 0 
5041.361,16,194 ,9 ,300 ,0 ,0 ,1 ,1 ,270 ,0 ,0 ,272 ,0 ,4 ,270 ,274,7611 , 0 
5041.444,10,194 ,14 ,512 ,0 ,0 ,0 ,0 ,0 ,0 ,0 ,0 ,0 ,1 ,0 ,1,2817 , 0 
5041.482,12,194 ,18 ,802 ,0 ,0 ,6 ,2 ,0 ,1 ,0 ,9 ,0 ,2 ,0 ,2,3372 , 0 
5041.597,9,194 ,7 ,822 ,0 ,0 ,2 ,1 ,274 ,0 ,1 ,278 ,0 ,2 ,278 ,280,6917 , 1 
5041.602,5,194 ,9 ,300 ,0 ,0 ,1 ,1 ,1 ,1 ,1 ,5 ,0 ,3 ,3 ,6,4987 , 0 
5041.606,19,194 ,1 ,256 ,0 ,0 ,2 ,0 ,0 ,1 ,0 ,3 ,0 ,2 ,0 ,2,3558 , 0 
5041.696,17,194 ,16 ,566 ,0 ,0 ,1 ,0 ,1 ,0 ,0 ,2 ,0 ,2 ,1 ,3,3888 , 0 
5041.771,13,194 ,14 ,512 ,0 ,0 ,1 ,0 ,0 ,0 ,0 ,1 ,0 ,0 ,0 ,0,3120 , 0 
5041.786,3,194 ,1 ,256 ,0 ,0 ,1 ,0 ,0 ,0 ,0 ,1 ,0 ,1 ,0 ,1,2162 , 0 
5160.96,8,194 ,1 ,256 ,0 ,0 ,0 ,0 ,0 ,0 ,0 ,0 ,0 ,1 ,0 ,1,2272 , 0 
5161.078,11,194 ,5 ,548 ,0 ,0 ,4 ,1 ,0 ,2 ,0 ,7 ,0 ,7 ,0 ,7,3760 , 0 
5161.123,2,194 ,1 ,256 ,0 ,0 ,2 ,0 ,0 ,0 ,0 ,2 ,0 ,2 ,0 ,2,3777 , 0 
5161.138,6,194 ,17 ,984 ,0 ,0 ,1 ,0 ,0 ,0 ,0 ,1 ,0 ,4 ,0 ,4,4559 , 0 
5161.214,18,194 ,19 ,512 ,0 ,0 ,1 ,0 ,0 ,0 ,0 ,1 ,0 ,4 ,0 ,4,3731 , 0 
5161.235,4,194 ,8 ,553 ,0 ,0 ,2 ,0 ,0 ,0 ,0 ,2 ,0 ,1 ,0 ,1,3115 , 0 
5161.29,7,194 ,16 ,556 ,0 ,0 ,1 ,1 ,232 ,0 ,1 ,235 ,0 ,3 ,233 ,236,7009 , 0 
5161.337,14,194 ,1 ,256 ,0 ,0 ,2 ,0 ,1 ,0 ,0 ,3 ,0 ,1 ,1 ,2,2985 , 0 
5161.35,15,194 ,9 ,300 ,0 ,0 ,2 ,0 ,1 ,0 ,1 ,4 ,0 ,2 ,2 ,4,3891 , 0 
5161.36,20,194 ,5 ,548 ,0 ,0 ,3 ,0 ,0 ,0 ,0 ,3 ,0 ,4 ,0 ,4,3607 , 0 
5161.361,16,194 ,9 ,300 ,0 ,0 ,2 ,0 ,235 ,0 ,1 ,238 ,0 ,0 ,236 ,236,8395 , 0 
5161.444,10,194 ,14 ,512 ,0 ,0 ,2 ,1 ,0 ,0 ,0 ,3 ,0 ,3 ,0 ,3,2737 , 0 
5161.482,12,194 ,18 ,802 ,0 ,0 ,2 ,0 ,0 ,0 ,0 ,2 ,0 ,5 ,0 ,5,3626 , 0 
5161.597,9,194 ,7 ,822 ,0 ,0 ,1 ,0 ,231 ,0 ,1 ,233 ,0 ,3 ,236 ,239,7556 , 0 
5161.602,5,194 ,19 ,523 ,0 ,0 ,3 ,1 ,0 ,1 ,0 ,5 ,0 ,4 ,0 ,4,5127 , 0 
5161.606,19,194 ,1 ,256 ,0 ,0 ,1 ,0 ,1 ,0 ,0 ,2 ,0 ,3 ,1 ,4,3290 , 0 
5161.696,17,194 ,16 ,556 ,0 ,0 ,1 ,1 ,0 ,0 ,0 ,2 ,0 ,1 ,0 ,1,3787 , 0 
5161.771,13,194 ,14 ,512 ,0 ,0 ,1 ,0 ,0 ,0 ,0 ,1 ,0 ,3 ,0 ,3,2900 , 0 
5161.786,3,194 ,1 ,256 ,0 ,0 ,2 ,0 ,0 ,0 ,0 ,2 ,0 ,1 ,0 ,1,2272 , 0 
5280.96,8,194 ,1 ,256 ,0 ,0 ,2 ,1 ,2 ,0 ,0 ,5 ,0 ,2 ,2 ,4,2714 , 0 
5281.123,2,194 ,1 ,256 ,0 ,0 ,1 ,0 ,7 ,0 ,0 ,8 ,0 ,5 ,9 ,14,4073 , 0 
5281.138,6,194 ,17 ,1097 ,0 ,0 ,1 ,1 ,0 ,0 ,0 ,2 ,0 ,4 ,0 ,4,5001 , 0 
5281.214,18,194 ,4 ,868 ,0 ,0 ,5 ,1 ,0 ,1 ,0 ,7 ,0 ,1 ,0 ,1,3603 , 0 
5281.214,11,194 ,15 ,1087 ,0 ,0 ,8 ,2 ,0 ,1 ,0 ,11 ,0 ,3 ,0 ,3,3261 , 0 
5281.235,4,194 ,8 ,553 ,0 ,0 ,1 ,1 ,1 ,0 ,0 ,3 ,0 ,4 ,1 ,5,3211 , 0 
5281.29,7,194 ,16 ,867 ,0 ,0 ,2 ,0 ,263 ,0 ,2 ,267 ,0 ,5 ,265 ,270,7621 , 0 
5281.337,14,194 ,1 ,256 ,0 ,0 ,1 ,1 ,0 ,0 ,0 ,2 ,0 ,3 ,0 ,3,2852 , 0 
5281.35,15,194 ,7 ,872 ,0 ,0 ,3 ,1 ,1 ,1 ,0 ,6 ,0 ,5 ,1 ,6,3262 , 0 
5281.36,20,194 ,5 ,622 ,0 ,0 ,0 ,1 ,0 ,0 ,0 ,1 ,0 ,6 ,0 ,6,3001 , 0 
5281.361,16,194 ,2 ,512 ,0 ,0 ,2 ,1 ,263 ,1 ,2 ,269 ,0 ,3 ,266 ,269,9306 , 0 
5281.444,10,194 ,14 ,512 ,0 ,0 ,2 ,0 ,0 ,0 ,0 ,2 ,0 ,0 ,0 ,0,2897 , 0 
5281.482,12,194 ,18 ,802 ,0 ,0 ,1 ,0 ,0 ,0 ,0 ,1 ,0 ,5 ,0 ,5,3476 , 0 
5281.597,9,194 ,7 ,813 ,0 ,0 ,2 ,1 ,260 ,0 ,2 ,265 ,0 ,7 ,262 ,269,8268 , 0 
5281.602,5,194 ,19 ,523 ,0 ,0 ,5 ,0 ,1 ,0 ,0 ,6 ,0 ,7 ,2 ,9,5200 , 0 
5281.606,19,194 ,1 ,256 ,0 ,0 ,1 ,0 ,1 ,0 ,0 ,2 ,0 ,2 ,1 ,3,3641 , 0 
5281.696,17,194 ,7 ,813 ,0 ,0 ,2 ,1 ,2 ,1 ,0 ,6 ,0 ,3 ,2 ,5,4138 , 0 
5281.771,13,194 ,14 ,512 ,0 ,0 ,0 ,0 ,0 ,0 ,0 ,0 ,0 ,6 ,0 ,6,3216 , 0 
5281.786,3,194 ,1 ,256 ,0 ,0 ,2 ,1 ,0 ,0 ,0 ,3 ,0 ,3 ,0 ,3,2245 , 0 
5400.96,8,194 ,1 ,256 ,0 ,0 ,2 ,0 ,1 ,1 ,1 ,5 ,0 ,2 ,3 ,5,2365 , 0 
5401.078,11,194 ,15 ,1182 ,0 ,0 ,1 ,3 ,0 ,0 ,0 ,4 ,0 ,10 ,0 ,10,3864 , 0 
5401.124,2,194 ,1 ,256 ,0 ,0 ,3 ,0 ,16 ,1 ,2 ,22 ,0 ,6 ,18 ,24,3895 , 0 
5401.138,6,194 ,17 ,1150 ,0 ,0 ,2 ,7 ,0 ,0 ,0 ,9 ,0 ,13 ,0 ,13,4699 , 0 
5401.214,18,194 ,4 ,868 ,0 ,0 ,3 ,0 ,0 ,1 ,1 ,5 ,0 ,5 ,1 ,6,3828 , 0 
5401.235,4,194 ,8 ,540 ,0 ,0 ,1 ,1 ,0 ,1 ,1 ,4 ,0 ,4 ,2 ,6,3199 , 0 
5401.289,7,194 ,16 ,776 ,0 ,0 ,1 ,4 ,9 ,1 ,1 ,16 ,0 ,11 ,12 ,23,7175 , 0 
5401.337,14,194 ,1 ,256 ,0 ,0 ,1 ,0 ,0 ,0 ,0 ,1 ,0 ,2 ,0 ,2,3066 , 0 
5401.35,15,194 ,7 ,872 ,0 ,0 ,5 ,0 ,3 ,0 ,0 ,8 ,0 ,1 ,3 ,4,3993 , 0 
5401.36,20,194 ,5 ,622 ,0 ,0 ,2 ,0 ,0 ,0 ,0 ,2 ,0 ,5 ,0 ,5,3680 , 0 
5401.361,16,194 ,2 ,512 ,0 ,0 ,5 ,0 ,16 ,1 ,1 ,23 ,0 ,5 ,18 ,23,8692 , 0 
5401.444,10,194 ,14 ,512 ,0 ,0 ,1 ,0 ,0 ,0 ,0 ,1 ,0 ,1 ,0 ,1,2827 , 0 
5401.481,12,194 ,5 ,622 ,0 ,0 ,5 ,1 ,0 ,1 ,0 ,7 ,0 ,5 ,0 ,5,3735 , 0 
5401.596,9,194 ,7 ,813 ,0 ,0 ,1 ,0 ,0 ,2 ,0 ,3 ,0 ,8 ,0 ,8,7665 , 0 
5401.602,5,194 ,19 ,533 ,0 ,0 ,2 ,0 ,1 ,0 ,0 ,3 ,0 ,9 ,1 ,10,5232 , 0 
5401.606,19,194 ,1 ,256 ,0 ,0 ,2 ,0 ,1 ,0 ,0 ,3 ,0 ,5 ,1 ,6,3393 , 0 
5401.696,17,194 ,16 ,772 ,0 ,0 ,7 ,2 ,6 ,1 ,0 ,16 ,0 ,6 ,6 ,12,3975 , 0 
5401.771,13,194 ,14 ,512 ,0 ,0 ,2 ,0 ,0 ,0 ,0 ,2 ,0 ,2 ,0 ,2,2988 , 0 
5401.786,3,194 ,1 ,256 ,0 ,0 ,1 ,0 ,0 ,0 ,0 ,1 ,0 ,1 ,0 ,1,2336 , 0 
5520.96,8,194 ,1 ,256 ,0 ,0 ,1 ,0 ,1 ,0 ,0 ,2 ,0 ,1 ,1 ,2,2784 , 0 
5521.078,11,194 ,15 ,1182 ,0 ,0 ,2 ,0 ,0 ,0 ,0 ,2 ,0 ,4 ,0 ,4,3346 , 0 
5521.124,2,194 ,1 ,256 ,0 ,0 ,26 ,0 ,63 ,0 ,0 ,89 ,113 ,22 ,63 ,198,4447 , 0 
5521.214,18,194 ,4 ,822 ,0 ,0 ,2 ,1 ,0 ,0 ,0 ,3 ,0 ,3 ,0 ,3,3677 , 0 
5521.235,4,194 ,8 ,540 ,0 ,0 ,2 ,0 ,1 ,0 ,0 ,3 ,0 ,2 ,1 ,3,3301 , 0 
5521.276,6,194 ,17 ,1072 ,0 ,120 ,1 ,16 ,0 ,0 ,0 ,137 ,0 ,80 ,0 ,80,5912 , 1 
5521.289,7,194 ,16 ,786 ,0 ,0 ,1 ,19 ,0 ,1 ,0 ,21 ,0 ,44 ,0 ,44,7866 , 0 
5521.337,14,194 ,1 ,256 ,0 ,0 ,0 ,0 ,0 ,0 ,0 ,0 ,0 ,38 ,0 ,38,2932 , 0 
5521.35,15,194 ,7 ,1069 ,0 ,0 ,1 ,0 ,0 ,0 ,0 ,1 ,0 ,2 ,0 ,2,3368 , 0 
5521.36,20,194 ,5 ,622 ,0 ,0 ,1 ,0 ,0 ,0 ,0 ,1 ,0 ,4 ,0 ,4,3064 , 0 
5521.361,16,194 ,2 ,512 ,0 ,0 ,27 ,11 ,52 ,0 ,0 ,90 ,113 ,30 ,53 ,196,10150 , 0 
5521.444,10,194 ,14 ,512 ,0 ,0 ,25 ,0 ,0 ,0 ,0 ,25 ,112 ,1 ,0 ,113,3189 , 0 
5521.481,12,194 ,5 ,622 ,0 ,0 ,3 ,0 ,0 ,0 ,0 ,3 ,0 ,2 ,0 ,2,3569 , 0 
5521.596,9,194 ,7 ,813 ,0 ,0 ,2 ,0 ,0 ,0 ,0 ,2 ,0 ,28 ,0 ,28,8450 , 0 
5521.603,5,194 ,19 ,533 ,0 ,0 ,1 ,0 ,0 ,0 ,0 ,1 ,0 ,30 ,0 ,30,5350 , 0 
5521.606,19,194 ,1 ,256 ,0 ,0 ,1 ,0 ,0 ,0 ,0 ,1 ,0 ,26 ,0 ,26,3739 , 0 
5521.697,17,194 ,16 ,786 ,0 ,0 ,26 ,17 ,16 ,0 ,0 ,59 ,110 ,26 ,16 ,152,4561 , 0 
5521.771,13,194 ,14 ,512 ,0 ,0 ,0 ,0 ,0 ,0 ,0 ,0 ,0 ,21 ,0 ,21,3298 , 0 
5521.786,3,194 ,1 ,256 ,0 ,0 ,1 ,0 ,0 ,0 ,0 ,1 ,0 ,0 ,0 ,0,2310 , 0 
5640.96,8,194 ,1 ,256 ,0 ,0 ,1 ,0 ,0 ,0 ,0 ,1 ,0 ,0 ,0 ,0,2431 , 0 
5641.078,11,194 ,5 ,651 ,0 ,0 ,6 ,1 ,0 ,1 ,0 ,8 ,0 ,4 ,0 ,4,3980 , 0 
5641.124,2,194 ,1 ,256 ,0 ,0 ,26 ,0 ,64 ,0 ,1 ,91 ,102 ,26 ,65 ,193,4287 , 0 
5641.214,18,194 ,4 ,822 ,0 ,0 ,1 ,0 ,0 ,0 ,0 ,1 ,0 ,1 ,0 ,1,3924 , 0 
5641.235,4,194 ,8 ,540 ,0 ,0 ,1 ,0 ,0 ,0 ,0 ,1 ,0 ,0 ,0 ,0,3282 , 0 
5641.27,6,194 ,17 ,1050 ,0 ,120 ,2 ,16 ,0 ,0 ,0 ,138 ,0 ,87 ,0 ,87,5628 , 1 
5641.289,7,194 ,16 ,783 ,0 ,0 ,1 ,21 ,0 ,1 ,1 ,24 ,0 ,47 ,2 ,49,7548 , 0 
5641.337,14,194 ,1 ,256 ,0 ,0 ,1 ,0 ,0 ,0 ,0 ,1 ,0 ,41 ,0 ,41,3208 , 0 
5641.35,15,194 ,7 ,1069 ,0 ,0 ,3 ,0 ,0 ,1 ,1 ,5 ,0 ,3 ,1 ,4,4120 , 0 
5641.36,20,194 ,5 ,622 ,0 ,0 ,2 ,0 ,0 ,0 ,0 ,2 ,0 ,4 ,0 ,4,3754 , 0 
5641.375,16,194 ,2 ,512 ,0 ,0 ,25 ,14 ,52 ,0 ,1 ,92 ,102 ,39 ,53 ,194,9533 , 0 
5641.444,10,194 ,14 ,512 ,0 ,0 ,27 ,0 ,0 ,0 ,0 ,27 ,108 ,0 ,0 ,108,3158 , 0 
5641.481,12,194 ,5 ,622 ,0 ,0 ,1 ,0 ,0 ,0 ,0 ,1 ,0 ,6 ,0 ,6,3829 , 0 
5641.596,9,194 ,7 ,1221 ,0 ,0 ,1 ,0 ,0 ,0 ,0 ,1 ,0 ,25 ,0 ,25,7780 , 0 
5641.606,19,194 ,1 ,256 ,0 ,0 ,1 ,0 ,2 ,0 ,0 ,3 ,0 ,25 ,2 ,27,3502 , 0 
5641.607,5,194 ,19 ,528 ,0 ,0 ,1 ,1 ,1 ,0 ,0 ,3 ,0 ,25 ,1 ,26,5445 , 0 
5641.697,17,194 ,16 ,783 ,0 ,0 ,26 ,15 ,16 ,0 ,0 ,57 ,104 ,21 ,16 ,141,4456 , 0 
5641.771,13,194 ,14 ,512 ,0 ,0 ,2 ,0 ,0 ,0 ,0 ,2 ,0 ,21 ,0 ,21,3134 , 0 
5641.786,3,194 ,1 ,256 ,0 ,0 ,1 ,0 ,0 ,0 ,0 ,1 ,0 ,1 ,0 ,1,2400 , 0 
5760.96,8,194 ,1 ,256 ,0 ,0 ,1 ,0 ,1 ,0 ,0 ,2 ,0 ,0 ,1 ,1,2889 , 0 
5761.078,11,194 ,20 ,1028 ,0 ,0 ,7 ,4 ,0 ,2 ,0 ,13 ,0 ,8 ,0 ,8,3584 , 0 
5761.124,2,194 ,1 ,256 ,0 ,0 ,25 ,0 ,70 ,1 ,0 ,96 ,101 ,23 ,72 ,196,4868 , 0 
5761.214,18,194 ,4 ,822 ,0 ,0 ,2 ,0 ,1 ,0 ,0 ,3 ,0 ,7 ,2 ,9,3799 , 0 
5761.235,4,194 ,8 ,540 ,0 ,0 ,0 ,0 ,1 ,0 ,0 ,1 ,0 ,1 ,1 ,2,3362 , 0 
5761.27,6,194 ,2 ,512 ,0 ,120 ,4 ,17 ,0 ,1 ,0 ,142 ,0 ,73 ,0 ,73,6900 , 1 
5761.289,7,194 ,16 ,952 ,0 ,0 ,1 ,13 ,0 ,0 ,0 ,14 ,0 ,30 ,0 ,30,8129 , 0 
5761.337,14,194 ,1 ,256 ,0 ,0 ,1 ,0 ,0 ,1 ,1 ,3 ,0 ,36 ,1 ,37,3040 , 0 
5761.35,15,194 ,7 ,1069 ,0 ,0 ,1 ,0 ,0 ,0 ,0 ,1 ,0 ,5 ,0 ,5,3441 , 0 
5761.36,20,194 ,5 ,1060 ,0 ,0 ,1 ,3 ,3 ,0 ,0 ,7 ,0 ,13 ,5 ,18,3236 , 0 
5761.361,16,194 ,2 ,512 ,0 ,0 ,25 ,15 ,36 ,1 ,1 ,78 ,96 ,37 ,38 ,171,10984 , 0 
5761.444,10,194 ,14 ,512 ,0 ,0 ,26 ,0 ,0 ,0 ,0 ,26 ,107 ,4 ,0 ,111,3461 , 0 
5761.482,12,194 ,18 ,1152 ,0 ,0 ,7 ,2 ,3 ,2 ,1 ,15 ,0 ,10 ,4 ,14,3794 , 0 
5761.596,9,194 ,7 ,1221 ,0 ,0 ,1 ,0 ,0 ,0 ,0 ,1 ,0 ,30 ,0 ,30,8678 , 0 
5761.603,5,194 ,2 ,514 ,0 ,0 ,5 ,6 ,7 ,1 ,2 ,21 ,0 ,26 ,9 ,35,5740 , 0 
5761.606,19,194 ,1 ,256 ,0 ,0 ,1 ,0 ,0 ,2 ,2 ,5 ,0 ,28 ,2 ,30,3872 , 0 
5761.697,17,194 ,16 ,952 ,0 ,0 ,25 ,15 ,9 ,0 ,1 ,50 ,96 ,20 ,10 ,126,5014 , 0 
5761.771,13,194 ,1 ,256 ,0 ,0 ,4 ,1 ,0 ,1 ,0 ,6 ,0 ,21 ,0 ,21,3469 , 0 
5761.786,3,194 ,1 ,256 ,0 ,0 ,0 ,0 ,0 ,0 ,0 ,0 ,0 ,1 ,0 ,1,2366 , 0 
5880.96,8,194 ,1 ,256 ,0 ,0 ,1 ,0 ,0 ,0 ,0 ,1 ,0 ,1 ,0 ,1,2513 , 0 
5881.078,11,194 ,20 ,1028 ,0 ,0 ,3 ,0 ,0 ,0 ,0 ,3 ,0 ,9 ,0 ,9,4064 , 0 
5881.124,2,194 ,1 ,256 ,0 ,0 ,7 ,0 ,28 ,0 ,1 ,36 ,1 ,9 ,31 ,41,4432 , 0 
5881.138,6,194 ,2 ,512 ,0 ,0 ,3 ,5 ,0 ,0 ,0 ,8 ,0 ,23 ,0 ,23,5755 , 0 
5881.214,18,194 ,4 ,814 ,0 ,0 ,1 ,0 ,0 ,0 ,0 ,1 ,0 ,4 ,1 ,5,4001 , 0 
5881.235,4,194 ,8 ,527 ,0 ,0 ,1 ,0 ,0 ,0 ,0 ,1 ,0 ,2 ,0 ,2,3356 , 0 
5881.289,7,194 ,16 ,816 ,0 ,0 ,1 ,5 ,0 ,1 ,1 ,8 ,0 ,15 ,1 ,16,7673 , 0 
5881.337,14,194 ,1 ,256 ,0 ,0 ,1 ,0 ,0 ,0 ,0 ,1 ,0 ,10 ,0 ,10,3290 , 0 
5881.35,15,194 ,7 ,1209 ,0 ,0 ,2 ,0 ,0 ,0 ,0 ,2 ,0 ,8 ,0 ,8,4192 , 0 
5881.36,20,194 ,5 ,947 ,0 ,0 ,1 ,1 ,0 ,0 ,0 ,2 ,0 ,5 ,0 ,5,3822 , 0 
5881.361,16,194 ,2 ,512 ,0 ,0 ,7 ,4 ,13 ,1 ,1 ,26 ,0 ,14 ,16 ,30,9831 , 0 
5881.444,10,194 ,14 ,512 ,0 ,0 ,7 ,0 ,0 ,0 ,0 ,7 ,0 ,0 ,0 ,0,3270 , 0 
5881.482,12,194 ,18 ,1152 ,0 ,0 ,3 ,0 ,0 ,1 ,0 ,4 ,0 ,5 ,0 ,5,3929 , 0 
5881.596,9,194 ,16 ,816 ,0 ,0 ,4 ,4 ,0 ,1 ,0 ,9 ,0 ,8 ,0 ,8,7936 , 0 
5881.602,5,194 ,2 ,512 ,0 ,0 ,2 ,5 ,1 ,1 ,0 ,9 ,0 ,14 ,1 ,15,5621 , 0 
5881.606,19,194 ,1 ,256 ,0 ,0 ,1 ,0 ,0 ,0 ,0 ,1 ,0 ,8 ,0 ,8,3593 , 0 
5881.696,17,194 ,16 ,816 ,0 ,0 ,6 ,4 ,0 ,1 ,0 ,11 ,0 ,6 ,0 ,6,4573 , 0 
5881.771,13,194 ,1 ,256 ,0 ,0 ,3 ,0 ,0 ,0 ,0 ,3 ,0 ,6 ,0 ,6,3218 , 0 
5881.786,3,194 ,1 ,256 ,0 ,0 ,1 ,0 ,0 ,0 ,0 ,1 ,0 ,0 ,0 ,0,2470 , 0 
6000.96,8,194 ,1 ,256 ,0 ,0 ,3 ,0 ,0 ,0 ,0 ,3 ,0 ,0 ,0 ,0,2960 , 0 
6001.078,11,194 ,5 ,966 ,0 ,0 ,6 ,1 ,0 ,1 ,0 ,8 ,0 ,6 ,0 ,6,3698 , 0 
6001.123,2,194 ,1 ,256 ,0 ,0 ,2 ,0 ,8 ,0 ,1 ,11 ,0 ,5 ,9 ,14,4992 , 0 
6001.138,6,194 ,2 ,512 ,0 ,0 ,2 ,1 ,0 ,0 ,0 ,3 ,0 ,3 ,0 ,3,6972 , 0 
6001.214,18,194 ,4 ,814 ,0 ,0 ,1 ,0 ,0 ,0 ,0 ,1 ,0 ,2 ,0 ,2,3868 , 0 
6001.235,4,194 ,8 ,523 ,0 ,0 ,1 ,0 ,0 ,0 ,0 ,1 ,0 ,1 ,0 ,1,3428 , 0 
6001.289,7,194 ,16 ,824 ,0 ,0 ,1 ,1 ,0 ,0 ,0 ,2 ,0 ,4 ,0 ,4,8200 , 0 
6001.337,14,194 ,1 ,256 ,0 ,0 ,1 ,0 ,0 ,0 ,0 ,1 ,0 ,4 ,0 ,4,3104 , 0 
6001.35,15,194 ,7 ,1209 ,0 ,0 ,1 ,0 ,0 ,0 ,0 ,1 ,0 ,7 ,0 ,7,3531 , 0 
6001.36,20,194 ,5 ,966 ,0 ,0 ,2 ,1 ,0 ,1 ,1 ,5 ,0 ,5 ,1 ,6,3330 , 0 
6001.36,16,194 ,2 ,512 ,0 ,0 ,2 ,1 ,3 ,0 ,0 ,6 ,0 ,5 ,3 ,8,11104 , 0 
6001.444,10,194 ,14 ,512 ,0 ,0 ,2 ,0 ,0 ,0 ,0 ,2 ,0 ,2 ,0 ,2,3522 , 0 
6001.482,12,194 ,18 ,1152 ,0 ,0 ,2 ,0 ,0 ,0 ,0 ,2 ,0 ,6 ,0 ,6,3877 , 0 
6001.596,9,194 ,16 ,824 ,0 ,0 ,3 ,1 ,0 ,0 ,0 ,4 ,0 ,8 ,0 ,8,8797 , 0 
6001.602,5,194 ,2 ,512 ,0 ,0 ,2 ,1 ,2 ,0 ,1 ,6 ,0 ,8 ,4 ,12,5869 , 0 
6001.606,19,194 ,1 ,256 ,0 ,0 ,1 ,0 ,0 ,0 ,0 ,1 ,0 ,5 ,0 ,5,3945 , 0 
6001.696,17,194 ,16 ,824 ,0 ,0 ,2 ,1 ,0 ,0 ,0 ,3 ,0 ,3 ,0 ,3,5098 , 0 
6001.771,13,194 ,1 ,256 ,0 ,0 ,2 ,0 ,0 ,0 ,0 ,2 ,0 ,4 ,0 ,4,3546 , 0 
6001.786,3,194 ,1 ,256 ,0 ,0 ,1 ,0 ,0 ,0 ,0 ,1 ,0 ,2 ,0 ,2,2429 , 0 
6120.96,8,194 ,1 ,256 ,0 ,0 ,0 ,0 ,1 ,0 ,0 ,1 ,0 ,3 ,1 ,4,2567 , 0 
6121.078,11,194 ,5 ,966 ,0 ,0 ,1 ,0 ,0 ,0 ,0 ,1 ,0 ,1 ,0 ,1,4134 , 0 
6121.123,2,194 ,1 ,256 ,0 ,0 ,0 ,0 ,1 ,0 ,0 ,1 ,0 ,1 ,1 ,2,4495 , 0 
6121.138,6,194 ,2 ,512 ,0 ,0 ,2 ,0 ,0 ,0 ,0 ,2 ,0 ,3 ,0 ,3,5843 , 0 
6121.214,18,194 ,4 ,814 ,0 ,0 ,1 ,0 ,1 ,0 ,0 ,2 ,0 ,2 ,1 ,3,4069 , 0 
6121.235,4,194 ,8 ,523 ,0 ,0 ,1 ,0 ,1 ,0 ,0 ,2 ,0 ,0 ,1 ,1,3413 , 0 
6121.289,7,194 ,16 ,824 ,0 ,0 ,1 ,0 ,1 ,0 ,0 ,2 ,0 ,1 ,1 ,2,7751 , 0 
6121.337,14,194 ,1 ,256 ,0 ,0 ,1 ,0 ,0 ,0 ,0 ,1 ,0 ,0 ,0 ,0,3343 , 0 
6121.35,15,194 ,7 ,1161 ,0 ,0 ,1 ,1 ,0 ,0 ,0 ,2 ,0 ,2 ,0 ,2,4252 , 0 
6121.36,20,194 ,5 ,966 ,0 ,0 ,1 ,0 ,0 ,0 ,0 ,1 ,0 ,1 ,0 ,1,3877 , 0 
6121.36,16,194 ,2 ,512 ,0 ,0 ,1 ,0 ,1 ,0 ,0 ,2 ,0 ,2 ,1 ,3,9932 , 0 
6121.444,10,194 ,14 ,512 ,0 ,0 ,1 ,0 ,0 ,0 ,0 ,1 ,0 ,1 ,0 ,1,3323 , 0 
6121.482,12,194 ,18 ,1123 ,0 ,0 ,1 ,1 ,0 ,0 ,0 ,2 ,0 ,3 ,0 ,3,4005 , 0 
6121.596,9,194 ,16 ,824 ,0 ,0 ,1 ,0 ,0 ,0 ,0 ,1 ,0 ,1 ,0 ,1,8016 , 0 
6121.602,5,194 ,2 ,512 ,0 ,0 ,0 ,0 ,0 ,0 ,0 ,0 ,0 ,1 ,0 ,1,5702 , 0 
6121.606,19,194 ,1 ,256 ,0 ,0 ,1 ,0 ,0 ,0 ,0 ,1 ,0 ,1 ,0 ,1,3664 , 0 
6121.696,17,194 ,16 ,824 ,0 ,0 ,1 ,0 ,0 ,0 ,0 ,1 ,0 ,1 ,0 ,1,4658 , 0 
6121.771,13,194 ,1 ,256 ,0 ,0 ,1 ,0 ,0 ,0 ,0 ,1 ,0 ,0 ,0 ,0,3288 , 0 
6121.786,3,194 ,1 ,256 ,0 ,0 ,2 ,0 ,0 ,0 ,0 ,2 ,0 ,0 ,0 ,0,2527 , 0 
6240.96,8,194 ,1 ,256 ,0 ,0 ,1 ,0 ,3 ,0 ,0 ,4 ,0 ,1 ,3 ,4,3031 , 0 
6241.078,11,194 ,5 ,872 ,0 ,0 ,2 ,1 ,0 ,0 ,0 ,3 ,0 ,7 ,0 ,7,3775 , 0 
6241.123,2,194 ,1 ,256 ,0 ,0 ,2 ,0 ,7 ,0 ,1 ,10 ,0 ,2 ,8 ,10,5094 , 0 
6241.138,6,194 ,2 ,537 ,0 ,0 ,1 ,1 ,0 ,0 ,0 ,2 ,0 ,4 ,0 ,4,7036 , 0 
6241.214,18,194 ,4 ,787 ,0 ,0 ,2 ,1 ,1 ,0 ,0 ,4 ,0 ,4 ,1 ,5,3966 , 0 
6241.235,4,194 ,8 ,521 ,0 ,0 ,2 ,1 ,2 ,0 ,0 ,5 ,0 ,2 ,2 ,4,3527 , 0 
6241.289,7,194 ,17 ,1113 ,0 ,0 ,2 ,1 ,0 ,2 ,0 ,5 ,0 ,7 ,1 ,8,8304 , 0 
6241.337,14,194 ,1 ,256 ,0 ,0 ,1 ,0 ,0 ,0 ,0 ,1 ,0 ,5 ,0 ,5,3198 , 0 
6241.35,15,194 ,9 ,1448 ,0 ,0 ,4 ,1 ,0 ,1 ,0 ,6 ,0 ,3 ,1 ,4,3620 , 0 
6241.36,20,194 ,5 ,872 ,0 ,0 ,1 ,1 ,0 ,0 ,0 ,2 ,0 ,4 ,0 ,4,3416 , 0 
6241.36,16,194 ,2 ,537 ,0 ,0 ,1 ,1 ,2 ,0 ,1 ,5 ,0 ,4 ,3 ,7,11188 , 1 
6241.444,10,194 ,14 ,512 ,0 ,0 ,2 ,0 ,0 ,0 ,0 ,2 ,0 ,1 ,0 ,1,3606 , 0 
6241.482,12,194 ,18 ,1085 ,0 ,0 ,3 ,1 ,0 ,0 ,0 ,4 ,0 ,4 ,0 ,4,3969 , 0 
6241.596,9,194 ,16 ,824 ,0 ,0 ,1 ,0 ,1 ,0 ,0 ,2 ,0 ,6 ,1 ,7,8882 , 0 
6241.602,5,194 ,2 ,537 ,0 ,0 ,2 ,1 ,2 ,0 ,0 ,5 ,0 ,8 ,2 ,10,6038 , 0 
6241.606,19,194 ,1 ,256 ,0 ,0 ,1 ,0 ,0 ,0 ,0 ,1 ,0 ,5 ,0 ,5,4035 , 0 
6241.696,17,194 ,16 ,824 ,0 ,0 ,2 ,0 ,1 ,0 ,0 ,3 ,0 ,2 ,1 ,3,5168 , 0 
6241.771,13,194 ,1 ,256 ,0 ,0 ,2 ,0 ,0 ,0 ,0 ,2 ,0 ,2 ,0 ,2,3639 , 0 
6241.786,3,194 ,1 ,256 ,0 ,0 ,2 ,0 ,0 ,0 ,0 ,2 ,0 ,0 ,0 ,0,2491 , 0 
6360.96,8,194 ,1 ,256 ,0 ,0 ,1 ,0 ,1 ,0 ,0 ,2 ,0 ,0 ,1 ,1,2641 , 0 
6361.078,11,194 ,5 ,872 ,0 ,0 ,6 ,0 ,2 ,0 ,0 ,8 ,0 ,12 ,2 ,14,4270 , 0 
6361.124,2,194 ,1 ,256 ,0 ,0 ,6 ,0 ,24 ,0 ,2 ,32 ,0 ,4 ,29 ,33,4689 , 0 
6361.138,6,194 ,2 ,512 ,0 ,0 ,5 ,4 ,12 ,0 ,0 ,21 ,0 ,13 ,12 ,25,6077 , 0 
6361.214,18,194 ,4 ,781 ,0 ,0 ,1 ,0 ,1 ,0 ,0 ,2 ,0 ,2 ,1 ,3,4143 , 0 
6361.235,4,194 ,8 ,521 ,0 ,0 ,2 ,0 ,1 ,0 ,0 ,3 ,0 ,0 ,1 ,1,3487 , 0 
6361.289,7,194 ,17 ,1191 ,0 ,0 ,6 ,8 ,0 ,0 ,0 ,14 ,0 ,22 ,0 ,22,7905 , 0 
6361.337,14,194 ,1 ,256 ,0 ,0 ,1 ,0 ,0 ,0 ,0 ,1 ,0 ,5 ,0 ,5,3404 , 0 
6361.35,15,194 ,11 ,1350 ,0 ,0 ,7 ,2 ,0 ,1 ,0 ,10 ,0 ,12 ,0 ,12,4400 , 0 
6361.36,20,194 ,5 ,872 ,0 ,0 ,1 ,0 ,0 ,0 ,0 ,1 ,0 ,5 ,0 ,5,3958 , 0 
6361.36,16,194 ,2 ,512 ,0 ,0 ,2 ,2 ,0 ,2 ,2 ,8 ,0 ,23 ,2 ,25,10080 , 1 
6361.444,10,194 ,14 ,512 ,0 ,0 ,1 ,0 ,0 ,0 ,0 ,1 ,0 ,4 ,0 ,4,3387 , 0 
6361.482,12,194 ,18 ,1072 ,0 ,0 ,1 ,1 ,0 ,0 ,0 ,2 ,0 ,7 ,0 ,7,4095 , 0 
6361.596,9,194 ,5 ,872 ,0 ,0 ,6 ,1 ,0 ,2 ,1 ,10 ,0 ,17 ,1 ,18,8195 , 0 
6361.603,5,194 ,2 ,512 ,0 ,0 ,1 ,3 ,3 ,0 ,1 ,8 ,0 ,11 ,5 ,16,5910 , 0 
6361.606,19,194 ,1 ,256 ,0 ,0 ,1 ,0 ,0 ,0 ,0 ,1 ,0 ,5 ,0 ,5,3764 , 0 
6361.697,17,194 ,6 ,828 ,0 ,0 ,10 ,4 ,8 ,1 ,0 ,23 ,0 ,11 ,8 ,19,4881 , 0 
6361.771,13,194 ,1 ,256 ,0 ,0 ,1 ,0 ,0 ,0 ,0 ,1 ,0 ,3 ,0 ,3,3365 , 0 
6361.786,3,194 ,1 ,256 ,0 ,0 ,0 ,0 ,0 ,0 ,0 ,0 ,0 ,1 ,0 ,1,2576 , 0 
6480.96,8,194 ,1 ,256 ,0 ,0 ,2 ,0 ,0 ,0 ,0 ,2 ,0 ,0 ,0 ,0,3130 , 0 
6481.078,11,194 ,5 ,872 ,0 ,0 ,1 ,0 ,1 ,0 ,0 ,2 ,0 ,6 ,1 ,7,3873 , 0 
6481.124,2,194 ,1 ,256 ,0 ,0 ,3 ,0 ,12 ,0 ,0 ,15 ,0 ,2 ,12 ,14,5179 , 0 
6481.138,6,194 ,2 ,512 ,0 ,0 ,3 ,2 ,4 ,0 ,0 ,9 ,0 ,4 ,4 ,8,7177 , 0 
6481.214,18,194 ,4 ,781 ,0 ,0 ,1 ,0 ,0 ,0 ,0 ,1 ,0 ,0 ,0 ,0,4027 , 0 
6481.235,4,194 ,8 ,515 ,0 ,0 ,1 ,0 ,0 ,0 ,0 ,1 ,0 ,1 ,0 ,1,3585 , 0 
6481.289,7,194 ,17 ,1130 ,0 ,0 ,2 ,2 ,0 ,0 ,0 ,4 ,0 ,7 ,0 ,7,8394 , 0 
6481.337,14,194 ,1 ,256 ,0 ,0 ,0 ,0 ,0 ,0 ,0 ,0 ,0 ,4 ,0 ,4,3261 , 0 
6481.35,15,194 ,11 ,1350 ,0 ,0 ,1 ,1 ,0 ,0 ,0 ,2 ,0 ,5 ,0 ,5,3692 , 0 
6481.36,20,194 ,5 ,839 ,0 ,0 ,2 ,1 ,0 ,0 ,0 ,3 ,0 ,1 ,0 ,1,3487 , 0 
6481.36,16,194 ,2 ,512 ,0 ,0 ,1 ,2 ,0 ,0 ,0 ,3 ,0 ,11 ,0 ,11,11283 , 1 
6481.444,10,194 ,14 ,512 ,0 ,0 ,2 ,0 ,0 ,0 ,0 ,2 ,0 ,3 ,0 ,3,3667 , 0 
6481.482,12,194 ,18 ,1072 ,0 ,0 ,1 ,0 ,0 ,0 ,0 ,1 ,0 ,1 ,0 ,1,4053 , 0 
6481.596,9,194 ,5 ,872 ,0 ,0 ,5 ,0 ,0 ,0 ,0 ,5 ,0 ,4 ,0 ,4,8982 , 0 
6481.602,5,194 ,2 ,512 ,0 ,0 ,1 ,2 ,2 ,0 ,0 ,5 ,0 ,8 ,2 ,10,6152 , 0 
6481.606,19,194 ,1 ,256 ,0 ,0 ,0 ,0 ,0 ,0 ,0 ,0 ,0 ,5 ,0 ,5,4103 , 0 
6481.696,17,194 ,6 ,819 ,0 ,0 ,2 ,2 ,2 ,0 ,0 ,6 ,0 ,3 ,2 ,5,5261 , 0 
6481.771,13,194 ,1 ,256 ,0 ,0 ,1 ,0 ,0 ,0 ,0 ,1 ,0 ,2 ,0 ,2,3702 , 0 
6481.786,3,194 ,1 ,256 ,0 ,0 ,1 ,0 ,0 ,0 ,0 ,1 ,0 ,1 ,0 ,1,2568 , 0 
6600.96,8,194 ,1 ,256 ,0 ,0 ,0 ,0 ,0 ,0 ,0 ,0 ,0 ,0 ,0 ,0,2712 , 0 
6601.078,11,194 ,5 ,872 ,0 ,0 ,2 ,0 ,2 ,0 ,0 ,4 ,0 ,4 ,2 ,6,4363 , 0 
6601.123,2,194 ,1 ,256 ,0 ,0 ,1 ,0 ,2 ,0 ,0 ,3 ,0 ,2 ,2 ,4,4769 , 0 
6601.138,6,194 ,2 ,512 ,0 ,0 ,1 ,0 ,0 ,0 ,0 ,1 ,0 ,2 ,0 ,2,6149 , 0 
6601.214,18,194 ,4 ,773 ,0 ,0 ,1 ,0 ,0 ,0 ,0 ,1 ,0 ,2 ,0 ,2,4232 , 0 
6601.235,4,194 ,8 ,515 ,0 ,0 ,1 ,0 ,0 ,0 ,0 ,1 ,0 ,0 ,0 ,0,3564 , 0 
6601.289,7,194 ,17 ,1124 ,0 ,0 ,2 ,0 ,0 ,0 ,0 ,2 ,0 ,5 ,0 ,5,7986 , 0 
6601.337,14,194 ,1 ,256 ,0 ,0 ,1 ,0 ,0 ,0 ,0 ,1 ,0 ,2 ,0 ,2,3493 , 0 
6601.35,15,194 ,11 ,1340 ,0 ,0 ,2 ,2 ,0 ,0 ,0 ,4 ,0 ,7 ,0 ,7,4480 , 0 
6601.36,20,194 ,5 ,839 ,0 ,0 ,2 ,0 ,0 ,0 ,0 ,2 ,0 ,1 ,0 ,1,4026 , 0 
6601.36,16,194 ,2 ,512 ,0 ,0 ,1 ,0 ,0 ,0 ,0 ,1 ,0 ,5 ,0 ,5,10165 , 0 
6601.444,10,194 ,14 ,512 ,0 ,0 ,1 ,0 ,0 ,0 ,0 ,1 ,0 ,0 ,0 ,0,3467 , 0 
6601.482,12,194 ,18 ,1072 ,0 ,0 ,1 ,0 ,0 ,0 ,0 ,1 ,0 ,2 ,0 ,2,4164 , 0 
6601.596,9,194 ,5 ,872 ,0 ,0 ,3 ,0 ,0 ,0 ,0 ,3 ,0 ,3 ,0 ,3,8270 , 0 
6601.602,5,194 ,2 ,512 ,0 ,0 ,1 ,0 ,2 ,0 ,0 ,3 ,0 ,7 ,2 ,9,6019 , 0 
6601.606,19,194 ,1 ,256 ,0 ,0 ,1 ,0 ,0 ,0 ,0 ,1 ,0 ,2 ,0 ,2,3837 , 0 
6601.696,17,194 ,6 ,819 ,0 ,0 ,1 ,0 ,0 ,0 ,0 ,1 ,0 ,2 ,0 ,2,4959 , 0 
6601.771,13,194 ,1 ,256 ,0 ,0 ,2 ,0 ,0 ,0 ,0 ,2 ,0 ,1 ,0 ,1,3452 , 0 
6601.786,3,194 ,1 ,256 ,0 ,0 ,1 ,0 ,0 ,0 ,0 ,1 ,0 ,0 ,0 ,0,2637 , 0 
6720.96,8,194 ,1 ,256 ,0 ,0 ,1 ,0 ,0 ,0 ,1 ,2 ,0 ,0 ,1 ,1,3195 , 0 
6721.078,11,194 ,5 ,872 ,0 ,0 ,2 ,0 ,0 ,0 ,0 ,2 ,0 ,5 ,0 ,5,3965 , 0 
6721.123,2,194 ,1 ,256 ,0 ,0 ,2 ,0 ,6 ,0 ,0 ,8 ,0 ,1 ,6 ,7,5281 , 0 
6721.138,6,194 ,2 ,512 ,0 ,0 ,1 ,1 ,2 ,0 ,0 ,4 ,0 ,4 ,2 ,6,7275 , 0 
6721.214,18,194 ,4 ,772 ,0 ,0 ,1 ,0 ,0 ,0 ,1 ,2 ,0 ,6 ,1 ,7,4107 , 0 
6721.235,4,194 ,8 ,515 ,0 ,0 ,2 ,0 ,0 ,0 ,1 ,3 ,0 ,0 ,1 ,1,3662 , 0 
6721.289,7,194 ,17 ,1095 ,0 ,0 ,2 ,1 ,0 ,0 ,0 ,3 ,0 ,3 ,0 ,3,8479 , 0 
6721.337,14,194 ,1 ,256 ,0 ,0 ,1 ,0 ,0 ,0 ,0 ,1 ,0 ,4 ,0 ,4,3329 , 0 
6721.35,15,194 ,11 ,1318 ,0 ,0 ,2 ,0 ,0 ,0 ,0 ,2 ,0 ,3 ,0 ,3,3779 , 0 
6721.36,20,194 ,5 ,839 ,0 ,0 ,1 ,0 ,0 ,0 ,0 ,1 ,0 ,5 ,0 ,5,3556 , 0 
6721.36,16,194 ,2 ,512 ,0 ,0 ,0 ,1 ,0 ,0 ,0 ,1 ,0 ,4 ,0 ,4,11361 , 0 
6721.444,10,194 ,14 ,512 ,0 ,0 ,2 ,0 ,0 ,0 ,0 ,2 ,0 ,0 ,0 ,0,3728 , 0 
6721.481,12,194 ,5 ,800 ,0 ,0 ,5 ,1 ,0 ,1 ,0 ,7 ,0 ,3 ,0 ,3,4166 , 0 
6721.596,9,194 ,5 ,872 ,0 ,0 ,3 ,0 ,0 ,0 ,0 ,3 ,0 ,5 ,0 ,5,9126 , 0 
6721.602,5,194 ,2 ,512 ,0 ,0 ,1 ,1 ,1 ,0 ,0 ,3 ,0 ,9 ,1 ,10,6292 , 0 
6721.606,19,194 ,1 ,256 ,0 ,0 ,1 ,0 ,0 ,0 ,0 ,1 ,0 ,3 ,0 ,3,4210 , 0 
6721.696,17,194 ,6 ,804 ,0 ,0 ,2 ,1 ,1 ,0 ,0 ,4 ,0 ,2 ,1 ,3,5340 , 0 
6721.771,13,194 ,1 ,256 ,0 ,0 ,2 ,0 ,0 ,0 ,0 ,2 ,0 ,3 ,0 ,3,3799 , 0 
6721.786,3,194 ,1 ,256 ,0 ,0 ,0 ,0 ,0 ,0 ,0 ,0 ,0 ,0 ,0 ,0,2618 , 0 
6840.96,8,194 ,1 ,256 ,0 ,0 ,1 ,0 ,0 ,1 ,0 ,2 ,0 ,1 ,1 ,2,2791 , 0 
6841.078,11,194 ,5 ,872 ,0 ,0 ,0 ,0 ,0 ,0 ,0 ,0 ,0 ,3 ,0 ,3,4425 , 0 
6841.123,2,194 ,1 ,256 ,0 ,0 ,1 ,0 ,1 ,0 ,0 ,2 ,0 ,2 ,1 ,3,4852 , 0 
6841.138,6,194 ,2 ,512 ,0 ,0 ,2 ,0 ,1 ,0 ,0 ,3 ,0 ,2 ,1 ,3,6226 , 0 
6841.214,18,194 ,4 ,772 ,0 ,0 ,1 ,0 ,0 ,1 ,0 ,2 ,0 ,2 ,0 ,2,4301 , 0 
6841.235,4,194 ,8 ,515 ,0 ,0 ,0 ,0 ,0 ,1 ,0 ,1 ,0 ,0 ,1 ,1,3640 , 0 
6841.289,7,194 ,17 ,1070 ,0 ,0 ,1 ,1 ,0 ,0 ,0 ,2 ,0 ,2 ,0 ,2,8051 , 0 
6841.337,14,194 ,1 ,256 ,0 ,0 ,1 ,0 ,0 ,0 ,0 ,1 ,0 ,1 ,0 ,1,3594 , 0 
6841.35,15,194 ,11 ,1318 ,0 ,0 ,1 ,0 ,0 ,0 ,0 ,1 ,0 ,0 ,0 ,0,4535 , 0 
6841.36,20,194 ,5 ,839 ,0 ,0 ,1 ,0 ,0 ,0 ,0 ,1 ,0 ,2 ,0 ,2,4088 , 0 
6841.36,16,194 ,2 ,512 ,0 ,0 ,1 ,0 ,0 ,0 ,0 ,1 ,0 ,2 ,0 ,2,10242 , 0 
6841.444,10,194 ,14 ,512 ,0 ,0 ,1 ,0 ,0 ,0 ,0 ,1 ,0 ,2 ,0 ,2,3533 , 0 
6841.481,12,194 ,5 ,800 ,0 ,0 ,3 ,0 ,0 ,0 ,0 ,3 ,0 ,1 ,0 ,1,4249 , 0 
6841.596,9,194 ,5 ,872 ,0 ,0 ,0 ,0 ,0 ,0 ,0 ,0 ,0 ,0 ,0 ,0,8324 , 0 
6841.602,5,194 ,2 ,512 ,0 ,0 ,1 ,0 ,0 ,0 ,0 ,1 ,0 ,1 ,0 ,1,6096 , 0 
6841.606,19,194 ,1 ,256 ,0 ,0 ,1 ,0 ,0 ,0 ,0 ,1 ,0 ,1 ,0 ,1,3916 , 0 
6841.696,17,194 ,6 ,787 ,0 ,0 ,1 ,0 ,1 ,0 ,0 ,2 ,0 ,1 ,1 ,2,5017 , 0 
6841.786,3,194 ,1 ,256 ,0 ,0 ,2 ,0 ,0 ,0 ,0 ,2 ,0 ,2 ,0 ,2,2709 , 0 
6841.854,13,194 ,1 ,256 ,0 ,0 ,1 ,0 ,0 ,0 ,0 ,1 ,0 ,1 ,0 ,1,3515 , 0 
6960.96,8,194 ,1 ,256 ,0 ,0 ,2 ,0 ,0 ,0 ,0 ,2 ,0 ,1 ,0 ,1,3253 , 0 
6961.078,11,194 ,5 ,872 ,0 ,0 ,2 ,0 ,1 ,0 ,0 ,3 ,0 ,4 ,1 ,5,4049 , 0 
6961.123,2,194 ,1 ,256 ,0 ,0 ,1 ,0 ,4 ,0 ,0 ,5 ,0 ,1 ,4 ,5,5385 , 0 
6961.138,6,194 ,2 ,512 ,0 ,0 ,1 ,0 ,1 ,0 ,0 ,2 ,0 ,1 ,1 ,2,7346 , 0 
6961.214,18,194 ,4 ,772 ,0 ,0 ,2 ,0 ,0 ,0 ,0 ,2 ,0 ,1 ,0 ,1,4182 , 0 
6961.235,4,194 ,8 ,515 ,0 ,0 ,2 ,0 ,0 ,0 ,0 ,2 ,0 ,1 ,0 ,1,3747 , 0 
6961.289,7,194 ,17 ,1070 ,0 ,0 ,1 ,0 ,0 ,0 ,0 ,1 ,0 ,1 ,0 ,1,8548 , 0 
6961.337,14,194 ,1 ,256 ,0 ,0 ,1 ,0 ,0 ,0 ,0 ,1 ,0 ,1 ,0 ,1,3395 , 0 
6961.35,15,194 ,11 ,1281 ,0 ,0 ,1 ,1 ,0 ,0 ,0 ,2 ,0 ,3 ,0 ,3,3847 , 0 
6961.36,20,194 ,5 ,839 ,0 ,0 ,1 ,0 ,0 ,0 ,0 ,1 ,0 ,1 ,0 ,1,3614 , 0 
6961.36,16,194 ,2 ,512 ,0 ,0 ,1 ,0 ,0 ,0 ,0 ,1 ,0 ,2 ,0 ,2,11448 , 1 
6961.444,10,194 ,14 ,512 ,0 ,0 ,1 ,0 ,0 ,0 ,0 ,1 ,0 ,0 ,0 ,0,3790 , 0 
6961.481,12,194 ,5 ,800 ,0 ,0 ,1 ,0 ,0 ,0 ,0 ,1 ,0 ,1 ,0 ,1,4226 , 0 
6961.596,9,194 ,5 ,793 ,0 ,0 ,2 ,1 ,0 ,0 ,0 ,3 ,0 ,3 ,0 ,3,9197 , 0 
6961.602,5,194 ,2 ,512 ,0 ,0 ,1 ,1 ,2 ,0 ,0 ,4 ,0 ,4 ,2 ,6,6390 , 0 
6961.606,19,194 ,1 ,256 ,0 ,0 ,1 ,0 ,0 ,0 ,0 ,1 ,0 ,4 ,0 ,4,4278 , 0 
6961.696,17,194 ,6 ,785 ,0 ,0 ,2 ,1 ,0 ,0 ,0 ,3 ,0 ,1 ,0 ,1,5425 , 0 
6961.771,13,194 ,1 ,256 ,0 ,0 ,0 ,0 ,0 ,0 ,0 ,0 ,0 ,1 ,0 ,1,3869 , 0 
6961.786,3,194 ,1 ,256 ,0 ,0 ,1 ,0 ,0 ,0 ,0 ,1 ,0 ,1 ,0 ,1,2670 , 0 
7080.96,8,194 ,1 ,256 ,0 ,0 ,1 ,0 ,0 ,0 ,0 ,1 ,0 ,3 ,0 ,3,2848 , 0 
7081.078,11,194 ,5 ,872 ,0 ,0 ,1 ,0 ,0 ,0 ,0 ,1 ,0 ,0 ,0 ,0,4497 , 0 
7081.123,2,194 ,1 ,256 ,0 ,0 ,2 ,0 ,2 ,0 ,0 ,4 ,0 ,3 ,2 ,5,4938 , 0 
7081.138,6,194 ,2 ,512 ,0 ,0 ,1 ,1 ,1 ,0 ,0 ,3 ,0 ,3 ,1 ,4,6319 , 0 
7081.214,18,194 ,4 ,772 ,0 ,0 ,1 ,0 ,0 ,0 ,0 ,1 ,0 ,1 ,0 ,1,4373 , 0 
7081.235,4,194 ,8 ,515 ,0 ,0 ,1 ,0 ,0 ,0 ,0 ,1 ,0 ,1 ,0 ,1,3697 , 0 
7081.289,7,194 ,17 ,1057 ,0 ,0 ,0 ,1 ,0 ,0 ,0 ,1 ,0 ,2 ,0 ,2,8114 , 0 
7081.337,14,194 ,1 ,256 ,0 ,0 ,2 ,0 ,1 ,0 ,0 ,3 ,0 ,2 ,1 ,3,3673 , 0 
7081.35,15,194 ,11 ,1281 ,0 ,0 ,1 ,0 ,0 ,0 ,0 ,1 ,0 ,1 ,0 ,1,4617 , 0 
7081.36,20,194 ,5 ,839 ,0 ,0 ,1 ,0 ,0 ,0 ,0 ,1 ,0 ,2 ,0 ,2,4156 , 0 
7081.36,16,194 ,2 ,512 ,0 ,0 ,1 ,0 ,0 ,0 ,0 ,1 ,0 ,1 ,0 ,1,10312 , 1 
7081.444,10,194 ,14 ,512 ,0 ,0 ,1 ,1 ,0 ,0 ,0 ,2 ,0 ,1 ,0 ,1,3596 , 0 
7081.481,12,194 ,5 ,800 ,0 ,0 ,1 ,0 ,0 ,0 ,0 ,1 ,0 ,1 ,0 ,1,4343 , 0 
7081.596,9,194 ,5 ,793 ,0 ,0 ,1 ,0 ,0 ,0 ,0 ,1 ,0 ,0 ,0 ,0,8418 , 0 
7081.602,5,194 ,2 ,512 ,0 ,0 ,1 ,0 ,0 ,0 ,0 ,1 ,0 ,4 ,0 ,4,6230 , 0 
7081.606,19,194 ,1 ,256 ,0 ,0 ,2 ,0 ,0 ,0 ,0 ,2 ,0 ,3 ,0 ,3,4012 , 0 
7081.696,17,194 ,6 ,785 ,0 ,0 ,1 ,0 ,1 ,0 ,0 ,2 ,0 ,0 ,1 ,1,5089 , 0 
7081.771,13,194 ,1 ,256 ,0 ,0 ,2 ,0 ,0 ,0 ,0 ,2 ,0 ,4 ,0 ,4,3614 , 0 
7081.786,3,194 ,1 ,256 ,0 ,0 ,1 ,0 ,0 ,0 ,0 ,1 ,0 ,1 ,0 ,1,2766 , 0 
7200.96,8,194 ,1 ,256 ,0 ,0 ,1 ,0 ,0 ,0 ,0 ,1 ,0 ,1 ,0 ,1,3327 , 0 
7201.078,11,194 ,5 ,872 ,0 ,0 ,2 ,0 ,0 ,0 ,0 ,2 ,0 ,3 ,0 ,3,4122 , 0 
7201.123,2,194 ,1 ,256 ,0 ,0 ,1 ,0 ,2 ,0 ,0 ,3 ,0 ,1 ,2 ,3,5460 , 0 
7201.138,6,194 ,2 ,512 ,0 ,0 ,2 ,0 ,2 ,0 ,0 ,4 ,0 ,2 ,2 ,4,7424 , 0 
7201.214,18,194 ,4 ,796 ,0 ,0 ,0 ,0 ,0 ,0 ,0 ,0 ,0 ,4 ,0 ,4,4239 , 0 
7201.235,4,194 ,8 ,515 ,0 ,0 ,1 ,0 ,0 ,0 ,0 ,1 ,0 ,0 ,0 ,0,3822 , 0 
7201.289,7,194 ,17 ,1044 ,0 ,0 ,2 ,1 ,0 ,0 ,0 ,3 ,0 ,2 ,0 ,2,8647 , 0 
7201.337,14,194 ,1 ,256 ,0 ,0 ,1 ,0 ,0 ,0 ,0 ,1 ,0 ,0 ,0 ,0,3481 , 0 
7201.35,15,194 ,11 ,1238 ,0 ,0 ,0 ,0 ,0 ,0 ,0 ,0 ,0 ,2 ,0 ,2,3899 , 0 
7201.36,20,194 ,5 ,839 ,0 ,0 ,1 ,0 ,0 ,0 ,0 ,1 ,0 ,2 ,0 ,2,3691 , 0 
7201.36,16,194 ,2 ,512 ,0 ,0 ,0 ,0 ,0 ,0 ,0 ,0 ,0 ,5 ,0 ,5,11522 , 1 
7201.444,10,194 ,14 ,512 ,0 ,0 ,1 ,0 ,0 ,0 ,0 ,1 ,0 ,2 ,0 ,2,3854 , 0 
7201.481,12,194 ,5 ,800 ,0 ,0 ,2 ,0 ,0 ,0 ,0 ,2 ,0 ,2 ,0 ,2,4286 , 0 
7201.596,9,194 ,5 ,793 ,0 ,0 ,1 ,0 ,0 ,0 ,0 ,1 ,0 ,2 ,0 ,2,9266 , 0 
7201.602,5,194 ,2 ,512 ,0 ,0 ,1 ,0 ,0 ,0 ,0 ,1 ,0 ,2 ,0 ,2,6466 , 0 
7201.606,19,194 ,1 ,256 ,0 ,0 ,1 ,0 ,0 ,0 ,0 ,1 ,0 ,2 ,0 ,2,4361 , 0 
7201.696,17,194 ,6 ,776 ,0 ,0 ,2 ,1 ,1 ,0 ,0 ,4 ,0 ,2 ,1 ,3,5501 , 0 
7201.771,13,194 ,1 ,256 ,0 ,0 ,1 ,0 ,0 ,0 ,0 ,1 ,0 ,0 ,0 ,0,3930 , 0 
7201.786,3,194 ,1 ,256 ,0 ,0 ,1 ,0 ,0 ,0 ,0 ,1 ,0 ,2 ,0 ,2,2737 , 0 
7320.96,8,194 ,1 ,256 ,0 ,0 ,0 ,0 ,0 ,0 ,0 ,0 ,0 ,1 ,0 ,1,2901 , 0 
7321.078,11,194 ,5 ,872 ,0 ,0 ,1 ,0 ,0 ,0 ,0 ,1 ,0 ,2 ,0 ,2,4565 , 0 
7321.123,2,194 ,1 ,256 ,0 ,0 ,2 ,0 ,1 ,0 ,0 ,3 ,0 ,1 ,1 ,2,5039 , 0 
7321.138,6,194 ,2 ,512 ,0 ,0 ,1 ,0 ,1 ,0 ,0 ,2 ,0 ,1 ,1 ,2,6380 , 0 
7321.214,18,194 ,4 ,796 ,0 ,0 ,1 ,0 ,0 ,0 ,0 ,1 ,0 ,0 ,0 ,0,4435 , 0 
7321.235,4,194 ,8 ,515 ,0 ,0 ,1 ,0 ,0 ,0 ,0 ,1 ,0 ,0 ,0 ,0,3767 , 0 
7321.289,7,194 ,17 ,1044 ,0 ,0 ,1 ,0 ,0 ,0 ,0 ,1 ,0 ,1 ,0 ,1,8183 , 0 
7321.337,14,194 ,1 ,256 ,0 ,0 ,1 ,0 ,0 ,0 ,0 ,1 ,0 ,4 ,0 ,4,3741 , 0 
7321.35,15,194 ,11 ,1238 ,0 ,0 ,2 ,0 ,0 ,0 ,0 ,2 ,0 ,1 ,0 ,1,4692 , 0 
7321.36,20,194 ,5 ,839 ,0 ,0 ,1 ,0 ,0 ,0 ,0 ,1 ,0 ,1 ,0 ,1,4210 , 0 
7321.36,16,194 ,2 ,512 ,0 ,0 ,2 ,0 ,0 ,0 ,0 ,2 ,0 ,0 ,0 ,0,10414 , 0 
7321.444,10,194 ,14 ,512 ,0 ,0 ,1 ,0 ,0 ,0 ,0 ,1 ,0 ,0 ,0 ,0,3648 , 0 
7321.481,12,194 ,5 ,800 ,0 ,0 ,1 ,0 ,0 ,0 ,0 ,1 ,0 ,1 ,0 ,1,4401 , 0 
7321.596,9,194 ,5 ,779 ,0 ,0 ,1 ,0 ,0 ,0 ,0 ,1 ,0 ,4 ,0 ,4,8508 , 0 
7321.602,5,194 ,2 ,512 ,0 ,0 ,1 ,0 ,0 ,0 ,0 ,1 ,0 ,3 ,0 ,3,6304 , 0 
7321.606,19,194 ,1 ,256 ,0 ,0 ,1 ,0 ,0 ,0 ,0 ,1 ,0 ,2 ,0 ,2,4070 , 0 
7321.696,17,194 ,6 ,774 ,0 ,0 ,0 ,1 ,0 ,0 ,0 ,1 ,0 ,2 ,0 ,2,5163 , 0 
7321.771,13,194 ,1 ,256 ,0 ,0 ,2 ,0 ,0 ,0 ,0 ,2 ,0 ,1 ,0 ,1,3674 , 0 
7321.786,3,194 ,1 ,256 ,0 ,0 ,2 ,0 ,0 ,0 ,0 ,2 ,0 ,0 ,0 ,0,2828 , 0 
7440.96,8,194 ,1 ,256 ,0 ,0 ,2 ,0 ,0 ,0 ,0 ,2 ,0 ,3 ,0 ,3,3395 , 0 
7441.078,11,194 ,5 ,872 ,0 ,0 ,2 ,0 ,0 ,0 ,0 ,2 ,0 ,1 ,0 ,1,4195 , 0 
7441.123,2,194 ,1 ,256 ,0 ,0 ,1 ,0 ,2 ,0 ,0 ,3 ,0 ,1 ,2 ,3,5532 , 0 
7441.138,6,194 ,2 ,512 ,0 ,0 ,1 ,1 ,1 ,0 ,0 ,3 ,0 ,1 ,1 ,2,7532 , 0 
7441.214,18,194 ,4 ,796 ,0 ,0 ,1 ,0 ,0 ,0 ,0 ,1 ,0 ,1 ,0 ,1,4296 , 0 
7441.235,4,194 ,8 ,512 ,0 ,0 ,1 ,0 ,0 ,0 ,0 ,1 ,0 ,1 ,0 ,1,3873 , 0 
7441.289,7,194 ,17 ,1039 ,0 ,0 ,0 ,1 ,0 ,0 ,0 ,1 ,0 ,3 ,0 ,3,8703 , 0 
7441.337,14,194 ,1 ,256 ,0 ,0 ,0 ,0 ,0 ,0 ,0 ,0 ,0 ,2 ,0 ,2,3542 , 0 
7441.35,15,194 ,11 ,1238 ,0 ,0 ,1 ,0 ,0 ,0 ,0 ,1 ,0 ,1 ,0 ,1,3979 , 0 
7441.36,20,194 ,5 ,839 ,0 ,0 ,1 ,0 ,0 ,0 ,0 ,1 ,0 ,1 ,0 ,1,3755 , 0 
7441.36,16,194 ,2 ,512 ,0 ,0 ,0 ,0 ,0 ,0 ,0 ,0 ,0 ,2 ,0 ,2,11606 , 0 
7441.444,10,194 ,14 ,512 ,0 ,0 ,1 ,0 ,0 ,0 ,0 ,1 ,0 ,0 ,0 ,0,3931 , 0 
7441.481,12,194 ,5 ,800 ,0 ,0 ,1 ,0 ,0 ,0 ,0 ,1 ,0 ,2 ,0 ,2,4361 , 0 
7441.596,9,194 ,5 ,779 ,0 ,0 ,2 ,0 ,0 ,0 ,0 ,2 ,0 ,1 ,0 ,1,9344 , 0 
7441.602,5,194 ,2 ,512 ,0 ,0 ,0 ,0 ,0 ,0 ,0 ,0 ,0 ,3 ,0 ,3,6572 , 0 
7441.606,19,194 ,1 ,256 ,0 ,0 ,1 ,0 ,0 ,0 ,0 ,1 ,0 ,3 ,0 ,3,4442 , 0 
7441.696,17,194 ,6 ,774 ,0 ,0 ,1 ,0 ,1 ,0 ,0 ,2 ,0 ,0 ,1 ,1,5568 , 0 
7441.771,13,194 ,1 ,256 ,0 ,0 ,2 ,0 ,0 ,0 ,0 ,2 ,0 ,1 ,0 ,1,4014 , 0 
7441.786,3,194 ,1 ,256 ,0 ,0 ,2 ,0 ,0 ,0 ,0 ,2 ,0 ,1 ,0 ,1,2801 , 0 
7560.96,8,194 ,1 ,256 ,0 ,0 ,1 ,0 ,1 ,0 ,0 ,2 ,0 ,0 ,1 ,1,2973 , 0 
7561.078,11,194 ,5 ,801 ,0 ,0 ,1 ,1 ,0 ,1 ,1 ,4 ,0 ,6 ,1 ,7,4659 , 0 
7561.124,2,194 ,1 ,256 ,0 ,0 ,1 ,0 ,8 ,0 ,2 ,11 ,0 ,4 ,12 ,16,5154 , 0 
7561.138,6,194 ,2 ,512 ,0 ,0 ,1 ,0 ,0 ,1 ,1 ,3 ,0 ,1 ,2 ,3,6466 , 0 
7561.214,18,194 ,4 ,781 ,0 ,0 ,1 ,1 ,0 ,0 ,0 ,2 ,0 ,2 ,0 ,2,4532 , 0 
7561.235,4,194 ,8 ,512 ,0 ,0 ,1 ,0 ,1 ,0 ,0 ,2 ,0 ,0 ,1 ,1,3864 , 0 
7561.289,7,194 ,16 ,768 ,0 ,0 ,6 ,2 ,3 ,1 ,0 ,12 ,0 ,6 ,3 ,9,8326 , 0 
7561.337,14,194 ,1 ,256 ,0 ,0 ,2 ,0 ,0 ,0 ,0 ,2 ,0 ,1 ,0 ,1,3836 , 0 
7561.35,15,194 ,7 ,1032 ,0 ,0 ,5 ,3 ,0 ,1 ,0 ,9 ,0 ,4 ,0 ,4,4817 , 0 
7561.36,20,194 ,5 ,801 ,0 ,0 ,1 ,1 ,0 ,0 ,0 ,2 ,0 ,2 ,0 ,2,4311 , 0 
7561.36,16,194 ,2 ,512 ,0 ,0 ,3 ,0 ,5 ,0 ,0 ,8 ,0 ,7 ,5 ,12,10542 , 0 
7561.444,10,194 ,14 ,512 ,0 ,0 ,0 ,0 ,0 ,0 ,0 ,0 ,0 ,0 ,0 ,0,3704 , 0 
7561.481,12,194 ,5 ,801 ,0 ,0 ,1 ,1 ,0 ,0 ,0 ,2 ,0 ,1 ,0 ,1,4484 , 0 
7561.596,9,194 ,5 ,801 ,0 ,0 ,1 ,0 ,0 ,0 ,0 ,1 ,0 ,14 ,0 ,14,8592 , 0 
7561.602,5,194 ,2 ,512 ,0 ,0 ,2 ,0 ,3 ,1 ,1 ,7 ,0 ,1 ,5 ,6,6462 , 0 
7561.606,19,194 ,1 ,256 ,0 ,0 ,1 ,0 ,0 ,0 ,0 ,1 ,0 ,3 ,0 ,3,4162 , 0 
7561.696,17,194 ,6 ,774 ,0 ,0 ,1 ,0 ,0 ,1 ,1 ,3 ,0 ,6 ,1 ,7,5234 , 0 
7561.771,13,194 ,1 ,256 ,0 ,0 ,1 ,0 ,0 ,0 ,0 ,1 ,0 ,2 ,0 ,2,3782 , 0 
7561.786,3,194 ,1 ,256 ,0 ,0 ,1 ,0 ,0 ,0 ,0 ,1 ,0 ,2 ,0 ,2,2907 , 0 
7680.96,8,194 ,1 ,256 ,0 ,0 ,1 ,0 ,0 ,0 ,0 ,1 ,0 ,1 ,0 ,1,3450 , 0 
7681.078,11,194 ,5 ,786 ,0 ,0 ,0 ,1 ,0 ,0 ,0 ,1 ,0 ,8 ,0 ,8,4277 , 0 
7681.124,2,194 ,16 ,1613 ,0 ,0 ,1 ,0 ,3 ,1 ,5 ,10 ,0 ,1 ,8 ,9,5656 , 0 
7681.138,6,194 ,0 ,0 ,0 ,0 ,1 ,0 ,1 ,1 ,1 ,4 ,0 ,2 ,2 ,4,7617 , 0 
7681.214,18,194 ,4 ,781 ,0 ,0 ,2 ,0 ,0 ,0 ,0 ,2 ,0 ,1 ,0 ,1,4380 , 0 
7681.235,4,194 ,8 ,512 ,0 ,0 ,1 ,0 ,0 ,0 ,0 ,1 ,0 ,1 ,0 ,1,3944 , 0 
7681.289,7,197 ,16 ,768 ,0 ,0 ,2 ,0 ,7 ,0 ,1 ,10 ,0 ,2 ,8 ,10,8817 , 1 
7681.337,14,194 ,1 ,256 ,0 ,0 ,1 ,0 ,0 ,0 ,0 ,1 ,0 ,1 ,0 ,1,3606 , 0 
7681.35,15,196 ,7 ,1031 ,0 ,0 ,3 ,2 ,0 ,1 ,0 ,6 ,0 ,1 ,0 ,1,4090 , 0 
7681.36,20,194 ,5 ,801 ,0 ,0 ,2 ,0 ,0 ,0 ,0 ,2 ,0 ,1 ,0 ,1,3817 , 0 
7681.361,16,196 ,17 ,1332 ,0 ,0 ,3 ,1 ,7 ,1 ,1 ,13 ,0 ,2 ,9 ,11,11771 , 0 
7681.444,10,194 ,14 ,512 ,0 ,0 ,1 ,0 ,0 ,0 ,0 ,1 ,0 ,0 ,0 ,0,3983 , 0 
7681.481,12,194 ,5 ,801 ,0 ,0 ,2 ,0 ,0 ,0 ,0 ,2 ,0 ,2 ,0 ,2,4447 , 0 
7681.596,9,196 ,7 ,1031 ,0 ,0 ,2 ,1 ,0 ,1 ,0 ,4 ,0 ,3 ,0 ,3,9490 , 0 
7681.602,5,194 ,2 ,512 ,0 ,0 ,1 ,0 ,1 ,0 ,1 ,3 ,0 ,3 ,2 ,5,6718 , 0 
7681.606,19,194 ,1 ,256 ,0 ,0 ,1 ,0 ,0 ,0 ,0 ,1 ,0 ,2 ,0 ,2,4521 , 0 
7681.702,17,196 ,7 ,1031 ,0 ,0 ,2 ,2 ,4 ,1 ,0 ,9 ,0 ,6 ,6 ,12,5743 , 0 
7681.771,13,194 ,1 ,256 ,0 ,0 ,1 ,0 ,0 ,0 ,0 ,1 ,0 ,1 ,0 ,1,4093 , 0 
7681.786,3,194 ,1 ,256 ,0 ,0 ,0 ,0 ,0 ,0 ,0 ,0 ,0 ,0 ,0 ,0,2850 , 0 
7800.96,8,217 ,1 ,256 ,0 ,0 ,16 ,9 ,8 ,9 ,2 ,44 ,0 ,26 ,12 ,38,3657 , 0 
7801.078,11,216 ,9 ,5618 ,0 ,0 ,17 ,9 ,3 ,11 ,3 ,43 ,0 ,12 ,11 ,23,5539 , 0 
7801.124,2,216 ,16 ,3058 ,0 ,0 ,15 ,8 ,13 ,10 ,6 ,52 ,0 ,27 ,24 ,51,6020 , 0 
7801.139,6,216 ,16 ,3186 ,0 ,0 ,13 ,8 ,8 ,7 ,2 ,38 ,0 ,15 ,12 ,27,7495 , 0 
7801.236,4,217 ,8 ,1458 ,0 ,0 ,15 ,10 ,1 ,9 ,1 ,36 ,0 ,25 ,2 ,27,4572 , 0 
7801.249,18,216 ,5 ,4285 ,0 ,0 ,17 ,13 ,6 ,9 ,4 ,49 ,0 ,23 ,11 ,34,5538 , 0 
7801.29,7,225 ,16 ,768 ,0 ,0 ,14 ,0 ,29 ,0 ,8 ,51 ,0 ,11 ,46 ,57,9276 , 1 
7801.35,15,222 ,7 ,1892 ,0 ,0 ,15 ,5 ,5 ,4 ,4 ,33 ,0 ,12 ,10 ,22,5570 , 0 
7801.36,20,216 ,5 ,4285 ,0 ,0 ,13 ,5 ,1 ,9 ,1 ,29 ,0 ,15 ,4 ,19,4998 , 0 
7801.408,16,216 ,17 ,2453 ,0 ,0 ,12 ,6 ,35 ,4 ,8 ,65 ,0 ,14 ,50 ,64,11842 , 0 
7801.418,14,217 ,1 ,256 ,0 ,0 ,14 ,9 ,3 ,12 ,1 ,39 ,0 ,12 ,4 ,16,4636 , 0 
7801.444,10,216 ,6 ,3570 ,0 ,0 ,15 ,9 ,1 ,6 ,1 ,32 ,0 ,12 ,3 ,15,4273 , 0 
7801.482,12,216 ,0 ,0 ,0 ,0 ,13 ,9 ,0 ,9 ,0 ,31 ,0 ,13 ,1 ,14,5136 , 0 
7801.596,9,216 ,16 ,3058 ,0 ,0 ,14 ,5 ,3 ,4 ,0 ,26 ,0 ,12 ,6 ,18,9202 , 0 
7801.603,5,216 ,2 ,3773 ,0 ,0 ,14 ,9 ,3 ,10 ,5 ,41 ,0 ,20 ,8 ,28,7310 , 0 
7801.607,19,216 ,5 ,4285 ,0 ,0 ,18 ,8 ,15 ,8 ,5 ,54 ,0 ,22 ,30 ,52,5127 , 0 
7801.71,17,224 ,0 ,0 ,0 ,0 ,13 ,6 ,45 ,8 ,14 ,86 ,0 ,14 ,62 ,76,6855 , 0 
7801.772,13,216 ,19 ,5940 ,0 ,0 ,16 ,9 ,0 ,11 ,0 ,36 ,0 ,12 ,4 ,16,4661 , 0 
7801.787,3,217 ,1 ,256 ,0 ,0 ,12 ,7 ,7 ,5 ,2 ,33 ,0 ,13 ,10 ,23,3458 , 0 
7920.973,8,255 ,1 ,256 ,0 ,0 ,15 ,11 ,3 ,10 ,3 ,42 ,0 ,33 ,7 ,40,4073 , 0 
7921.078,11,0 ,20 ,1024 ,0 ,0 ,19 ,5 ,6 ,8 ,5 ,43 ,0 ,40 ,14 ,54,5059 , 0 
7921.124,2,0 ,1 ,256 ,0 ,0 ,15 ,6 ,9 ,10 ,6 ,46 ,0 ,43 ,22 ,65,6436 , 0 
7921.138,6,0 ,17 ,2989 ,0 ,0 ,17 ,2 ,1 ,5 ,1 ,26 ,0 ,37 ,7 ,44,8105 , 0 
7921.214,18,0 ,4 ,1049 ,0 ,0 ,15 ,4 ,0 ,9 ,0 ,28 ,0 ,26 ,0 ,26,4974 , 0 
7921.236,4,254 ,8 ,512 ,0 ,0 ,16 ,9 ,0 ,8 ,0 ,33 ,0 ,25 ,2 ,27,4592 , 0 
7921.29,7,3 ,16 ,65535 ,0 ,0 ,17 ,0 ,8 ,3 ,2 ,30 ,0 ,25 ,19 ,44,9469 , 1 
7921.338,14,0 ,1 ,256 ,0 ,0 ,13 ,8 ,3 ,9 ,3 ,36 ,0 ,30 ,11 ,41,4091 , 0 
7921.35,15,0 ,7 ,1674 ,0 ,0 ,13 ,1 ,5 ,4 ,1 ,24 ,0 ,28 ,13 ,41,4628 , 0 
7921.36,20,0 ,5 ,768 ,0 ,0 ,16 ,6 ,1 ,6 ,1 ,30 ,0 ,20 ,5 ,25,4576 , 0 
7921.361,16,2 ,17 ,2698 ,0 ,0 ,16 ,3 ,4 ,5 ,2 ,30 ,0 ,34 ,18 ,52,12374 , 0 
7921.444,10,253 ,14 ,512 ,0 ,0 ,13 ,5 ,0 ,8 ,0 ,26 ,0 ,16 ,0 ,16,4387 , 0 
7921.482,12,0 ,20 ,1024 ,0 ,0 ,16 ,6 ,1 ,8 ,1 ,32 ,0 ,27 ,2 ,29,4993 , 0 
7921.596,9,2 ,0 ,65535 ,0 ,0 ,17 ,3 ,1 ,5 ,0 ,26 ,0 ,39 ,1 ,40,10092 , 0 
7921.603,5,0 ,13 ,580 ,0 ,0 ,15 ,5 ,8 ,10 ,4 ,42 ,0 ,40 ,20 ,60,7494 , 0 
7921.607,19,0 ,1 ,256 ,0 ,0 ,19 ,8 ,12 ,13 ,8 ,60 ,0 ,46 ,29 ,75,5308 , 0 
7921.697,17,2 ,7 ,1674 ,0 ,0 ,14 ,2 ,7 ,2 ,3 ,28 ,0 ,26 ,12 ,38,6327 , 0 
7921.771,13,0 ,1 ,256 ,0 ,0 ,14 ,7 ,9 ,8 ,6 ,44 ,0 ,36 ,19 ,55,4729 , 0 
7921.787,3,0 ,1 ,256 ,0 ,0 ,12 ,10 ,3 ,9 ,3 ,37 ,0 ,23 ,6 ,29,3178 , 0 
8040.96,8,5 ,1 ,256 ,0 ,0 ,7 ,4 ,0 ,3 ,0 ,14 ,0 ,23 ,0 ,23,3811 , 0 
8041.078,11,5 ,5 ,870 ,0 ,0 ,9 ,4 ,3 ,0 ,0 ,16 ,0 ,28 ,3 ,31,5740 , 0 
8041.124,2,5 ,1 ,256 ,0 ,0 ,8 ,4 ,11 ,1 ,2 ,26 ,0 ,32 ,13 ,45,6237 , 0 
8041.138,6,5 ,10 ,819 ,0 ,0 ,10 ,4 ,1 ,4 ,1 ,20 ,0 ,29 ,3 ,32,7791 , 0 
8041.214,18,5 ,4 ,1166 ,0 ,0 ,7 ,4 ,0 ,0 ,0 ,11 ,0 ,18 ,0 ,18,5710 , 0 
8041.236,4,5 ,19 ,557 ,0 ,0 ,7 ,3 ,4 ,0 ,0 ,14 ,0 ,12 ,4 ,16,4817 , 0 
8041.289,7,5 ,16 ,962 ,0 ,0 ,10 ,5 ,3 ,1 ,2 ,21 ,0 ,29 ,8 ,37,9510 , 0 
8041.337,14,5 ,1 ,256 ,0 ,0 ,8 ,4 ,6 ,2 ,0 ,20 ,0 ,27 ,6 ,33,4790 , 0 
8041.35,15,5 ,11 ,1297 ,0 ,0 ,11 ,3 ,0 ,1 ,0 ,15 ,0 ,21 ,0 ,21,5825 , 0 
8041.36,20,5 ,5 ,870 ,0 ,0 ,8 ,4 ,0 ,0 ,0 ,12 ,0 ,17 ,0 ,17,5197 , 0 
8041.361,16,5 ,2 ,512 ,0 ,0 ,8 ,2 ,9 ,0 ,2 ,21 ,0 ,33 ,14 ,47,12233 , 0 
8041.444,10,5 ,14 ,512 ,0 ,0 ,9 ,5 ,2 ,1 ,0 ,17 ,0 ,14 ,3 ,17,4503 , 0 
8041.482,12,5 ,5 ,870 ,0 ,0 ,6 ,4 ,0 ,1 ,0 ,11 ,0 ,21 ,0 ,21,5352 , 0 
8041.596,9,5 ,5 ,870 ,0 ,0 ,11 ,4 ,0 ,0 ,0 ,15 ,0 ,31 ,0 ,31,9444 , 0 
8041.603,5,5 ,19 ,557 ,0 ,0 ,7 ,3 ,19 ,0 ,0 ,29 ,0 ,27 ,20 ,47,7715 , 0 
8041.607,19,5 ,1 ,256 ,0 ,0 ,6 ,4 ,27 ,2 ,0 ,39 ,0 ,35 ,27 ,62,5366 , 0 
8041.696,17,5 ,7 ,1294 ,0 ,0 ,15 ,6 ,2 ,7 ,1 ,31 ,0 ,23 ,7 ,30,7246 , 0 
8041.771,13,5 ,1 ,256 ,0 ,0 ,7 ,4 ,0 ,3 ,0 ,14 ,0 ,26 ,0 ,26,4829 , 0 
8041.787,3,5 ,1 ,256 ,0 ,0 ,7 ,5 ,0 ,3 ,0 ,15 ,0 ,16 ,0 ,16,3625 , 0 
8160.96,8,5 ,1 ,256 ,0 ,0 ,2 ,1 ,0 ,0 ,0 ,3 ,0 ,4 ,0 ,4,4143 , 0 
8161.077,11,5 ,5 ,845 ,0 ,0 ,3 ,1 ,0 ,1 ,1 ,6 ,0 ,8 ,1 ,9,5149 , 0 
8161.123,2,5 ,1 ,256 ,0 ,0 ,2 ,1 ,4 ,0 ,0 ,7 ,0 ,7 ,4 ,11,6539 , 0 
8161.138,6,5 ,10 ,827 ,0 ,0 ,3 ,1 ,0 ,0 ,0 ,4 ,0 ,4 ,0 ,4,8213 , 0 
8161.213,18,5 ,5 ,845 ,0 ,0 ,6 ,1 ,0 ,1 ,0 ,8 ,0 ,7 ,0 ,7,5104 , 0 
8161.235,4,5 ,19 ,512 ,0 ,0 ,1 ,2 ,0 ,1 ,1 ,5 ,0 ,7 ,1 ,8,4680 , 0 
8161.289,7,5 ,16 ,962 ,0 ,0 ,3 ,0 ,2 ,1 ,0 ,6 ,0 ,5 ,2 ,7,9573 , 0 
8161.337,14,5 ,1 ,256 ,0 ,0 ,0 ,1 ,1 ,0 ,0 ,2 ,0 ,9 ,1 ,10,4157 , 0 
8161.35,15,5 ,9 ,1160 ,0 ,0 ,5 ,1 ,0 ,1 ,0 ,7 ,0 ,4 ,0 ,4,4737 , 0 
8161.359,20,5 ,5 ,845 ,0 ,0 ,3 ,1 ,0 ,0 ,0 ,4 ,0 ,4 ,0 ,4,4655 , 0 
8161.36,16,5 ,2 ,512 ,0 ,0 ,3 ,2 ,2 ,0 ,0 ,7 ,0 ,5 ,3 ,8,12488 , 0 
8161.444,10,5 ,14 ,512 ,0 ,0 ,2 ,0 ,1 ,0 ,0 ,3 ,0 ,2 ,1 ,3,4470 , 0 
8161.481,12,5 ,5 ,845 ,0 ,0 ,2 ,1 ,0 ,0 ,0 ,3 ,0 ,8 ,0 ,8,5079 , 0 
8161.596,9,5 ,5 ,785 ,0 ,0 ,1 ,2 ,1 ,0 ,0 ,4 ,0 ,11 ,1 ,12,10204 , 0 
8161.602,5,5 ,19 ,512 ,0 ,0 ,2 ,2 ,7 ,0 ,1 ,12 ,0 ,11 ,9 ,20,7690 , 0 
8161.607,19,5 ,1 ,256 ,0 ,0 ,3 ,1 ,11 ,0 ,2 ,17 ,0 ,10 ,14 ,24,5441 , 0 
8161.696,17,5 ,7 ,1236 ,0 ,0 ,2 ,2 ,0 ,0 ,0 ,4 ,0 ,4 ,0 ,4,6406 , 0 
8161.771,13,5 ,1 ,256 ,0 ,0 ,3 ,1 ,0 ,0 ,0 ,4 ,0 ,5 ,0 ,5,4812 , 0 
8161.786,3,5 ,1 ,256 ,0 ,0 ,2 ,1 ,0 ,0 ,0 ,3 ,0 ,2 ,0 ,2,3243 , 0 
8280.96,8,5 ,1 ,256 ,0 ,0 ,1 ,1 ,1 ,0 ,0 ,3 ,0 ,7 ,1 ,8,3891 , 0 
8281.077,11,5 ,5 ,774 ,0 ,0 ,0 ,1 ,0 ,0 ,0 ,1 ,0 ,5 ,0 ,5,5804 , 0 
8281.123,2,5 ,1 ,256 ,0 ,0 ,2 ,0 ,2 ,0 ,0 ,4 ,0 ,3 ,2 ,5,6350 , 0 
8281.138,6,5 ,10 ,815 ,0 ,0 ,1 ,1 ,0 ,0 ,0 ,2 ,0 ,2 ,0 ,2,7877 , 0 
8281.213,18,5 ,5 ,774 ,0 ,0 ,3 ,1 ,0 ,0 ,0 ,4 ,0 ,7 ,0 ,7,5802 , 0 
8281.235,4,5 ,8 ,525 ,0 ,0 ,6 ,1 ,0 ,1 ,0 ,8 ,0 ,3 ,0 ,3,4954 , 0 
8281.289,7,5 ,16 ,860 ,0 ,0 ,2 ,1 ,0 ,0 ,0 ,3 ,0 ,6 ,0 ,6,9597 , 0 
8281.337,14,5 ,1 ,256 ,0 ,0 ,2 ,1 ,2 ,0 ,0 ,5 ,0 ,3 ,2 ,5,4878 , 0 
8281.35,15,5 ,9 ,1072 ,0 ,0 ,3 ,1 ,0 ,0 ,0 ,4 ,0 ,2 ,0 ,2,5906 , 0 
8281.359,20,5 ,5 ,774 ,0 ,0 ,1 ,1 ,0 ,0 ,0 ,2 ,0 ,3 ,0 ,3,5260 , 0 
8281.36,16,5 ,2 ,512 ,0 ,0 ,2 ,1 ,1 ,0 ,0 ,4 ,0 ,5 ,1 ,6,12322 , 0 
8281.443,10,5 ,14 ,512 ,0 ,0 ,1 ,1 ,1 ,0 ,0 ,3 ,0 ,1 ,1 ,2,4579 , 0 
8281.481,12,5 ,5 ,774 ,0 ,0 ,2 ,1 ,0 ,0 ,0 ,3 ,0 ,4 ,0 ,4,5424 , 0 
8281.595,9,5 ,5 ,774 ,0 ,0 ,2 ,1 ,1 ,0 ,0 ,4 ,0 ,5 ,1 ,6,9536 , 0 
8281.602,5,5 ,19 ,512 ,0 ,0 ,2 ,0 ,6 ,0 ,0 ,8 ,0 ,3 ,6 ,9,7840 , 0 
8281.606,19,5 ,1 ,256 ,0 ,0 ,1 ,1 ,6 ,1 ,1 ,10 ,0 ,10 ,7 ,17,5456 , 0 
8281.696,17,5 ,7 ,1234 ,0 ,0 ,2 ,0 ,0 ,0 ,0 ,2 ,0 ,4 ,0 ,4,7320 , 0 
8281.771,13,5 ,1 ,256 ,0 ,0 ,0 ,1 ,0 ,0 ,0 ,1 ,0 ,3 ,0 ,3,4890 , 0 
8281.786,3,5 ,1 ,256 ,0 ,0 ,2 ,1 ,0 ,0 ,0 ,3 ,0 ,3 ,0 ,3,3709 , 0 
8400.96,8,5 ,1 ,256 ,0 ,0 ,2 ,0 ,0 ,0 ,0 ,2 ,0 ,3 ,0 ,3,4219 , 0 
8401.091,11,5 ,9 ,300 ,0 ,0 ,15 ,9 ,8 ,12 ,1 ,45 ,0 ,17 ,23 ,40,5673 , 0 
8401.124,2,5 ,1 ,256 ,0 ,0 ,0 ,0 ,10 ,3 ,6 ,19 ,0 ,14 ,18 ,32,6714 , 0 
8401.138,6,5 ,10 ,788 ,0 ,0 ,7 ,4 ,0 ,2 ,0 ,13 ,0 ,13 ,0 ,13,8409 , 0 
8401.213,18,5 ,5 ,607 ,0 ,0 ,2 ,5 ,0 ,0 ,0 ,7 ,0 ,8 ,0 ,8,5317 , 0 
8401.235,4,5 ,8 ,521 ,0 ,0 ,2 ,0 ,0 ,0 ,0 ,2 ,0 ,2 ,0 ,2,4770 , 0 
8401.289,7,5 ,9 ,300 ,0 ,0 ,8 ,10 ,7 ,5 ,1 ,31 ,0 ,18 ,13 ,31,10029 , 0 
8401.337,14,5 ,1 ,256 ,0 ,0 ,2 ,0 ,2 ,0 ,1 ,5 ,0 ,2 ,3 ,5,4254 , 0 
8401.36,20,5 ,5 ,607 ,0 ,0 ,0 ,5 ,0 ,0 ,0 ,5 ,0 ,17 ,0 ,17,4794 , 0 
8401.361,16,5 ,2 ,512 ,0 ,0 ,11 ,10 ,7 ,10 ,4 ,42 ,0 ,21 ,23 ,44,12998 , 0 
8401.444,10,5 ,14 ,512 ,0 ,0 ,2 ,0 ,2 ,0 ,1 ,5 ,0 ,6 ,3 ,9,4554 , 0 
8401.467,15,5 ,9 ,300 ,0 ,0 ,2 ,8 ,4 ,2 ,2 ,18 ,0 ,25 ,7 ,32,5002 , 0 
8401.482,12,5 ,11 ,567 ,0 ,0 ,4 ,9 ,0 ,1 ,0 ,14 ,0 ,15 ,0 ,15,5376 , 0 
8401.604,9,5 ,9 ,0 ,0 ,0 ,14 ,4 ,18 ,17 ,2 ,55 ,0 ,24 ,91 ,115,10849 , 1 
8401.606,19,5 ,1 ,256 ,0 ,0 ,1 ,0 ,0 ,2 ,2 ,5 ,0 ,9 ,2 ,11,5559 , 0 
8401.608,5,5 ,9 ,300 ,0 ,0 ,7 ,9 ,12 ,6 ,4 ,38 ,0 ,24 ,18 ,42,8291 , 0 
8401.697,17,5 ,7 ,665 ,0 ,0 ,1 ,6 ,0 ,0 ,0 ,7 ,0 ,18 ,0 ,18,6611 , 0 
8401.771,13,5 ,1 ,256 ,0 ,0 ,2 ,0 ,0 ,0 ,0 ,2 ,0 ,6 ,0 ,6,4957 , 0 
8401.786,3,5 ,1 ,256 ,0 ,0 ,2 ,0 ,0 ,0 ,0 ,2 ,0 ,2 ,0 ,2,3306 , 0 
8520.96,8,5 ,1 ,256 ,0 ,0 ,1 ,1 ,2 ,1 ,1 ,6 ,0 ,6 ,3 ,9,3972 , 0 
8521.078,11,5 ,9 ,300 ,0 ,0 ,14 ,11 ,13 ,6 ,1 ,45 ,0 ,39 ,27 ,66,6279 , 0 
8521.123,2,5 ,1 ,256 ,0 ,0 ,2 ,1 ,2 ,2 ,1 ,8 ,0 ,10 ,5 ,15,6482 , 0 
8521.138,6,5 ,10 ,788 ,0 ,0 ,2 ,1 ,0 ,0 ,0 ,3 ,0 ,6 ,0 ,6,7973 , 0 
8521.214,18,5 ,4 ,940 ,0 ,0 ,6 ,4 ,0 ,1 ,0 ,11 ,0 ,17 ,0 ,17,6021 , 0 
8521.235,4,5 ,19 ,512 ,0 ,0 ,6 ,2 ,3 ,1 ,0 ,12 ,0 ,3 ,3 ,6,5162 , 0 
8521.289,7,5 ,9 ,300 ,0 ,0 ,10 ,10 ,6 ,2 ,0 ,28 ,0 ,22 ,10 ,32,9942 , 0 
8521.337,14,5 ,1 ,256 ,0 ,0 ,2 ,1 ,2 ,0 ,0 ,5 ,0 ,4 ,2 ,6,4958 , 0 
8521.35,15,5 ,9 ,300 ,0 ,0 ,9 ,8 ,0 ,7 ,0 ,24 ,0 ,25 ,7 ,32,6226 , 0 
8521.36,20,5 ,11 ,585 ,0 ,0 ,9 ,5 ,0 ,2 ,0 ,16 ,0 ,25 ,0 ,25,5545 , 0 
8521.36,16,5 ,2 ,512 ,0 ,0 ,4 ,0 ,2 ,2 ,1 ,9 ,0 ,19 ,7 ,26,12528 , 0 
8521.443,10,5 ,14 ,512 ,0 ,0 ,1 ,1 ,1 ,0 ,0 ,3 ,0 ,2 ,1 ,3,4662 , 0 
8521.482,12,5 ,11 ,585 ,0 ,0 ,8 ,10 ,0 ,3 ,0 ,21 ,0 ,25 ,0 ,25,5756 , 0 
8521.596,9,5 ,5 ,777 ,0 ,0 ,14 ,7 ,22 ,19 ,3 ,65 ,0 ,30 ,66 ,96,10304 , 1 
8521.603,5,5 ,19 ,512 ,0 ,0 ,9 ,7 ,15 ,4 ,4 ,39 ,0 ,36 ,28 ,64,8371 , 0 
8521.607,19,5 ,1 ,256 ,0 ,0 ,1 ,1 ,17 ,0 ,1 ,20 ,0 ,17 ,19 ,36,5624 , 0 
8521.696,17,5 ,7 ,741 ,0 ,0 ,2 ,7 ,0 ,0 ,0 ,9 ,0 ,12 ,0 ,12,7504 , 0 
8521.771,13,5 ,1 ,256 ,0 ,0 ,2 ,1 ,2 ,4 ,4 ,13 ,0 ,8 ,6 ,14,5050 , 0 
8521.786,3,5 ,1 ,256 ,0 ,0 ,1 ,1 ,0 ,0 ,0 ,2 ,0 ,2 ,0 ,2,3776 , 0 
8640.96,8,5 ,1 ,256 ,0 ,0 ,1 ,0 ,1 ,0 ,0 ,2 ,0 ,6 ,1 ,7,4308 , 0 
8641.123,2,5 ,1 ,256 ,0 ,0 ,3 ,0 ,3 ,0 ,1 ,7 ,0 ,10 ,4 ,14,6937 , 0 
8641.138,6,5 ,10 ,780 ,0 ,0 ,4 ,1 ,0 ,0 ,0 ,5 ,0 ,9 ,0 ,9,8539 , 0 
8641.213,18,5 ,4 ,922 ,0 ,0 ,4 ,1 ,0 ,0 ,0 ,5 ,0 ,7 ,0 ,7,5433 , 0 
8641.217,11,5 ,9 ,65535 ,0 ,0 ,7 ,8 ,6 ,2 ,0 ,23 ,0 ,18 ,9 ,27,5991 , 0 
8641.235,4,5 ,8 ,520 ,0 ,0 ,4 ,1 ,1 ,1 ,0 ,7 ,0 ,5 ,1 ,6,4969 , 0 
8641.294,7,5 ,9 ,65535 ,0 ,0 ,9 ,5 ,4 ,7 ,0 ,25 ,0 ,18 ,18 ,36,10353 , 0 
8641.337,14,5 ,1 ,256 ,0 ,0 ,1 ,0 ,1 ,0 ,0 ,2 ,0 ,2 ,1 ,3,4324 , 0 
8641.35,15,5 ,9 ,300 ,0 ,0 ,6 ,6 ,0 ,2 ,0 ,14 ,0 ,19 ,1 ,20,5239 , 0 
8641.36,20,5 ,11 ,691 ,0 ,0 ,5 ,3 ,0 ,0 ,0 ,8 ,0 ,11 ,0 ,11,4950 , 0 
8641.36,16,5 ,2 ,512 ,0 ,0 ,5 ,1 ,0 ,0 ,0 ,6 ,0 ,19 ,1 ,20,13146 , 0 
8641.443,10,5 ,14 ,512 ,0 ,0 ,1 ,0 ,1 ,0 ,0 ,2 ,0 ,3 ,1 ,4,4623 , 0 
8641.482,12,5 ,11 ,691 ,0 ,0 ,4 ,4 ,0 ,0 ,0 ,8 ,0 ,13 ,0 ,13,5562 , 0 
8641.606,19,5 ,1 ,256 ,0 ,0 ,4 ,0 ,9 ,1 ,5 ,19 ,0 ,8 ,14 ,22,5748 , 0 
8641.608,5,5 ,9 ,65535 ,0 ,0 ,7 ,4 ,7 ,7 ,3 ,28 ,0 ,20 ,20 ,40,8728 , 0 
8641.696,17,5 ,7 ,874 ,0 ,0 ,4 ,7 ,0 ,1 ,0 ,12 ,0 ,9 ,0 ,9,6839 , 0 
8641.74,9,5 ,5 ,689 ,0 ,0 ,12 ,8 ,14 ,11 ,3 ,48 ,0 ,21 ,41 ,62,11394 , 1 
8641.771,13,5 ,1 ,256 ,0 ,0 ,4 ,0 ,0 ,0 ,0 ,4 ,0 ,8 ,0 ,8,5055 , 0 
8641.786,3,5 ,1 ,256 ,0 ,0 ,0 ,0 ,0 ,0 ,0 ,0 ,0 ,1 ,0 ,1,3366 , 0 
8760.96,8,5 ,1 ,256 ,0 ,0 ,1 ,0 ,2 ,0 ,0 ,3 ,0 ,5 ,2 ,7,4043 , 0 
8761.078,11,5 ,5 ,829 ,0 ,0 ,4 ,5 ,2 ,3 ,2 ,16 ,0 ,20 ,8 ,28,6506 , 0 
8761.124,2,5 ,1 ,256 ,0 ,0 ,4 ,0 ,11 ,1 ,0 ,16 ,0 ,13 ,11 ,24,6612 , 0 
8761.138,6,5 ,10 ,778 ,0 ,0 ,4 ,0 ,0 ,0 ,0 ,4 ,0 ,10 ,0 ,10,8061 , 0 
8761.214,18,5 ,4 ,929 ,0 ,0 ,3 ,2 ,0 ,0 ,0 ,5 ,0 ,15 ,0 ,15,6138 , 0 
8761.235,4,5 ,8 ,520 ,0 ,0 ,4 ,0 ,2 ,0 ,0 ,6 ,0 ,3 ,2 ,5,5255 , 0 
8761.289,7,5 ,16 ,829 ,0 ,0 ,7 ,3 ,0 ,0 ,0 ,10 ,0 ,14 ,1 ,15,10107 , 0 
8761.337,14,5 ,1 ,256 ,0 ,0 ,1 ,0 ,0 ,0 ,0 ,1 ,0 ,5 ,0 ,5,5042 , 0 
8761.35,15,5 ,11 ,1126 ,0 ,0 ,9 ,5 ,0 ,3 ,0 ,17 ,0 ,14 ,1 ,15,6501 , 0 
8761.36,20,5 ,5 ,829 ,0 ,0 ,4 ,6 ,1 ,3 ,1 ,15 ,0 ,12 ,2 ,14,5746 , 0 
8761.361,16,5 ,2 ,537 ,0 ,0 ,5 ,1 ,10 ,0 ,0 ,16 ,0 ,14 ,13 ,27,12782 , 0 
8761.443,10,5 ,14 ,512 ,0 ,0 ,1 ,0 ,0 ,0 ,0 ,1 ,0 ,3 ,0 ,3,4715 , 0 
8761.482,12,5 ,5 ,829 ,0 ,0 ,6 ,6 ,0 ,2 ,0 ,14 ,0 ,14 ,1 ,15,5984 , 0 
8761.596,9,5 ,16 ,829 ,0 ,0 ,6 ,3 ,0 ,3 ,0 ,12 ,0 ,21 ,3 ,24,10531 , 0 
8761.603,5,5 ,19 ,513 ,0 ,0 ,5 ,2 ,17 ,2 ,1 ,27 ,0 ,16 ,25 ,41,8775 , 0 
8761.607,19,5 ,1 ,256 ,0 ,0 ,4 ,0 ,19 ,2 ,1 ,26 ,0 ,13 ,23 ,36,5773 , 0 
8761.696,17,5 ,16 ,832 ,0 ,0 ,6 ,5 ,0 ,1 ,0 ,12 ,0 ,14 ,0 ,14,7657 , 0 
8761.771,13,5 ,1 ,256 ,0 ,0 ,3 ,0 ,0 ,0 ,0 ,3 ,0 ,10 ,0 ,10,5149 , 0 
8761.786,3,5 ,1 ,256 ,0 ,0 ,1 ,0 ,0 ,0 ,0 ,1 ,0 ,0 ,0 ,0,3835 , 0 
8880.96,8,5 ,1 ,256 ,0 ,0 ,1 ,0 ,1 ,0 ,0 ,2 ,0 ,3 ,1 ,4,4368 , 0 
8881.077,11,5 ,5 ,829 ,0 ,0 ,3 ,0 ,2 ,0 ,0 ,5 ,0 ,5 ,2 ,7,6075 , 0 
8881.123,2,5 ,1 ,256 ,0 ,0 ,2 ,0 ,4 ,0 ,0 ,6 ,0 ,5 ,4 ,9,7031 , 0 
8881.138,6,5 ,10 ,775 ,0 ,0 ,2 ,1 ,0 ,0 ,0 ,3 ,0 ,4 ,0 ,4,8620 , 0 
8881.213,18,5 ,4 ,921 ,0 ,0 ,2 ,1 ,0 ,0 ,0 ,3 ,0 ,5 ,0 ,5,5516 , 0 
8881.235,4,5 ,8 ,512 ,0 ,0 ,2 ,0 ,1 ,0 ,0 ,3 ,0 ,3 ,1 ,4,5041 , 0 
8881.289,7,5 ,16 ,844 ,0 ,0 ,2 ,1 ,0 ,0 ,0 ,3 ,0 ,4 ,0 ,4,10422 , 0 
8881.337,14,5 ,1 ,256 ,0 ,0 ,3 ,0 ,3 ,0 ,0 ,6 ,0 ,4 ,3 ,7,4427 , 0 
8881.35,15,5 ,11 ,1144 ,0 ,0 ,1 ,2 ,0 ,0 ,0 ,3 ,0 ,4 ,0 ,4,5320 , 0 
8881.359,20,5 ,5 ,829 ,0 ,0 ,3 ,0 ,0 ,0 ,0 ,3 ,0 ,5 ,0 ,5,5038 , 0 
8881.36,16,5 ,2 ,525 ,0 ,0 ,2 ,1 ,3 ,0 ,0 ,6 ,0 ,5 ,3 ,8,13260 , 0 
8881.443,10,5 ,14 ,512 ,0 ,0 ,2 ,2 ,1 ,0 ,0 ,5 ,0 ,3 ,1 ,4,4719 , 0 
8881.481,12,5 ,5 ,829 ,0 ,0 ,2 ,0 ,0 ,0 ,0 ,2 ,0 ,6 ,0 ,6,5633 , 0 
8881.596,9,5 ,16 ,844 ,0 ,0 ,1 ,1 ,0 ,0 ,0 ,2 ,0 ,4 ,0 ,4,11468 , 0 
8881.602,5,5 ,19 ,512 ,0 ,0 ,1 ,1 ,2 ,0 ,0 ,4 ,0 ,12 ,2 ,14,8848 , 0 
8881.606,19,5 ,1 ,256 ,0 ,0 ,2 ,0 ,3 ,0 ,0 ,5 ,0 ,5 ,3 ,8,5833 , 0 
8881.696,17,5 ,16 ,844 ,0 ,0 ,1 ,1 ,0 ,0 ,0 ,2 ,0 ,4 ,0 ,4,6903 , 0 
8881.771,13,5 ,1 ,256 ,0 ,0 ,2 ,0 ,0 ,0 ,0 ,2 ,0 ,5 ,0 ,5,5147 , 0 
8881.786,3,5 ,1 ,256 ,0 ,0 ,1 ,0 ,0 ,0 ,0 ,1 ,0 ,1 ,0 ,1,3424 , 0 
9000.96,8,5 ,1 ,256 ,0 ,0 ,3 ,0 ,1 ,0 ,0 ,4 ,0 ,1 ,1 ,2,4160 , 0 
9001.077,11,5 ,5 ,792 ,0 ,0 ,1 ,1 ,0 ,0 ,0 ,2 ,0 ,5 ,0 ,5,6634 , 0 
9001.123,2,5 ,1 ,256 ,0 ,0 ,1 ,0 ,4 ,0 ,0 ,5 ,0 ,3 ,4 ,7,6713 , 0 
9001.138,6,5 ,10 ,772 ,0 ,0 ,1 ,0 ,0 ,0 ,0 ,1 ,0 ,6 ,0 ,6,8142 , 0 
9001.213,18,5 ,4 ,943 ,0 ,0 ,1 ,1 ,0 ,0 ,0 ,2 ,0 ,2 ,0 ,2,6213 , 0 
9001.235,4,5 ,8 ,512 ,0 ,0 ,2 ,0 ,1 ,0 ,0 ,3 ,0 ,1 ,1 ,2,5382 , 0 
9001.289,7,5 ,16 ,849 ,0 ,0 ,1 ,2 ,0 ,0 ,0 ,3 ,0 ,4 ,0 ,4,10214 , 0 
9001.337,14,5 ,1 ,256 ,0 ,0 ,1 ,0 ,0 ,0 ,0 ,1 ,0 ,3 ,0 ,3,5100 , 0 
9001.35,15,5 ,11 ,1144 ,0 ,0 ,2 ,0 ,0 ,0 ,0 ,2 ,0 ,0 ,0 ,0,6576 , 0 
9001.359,20,5 ,5 ,792 ,0 ,0 ,1 ,1 ,0 ,0 ,0 ,2 ,0 ,1 ,0 ,1,5809 , 0 
9001.36,16,5 ,2 ,525 ,0 ,0 ,2 ,0 ,4 ,0 ,0 ,6 ,0 ,1 ,4 ,5,12939 , 0 
9001.444,10,5 ,14 ,512 ,0 ,0 ,2 ,0 ,0 ,0 ,0 ,2 ,0 ,0 ,0 ,0,4776 , 0 
9001.481,12,5 ,5 ,792 ,0 ,0 ,1 ,1 ,0 ,0 ,0 ,2 ,0 ,2 ,0 ,2,6105 , 0 
9001.596,9,5 ,16 ,813 ,0 ,0 ,1 ,1 ,0 ,0 ,0 ,2 ,0 ,6 ,0 ,6,10625 , 0 
9001.602,5,5 ,19 ,512 ,0 ,0 ,2 ,0 ,3 ,0 ,0 ,5 ,0 ,0 ,3 ,3,8904 , 0 
9001.606,19,5 ,1 ,256 ,0 ,0 ,1 ,0 ,3 ,0 ,0 ,4 ,0 ,6 ,3 ,9,5873 , 0 
9001.696,17,5 ,16 ,813 ,0 ,0 ,2 ,1 ,0 ,0 ,0 ,3 ,0 ,2 ,0 ,2,7747 , 0 
9001.771,13,5 ,1 ,256 ,0 ,0 ,1 ,0 ,0 ,0 ,0 ,1 ,0 ,1 ,0 ,1,5214 , 0 
9001.786,3,5 ,1 ,256 ,0 ,0 ,3 ,0 ,0 ,0 ,0 ,3 ,0 ,3 ,0 ,3,3901 , 0 
9120.96,8,5 ,1 ,256 ,0 ,0 ,1 ,0 ,1 ,0 ,0 ,2 ,0 ,2 ,1 ,3,4460 , 0 
9121.077,11,5 ,5 ,800 ,0 ,0 ,2 ,1 ,1 ,0 ,0 ,4 ,0 ,8 ,1 ,9,6164 , 0 
9121.124,2,5 ,1 ,256 ,0 ,0 ,25 ,0 ,55 ,1 ,1 ,82 ,102 ,29 ,57 ,188,7430 , 0 
9121.213,18,5 ,4 ,925 ,0 ,0 ,2 ,1 ,0 ,0 ,0 ,3 ,0 ,5 ,0 ,5,5603 , 0 
9121.235,4,5 ,8 ,512 ,0 ,0 ,2 ,0 ,1 ,0 ,0 ,3 ,0 ,3 ,1 ,4,5159 , 0 
9121.27,6,5 ,16 ,948 ,0 ,120 ,6 ,15 ,0 ,1 ,0 ,142 ,0 ,66 ,0 ,66,9552 , 1 
9121.289,7,5 ,16 ,948 ,0 ,0 ,0 ,15 ,0 ,0 ,0 ,15 ,0 ,42 ,0 ,42,10646 , 0 
9121.337,14,5 ,1 ,256 ,0 ,0 ,2 ,0 ,4 ,1 ,1 ,8 ,0 ,31 ,6 ,37,4542 , 0 
9121.35,15,5 ,11 ,1085 ,0 ,0 ,2 ,1 ,0 ,0 ,0 ,3 ,0 ,6 ,0 ,6,5430 , 0 
9121.359,20,5 ,5 ,800 ,0 ,0 ,2 ,1 ,0 ,0 ,0 ,3 ,0 ,5 ,0 ,5,5136 , 0 
9121.361,16,5 ,2 ,516 ,0 ,0 ,26 ,12 ,44 ,1 ,1 ,84 ,103 ,32 ,45 ,180,14075 , 0 
9121.444,10,5 ,14 ,512 ,0 ,0 ,25 ,0 ,6 ,1 ,1 ,33 ,110 ,5 ,7 ,122,5153 , 0 
9121.481,12,5 ,5 ,800 ,0 ,0 ,3 ,1 ,0 ,0 ,0 ,4 ,0 ,4 ,0 ,4,5741 , 0 
9121.596,9,5 ,5 ,800 ,0 ,0 ,6 ,6 ,0 ,1 ,0 ,13 ,0 ,23 ,0 ,23,11738 , 0 
9121.602,5,5 ,19 ,512 ,0 ,0 ,2 ,1 ,5 ,0 ,0 ,8 ,0 ,30 ,5 ,35,9090 , 0 
9121.606,19,5 ,1 ,256 ,0 ,0 ,3 ,0 ,6 ,0 ,0 ,9 ,0 ,20 ,6 ,26,5968 , 0 
9121.697,17,5 ,16 ,948 ,0 ,0 ,26 ,15 ,0 ,0 ,0 ,41 ,115 ,27 ,0 ,142,7315 , 0 
9121.771,13,5 ,1 ,256 ,0 ,0 ,3 ,0 ,0 ,0 ,0 ,3 ,0 ,14 ,0 ,14,5313 , 0 
9121.786,3,5 ,1 ,256 ,0 ,0 ,1 ,0 ,0 ,0 ,0 ,1 ,0 ,1 ,0 ,1,3508 , 0 
9240.96,8,5 ,1 ,256 ,0 ,0 ,0 ,0 ,0 ,0 ,0 ,0 ,0 ,0 ,0 ,0,4222 , 0 
9241.077,11,5 ,5 ,800 ,0 ,0 ,2 ,0 ,0 ,0 ,0 ,2 ,0 ,3 ,0 ,3,6760 , 0 
9241.146,6,5 ,16 ,868 ,0 ,120 ,0 ,17 ,0 ,0 ,0 ,137 ,0 ,83 ,0 ,83,9045 , 1 
9241.171,2,5 ,1 ,256 ,0 ,0 ,25 ,0 ,61 ,0 ,0 ,86 ,102 ,19 ,61 ,182,7104 , 0 
9241.213,18,5 ,4 ,925 ,0 ,0 ,2 ,0 ,0 ,0 ,0 ,2 ,0 ,0 ,0 ,0,6300 , 0 
9241.235,4,5 ,8 ,512 ,0 ,0 ,1 ,0 ,0 ,0 ,0 ,1 ,0 ,0 ,0 ,0,5472 , 0 
9241.289,7,5 ,16 ,868 ,0 ,0 ,3 ,14 ,0 ,0 ,0 ,17 ,0 ,46 ,0 ,46,10528 , 0 
9241.337,14,5 ,1 ,256 ,0 ,0 ,0 ,0 ,0 ,0 ,0 ,0 ,0 ,38 ,0 ,38,5227 , 0 
9241.35,15,5 ,11 ,1085 ,0 ,0 ,1 ,0 ,0 ,0 ,0 ,1 ,0 ,2 ,0 ,2,6657 , 0 
9241.359,20,5 ,5 ,800 ,0 ,0 ,1 ,0 ,0 ,0 ,0 ,1 ,0 ,1 ,0 ,1,5887 , 0 
9241.362,16,5 ,2 ,548 ,0 ,0 ,26 ,14 ,47 ,0 ,0 ,87 ,105 ,34 ,47 ,186,13729 , 0 
9241.444,10,5 ,14 ,512 ,0 ,0 ,25 ,0 ,0 ,0 ,0 ,25 ,102 ,0 ,0 ,102,5041 , 0 
9241.481,12,5 ,5 ,800 ,0 ,0 ,1 ,0 ,0 ,0 ,0 ,1 ,0 ,1 ,0 ,1,6169 , 0 
9241.596,9,5 ,5 ,800 ,0 ,0 ,2 ,0 ,0 ,0 ,0 ,2 ,0 ,24 ,0 ,24,10830 , 0 
9241.602,5,5 ,19 ,512 ,0 ,0 ,1 ,0 ,0 ,0 ,0 ,1 ,0 ,24 ,0 ,24,9029 , 0 
9241.606,19,5 ,1 ,256 ,0 ,0 ,0 ,0 ,0 ,0 ,0 ,0 ,0 ,26 ,0 ,26,5979 , 0 
9241.697,17,5 ,16 ,868 ,0 ,0 ,26 ,15 ,0 ,0 ,0 ,41 ,109 ,20 ,0 ,129,8150 , 0 
9241.771,13,5 ,1 ,256 ,0 ,0 ,1 ,0 ,0 ,0 ,0 ,1 ,0 ,22 ,0 ,22,5305 , 0 
9241.786,3,5 ,1 ,256 ,0 ,0 ,1 ,0 ,0 ,0 ,0 ,1 ,0 ,0 ,0 ,0,4002 , 0 
9360.96,8,5 ,1 ,256 ,0 ,0 ,2 ,0 ,0 ,0 ,0 ,2 ,0 ,1 ,0 ,1,4548 , 0 
9361.077,11,5 ,5 ,943 ,0 ,0 ,1 ,1 ,1 ,0 ,0 ,3 ,0 ,3 ,1 ,4,6331 , 0 
9361.124,2,5 ,1 ,256 ,0 ,0 ,26 ,0 ,64 ,0 ,0 ,90 ,107 ,23 ,64 ,194,7851 , 0 
9361.213,18,5 ,4 ,925 ,0 ,0 ,1 ,0 ,0 ,0 ,0 ,1 ,0 ,1 ,0 ,1,5695 , 0 
9361.235,4,5 ,8 ,512 ,0 ,0 ,0 ,0 ,0 ,0 ,0 ,0 ,0 ,0 ,0 ,0,5222 , 0 
9361.27,6,5 ,16 ,779 ,0 ,120 ,2 ,18 ,0 ,0 ,0 ,140 ,0 ,96 ,0 ,96,10511 , 1 
9361.289,7,5 ,16 ,779 ,0 ,0 ,1 ,15 ,0 ,0 ,0 ,16 ,0 ,41 ,0 ,41,10901 , 0 
9361.337,14,5 ,1 ,256 ,0 ,0 ,1 ,0 ,0 ,0 ,0 ,1 ,0 ,46 ,0 ,46,4639 , 0 
9361.35,15,5 ,11 ,1225 ,0 ,0 ,1 ,1 ,0 ,0 ,0 ,2 ,0 ,2 ,0 ,2,5530 , 0 
9361.359,20,5 ,5 ,800 ,0 ,0 ,0 ,0 ,0 ,0 ,0 ,0 ,0 ,0 ,0 ,0,5208 , 0 
9361.361,16,5 ,2 ,512 ,0 ,0 ,26 ,14 ,50 ,0 ,0 ,90 ,109 ,39 ,50 ,198,14961 , 0 
9361.444,10,5 ,14 ,512 ,0 ,0 ,25 ,0 ,0 ,0 ,0 ,25 ,107 ,0 ,0 ,107,5413 , 0 
9361.481,12,5 ,5 ,800 ,0 ,0 ,1 ,0 ,0 ,0 ,0 ,1 ,0 ,0 ,0 ,0,5822 , 0 
9361.596,9,5 ,5 ,800 ,0 ,0 ,1 ,0 ,0 ,0 ,0 ,1 ,0 ,24 ,0 ,24,11854 , 0 
9361.602,5,5 ,19 ,512 ,0 ,0 ,1 ,0 ,2 ,0 ,0 ,3 ,0 ,24 ,2 ,26,9240 , 0 
9361.606,19,5 ,1 ,256 ,0 ,0 ,1 ,0 ,2 ,0 ,0 ,3 ,0 ,26 ,2 ,28,6112 , 0 
9361.697,17,5 ,16 ,779 ,0 ,0 ,26 ,17 ,0 ,0 ,0 ,43 ,107 ,25 ,0 ,132,7708 , 0 
9361.771,13,5 ,1 ,256 ,0 ,0 ,1 ,0 ,0 ,0 ,0 ,1 ,0 ,26 ,0 ,26,5431 , 0 
9361.786,3,5 ,1 ,256 ,0 ,0 ,2 ,0 ,0 ,0 ,0 ,2 ,0 ,0 ,0 ,0,3567 , 0 
9480.96,8,5 ,1 ,256 ,0 ,0 ,1 ,0 ,0 ,0 ,0 ,1 ,0 ,1 ,0 ,1,4287 , 0 
9481.077,11,5 ,5 ,943 ,0 ,0 ,2 ,0 ,0 ,0 ,0 ,2 ,0 ,3 ,0 ,3,6837 , 0 
9481.123,2,5 ,1 ,256 ,0 ,0 ,6 ,0 ,20 ,0 ,0 ,26 ,1 ,6 ,20 ,27,7233 , 0 
9481.138,6,5 ,16 ,768 ,0 ,0 ,1 ,5 ,0 ,0 ,0 ,6 ,0 ,18 ,0 ,18,9145 , 0 
9481.213,18,5 ,4 ,925 ,0 ,0 ,1 ,0 ,0 ,0 ,0 ,1 ,0 ,2 ,0 ,2,6367 , 0 
9481.235,4,5 ,8 ,512 ,0 ,0 ,2 ,0 ,0 ,0 ,0 ,2 ,0 ,0 ,0 ,0,5544 , 0 
9481.289,7,5 ,16 ,768 ,0 ,0 ,2 ,6 ,0 ,0 ,0 ,8 ,0 ,11 ,0 ,11,10703 , 0 
9481.337,14,5 ,1 ,256 ,0 ,0 ,2 ,0 ,0 ,0 ,0 ,2 ,0 ,10 ,0 ,10,5291 , 0 
9481.35,15,5 ,11 ,1217 ,0 ,0 ,2 ,0 ,0 ,0 ,0 ,2 ,0 ,2 ,0 ,2,6738 , 0 
9481.359,20,5 ,5 ,800 ,0 ,0 ,3 ,0 ,0 ,0 ,0 ,3 ,0 ,1 ,0 ,1,6005 , 0 
9481.361,16,5 ,2 ,512 ,0 ,0 ,6 ,4 ,16 ,0 ,0 ,26 ,0 ,10 ,16 ,26,13987 , 0 
9481.443,10,5 ,14 ,512 ,0 ,0 ,6 ,0 ,0 ,0 ,0 ,6 ,0 ,2 ,0 ,2,5129 , 0 
9481.481,12,5 ,5 ,800 ,0 ,0 ,1 ,0 ,0 ,0 ,0 ,1 ,0 ,3 ,0 ,3,6256 , 0 
9481.596,9,5 ,5 ,800 ,0 ,0 ,2 ,0 ,0 ,0 ,0 ,2 ,0 ,9 ,0 ,9,10934 , 0 
9481.602,5,5 ,19 ,512 ,0 ,0 ,1 ,0 ,0 ,0 ,0 ,1 ,0 ,8 ,0 ,8,9129 , 0 
9481.606,19,5 ,1 ,256 ,0 ,0 ,1 ,0 ,0 ,0 ,0 ,1 ,0 ,6 ,0 ,6,6080 , 0 
9481.696,17,5 ,16 ,768 ,0 ,0 ,5 ,5 ,0 ,0 ,0 ,10 ,0 ,8 ,0 ,8,8287 , 0 
9481.771,13,5 ,1 ,256 ,0 ,0 ,1 ,0 ,0 ,0 ,0 ,1 ,0 ,4 ,0 ,4,5372 , 0 
9481.786,3,5 ,1 ,256 ,0 ,0 ,1 ,0 ,0 ,0 ,0 ,1 ,0 ,1 ,0 ,1,4059 , 0 
9600.96,8,5 ,1 ,256 ,0 ,0 ,1 ,0 ,2 ,0 ,0 ,3 ,0 ,2 ,2 ,4,4620 , 0 
9601.077,11,5 ,5 ,925 ,0 ,0 ,0 ,0 ,0 ,0 ,0 ,0 ,0 ,5 ,0 ,5,6388 , 0 
9601.123,2,5 ,1 ,256 ,0 ,0 ,3 ,0 ,3 ,0 ,0 ,6 ,0 ,1 ,3 ,4,7961 , 0 
9601.138,6,5 ,16 ,768 ,0 ,0 ,1 ,0 ,0 ,0 ,0 ,1 ,0 ,4 ,0 ,4,10585 , 0 
9601.213,18,5 ,4 ,881 ,0 ,0 ,2 ,1 ,0 ,0 ,0 ,3 ,0 ,3 ,0 ,3,5778 , 0 
9601.235,4,5 ,8 ,512 ,0 ,0 ,2 ,1 ,1 ,0 ,0 ,4 ,0 ,2 ,1 ,3,5323 , 0 
9601.289,7,5 ,16 ,768 ,0 ,0 ,1 ,1 ,0 ,0 ,0 ,2 ,0 ,3 ,0 ,3,10980 , 0 
9601.337,14,5 ,1 ,256 ,0 ,0 ,1 ,0 ,0 ,0 ,0 ,1 ,0 ,3 ,0 ,3,4713 , 0 
9601.35,15,5 ,11 ,1217 ,0 ,0 ,1 ,0 ,0 ,0 ,0 ,1 ,0 ,1 ,0 ,1,5597 , 0 
9601.359,20,5 ,5 ,800 ,0 ,0 ,1 ,0 ,0 ,0 ,0 ,1 ,0 ,1 ,0 ,1,5263 , 0 
9601.36,16,5 ,2 ,512 ,0 ,0 ,1 ,2 ,1 ,0 ,0 ,4 ,0 ,3 ,1 ,4,15080 , 0 
9601.443,10,5 ,14 ,512 ,0 ,0 ,1 ,0 ,0 ,0 ,0 ,1 ,0 ,0 ,0 ,0,5481 , 0 
9601.481,12,5 ,5 ,800 ,0 ,0 ,3 ,0 ,0 ,0 ,0 ,3 ,0 ,2 ,0 ,2,5904 , 0 
9601.596,9,5 ,5 ,800 ,0 ,0 ,2 ,0 ,0 ,0 ,0 ,2 ,0 ,1 ,0 ,1,11943 , 0 
9601.602,5,5 ,19 ,512 ,0 ,0 ,1 ,0 ,0 ,0 ,0 ,1 ,0 ,6 ,0 ,6,9308 , 0 
9601.606,19,5 ,1 ,256 ,0 ,0 ,1 ,0 ,0 ,0 ,0 ,1 ,0 ,4 ,0 ,4,6188 , 0 
9601.696,17,5 ,16 ,768 ,0 ,0 ,2 ,0 ,0 ,0 ,0 ,2 ,0 ,1 ,0 ,1,7782 , 0 
9601.771,13,5 ,1 ,256 ,0 ,0 ,1 ,0 ,0 ,0 ,0 ,1 ,0 ,2 ,0 ,2,5514 , 0 
9601.786,3,5 ,1 ,256 ,0 ,0 ,1 ,0 ,0 ,0 ,0 ,1 ,0 ,0 ,0 ,0,3622 , 0 
9720.96,8,5 ,1 ,256 ,0 ,0 ,2 ,0 ,1 ,0 ,0 ,3 ,0 ,1 ,1 ,2,4356 , 0 
9721.077,11,5 ,5 ,925 ,0 ,0 ,2 ,0 ,0 ,0 ,0 ,2 ,0 ,2 ,0 ,2,6913 , 0 
9721.123,2,5 ,1 ,256 ,0 ,0 ,1 ,0 ,4 ,0 ,0 ,5 ,0 ,3 ,4 ,7,7312 , 0 
9721.138,6,5 ,16 ,768 ,0 ,0 ,2 ,2 ,0 ,0 ,0 ,4 ,0 ,4 ,0 ,4,9234 , 0 
9721.213,18,5 ,4 ,840 ,0 ,0 ,2 ,1 ,0 ,0 ,0 ,3 ,0 ,1 ,0 ,1,6443 , 0 
9721.235,4,5 ,8 ,512 ,0 ,0 ,1 ,0 ,1 ,0 ,0 ,2 ,0 ,0 ,1 ,1,5605 , 0 
9721.289,7,5 ,16 ,768 ,0 ,0 ,1 ,1 ,0 ,0 ,0 ,2 ,0 ,4 ,0 ,4,10761 , 0 
9721.337,14,5 ,1 ,256 ,0 ,0 ,2 ,0 ,0 ,0 ,0 ,2 ,0 ,2 ,0 ,2,5374 , 0 
9721.35,15,5 ,11 ,1217 ,0 ,0 ,3 ,0 ,0 ,0 ,0 ,3 ,0 ,1 ,0 ,1,6817 , 0 
9721.359,20,5 ,5 ,925 ,0 ,0 ,1 ,1 ,0 ,0 ,0 ,2 ,0 ,2 ,0 ,2,6077 , 0 
9721.36,16,5 ,2 ,512 ,0 ,0 ,3 ,0 ,4 ,0 ,0 ,7 ,0 ,0 ,4 ,4,14089 , 0 
9721.443,10,5 ,14 ,512 ,0 ,0 ,2 ,0 ,0 ,0 ,0 ,2 ,0 ,1 ,0 ,1,5186 , 0 
9721.481,12,5 ,5 ,800 ,0 ,0 ,1 ,0 ,0 ,0 ,0 ,1 ,0 ,2 ,0 ,2,6328 , 0 
9721.596,9,5 ,5 ,800 ,0 ,0 ,1 ,0 ,0 ,0 ,0 ,1 ,0 ,4 ,0 ,4,11008 , 0 
9721.602,5,5 ,19 ,512 ,0 ,0 ,1 ,0 ,1 ,0 ,0 ,2 ,0 ,3 ,1 ,4,9255 , 0 
9721.606,19,5 ,1 ,256 ,0 ,0 ,1 ,0 ,1 ,0 ,0 ,2 ,0 ,2 ,1 ,3,6151 , 0 
9721.696,17,5 ,16 ,768 ,0 ,0 ,2 ,1 ,0 ,0 ,0 ,3 ,0 ,1 ,0 ,1,8368 , 0 
9721.771,13,5 ,1 ,256 ,0 ,0 ,1 ,0 ,0 ,0 ,0 ,1 ,0 ,2 ,0 ,2,5447 , 0 
9721.786,3,5 ,1 ,256 ,0 ,0 ,2 ,0 ,0 ,0 ,0 ,2 ,0 ,1 ,0 ,1,4134 , 0 
9840.96,8,5 ,1 ,256 ,0 ,0 ,1 ,0 ,0 ,0 ,0 ,1 ,0 ,0 ,0 ,0,4681 , 0 
9841.078,11,5 ,5 ,925 ,0 ,0 ,1 ,0 ,0 ,0 ,0 ,1 ,0 ,10 ,0 ,10,6471 , 0 
9841.123,2,5 ,1 ,256 ,0 ,0 ,7 ,0 ,12 ,0 ,3 ,22 ,0 ,9 ,15 ,24,8112 , 0 
9841.138,6,5 ,2 ,512 ,0 ,0 ,7 ,4 ,4 ,1 ,0 ,16 ,0 ,20 ,5 ,25,10783 , 0 
9841.213,18,5 ,4 ,840 ,0 ,0 ,1 ,0 ,0 ,0 ,0 ,1 ,0 ,1 ,0 ,1,5875 , 0 
9841.235,4,5 ,8 ,512 ,0 ,0 ,1 ,0 ,0 ,0 ,0 ,1 ,0 ,2 ,0 ,2,5393 , 0 
9841.289,7,5 ,9 ,1097 ,0 ,0 ,8 ,6 ,0 ,2 ,0 ,16 ,0 ,21 ,0 ,21,11178 , 0 
9841.337,14,5 ,1 ,256 ,0 ,0 ,0 ,0 ,0 ,0 ,0 ,0 ,0 ,9 ,0 ,9,4782 , 0 
9841.35,15,5 ,11 ,1217 ,0 ,0 ,5 ,0 ,0 ,0 ,0 ,5 ,0 ,12 ,0 ,12,5692 , 0 
9841.359,20,5 ,5 ,925 ,0 ,0 ,0 ,0 ,0 ,0 ,0 ,0 ,0 ,1 ,0 ,1,5335 , 0 
9841.36,16,5 ,2 ,512 ,0 ,0 ,4 ,4 ,0 ,0 ,3 ,11 ,0 ,28 ,3 ,31,15230 , 1 
9841.443,10,5 ,14 ,512 ,0 ,0 ,3 ,0 ,0 ,0 ,0 ,3 ,0 ,4 ,0 ,4,5556 , 0 
9841.481,12,5 ,5 ,800 ,0 ,0 ,1 ,0 ,0 ,0 ,0 ,1 ,0 ,0 ,0 ,0,5985 , 0 
9841.596,9,5 ,5 ,800 ,0 ,0 ,7 ,0 ,5 ,0 ,0 ,12 ,0 ,13 ,5 ,18,12120 , 0 
9841.602,5,5 ,19 ,512 ,0 ,0 ,1 ,0 ,5 ,0 ,0 ,6 ,0 ,11 ,5 ,16,9451 , 0 
9841.606,19,5 ,1 ,256 ,0 ,0 ,1 ,0 ,5 ,0 ,0 ,6 ,0 ,6 ,5 ,11,6291 , 0 
9841.696,17,5 ,6 ,1010 ,0 ,0 ,7 ,4 ,0 ,1 ,1 ,13 ,0 ,15 ,2 ,17,7936 , 0 
9841.771,13,5 ,1 ,256 ,0 ,0 ,0 ,0 ,0 ,0 ,0 ,0 ,0 ,5 ,0 ,5,5578 , 0 
9841.786,3,5 ,1 ,256 ,0 ,0 ,1 ,0 ,0 ,0 ,0 ,1 ,0 ,0 ,0 ,0,3683 , 0 
9960.96,8,5 ,1 ,256 ,0 ,0 ,1 ,0 ,0 ,0 ,0 ,1 ,0 ,1 ,0 ,1,4420 , 0 
9961.078,11,5 ,5 ,813 ,0 ,0 ,1 ,0 ,1 ,0 ,0 ,2 ,0 ,10 ,1 ,11,6997 , 0 
9961.123,2,5 ,1 ,256 ,0 ,0 ,6 ,0 ,13 ,1 ,0 ,20 ,0 ,6 ,16 ,22,7477 , 0 
9961.138,6,5 ,2 ,512 ,0 ,0 ,6 ,5 ,3 ,0 ,0 ,14 ,0 ,15 ,4 ,19,9446 , 0 
9961.213,18,5 ,4 ,840 ,0 ,0 ,0 ,0 ,0 ,0 ,0 ,0 ,0 ,0 ,0 ,0,6503 , 0 
9961.235,4,5 ,8 ,512 ,0 ,0 ,1 ,0 ,0 ,0 ,0 ,1 ,0 ,0 ,0 ,0,5681 , 0 
9961.289,7,5 ,9 ,1110 ,0 ,0 ,11 ,3 ,0 ,0 ,0 ,14 ,0 ,17 ,0 ,17,10909 , 0 
9961.337,14,5 ,1 ,256 ,0 ,0 ,1 ,0 ,0 ,0 ,0 ,1 ,0 ,4 ,0 ,4,5434 , 0 
9961.35,15,5 ,11 ,1195 ,0 ,0 ,3 ,1 ,0 ,0 ,0 ,4 ,0 ,14 ,0 ,14,6930 , 0 
9961.359,20,5 ,5 ,925 ,0 ,0 ,2 ,0 ,0 ,0 ,0 ,2 ,0 ,0 ,0 ,0,6174 , 0 
9961.36,16,5 ,2 ,512 ,0 ,0 ,4 ,5 ,0 ,3 ,0 ,12 ,0 ,30 ,0 ,30,14256 , 1 
9961.443,10,5 ,14 ,512 ,0 ,0 ,1 ,0 ,0 ,0 ,0 ,1 ,0 ,6 ,0 ,6,5256 , 0 
9961.481,12,5 ,5 ,800 ,0 ,0 ,0 ,0 ,0 ,0 ,0 ,0 ,0 ,0 ,0 ,0,6391 , 0 
9961.596,9,5 ,5 ,800 ,0 ,0 ,7 ,0 ,3 ,0 ,0 ,10 ,0 ,11 ,3 ,14,11173 , 0 
9961.602,5,5 ,19 ,512 ,0 ,0 ,2 ,0 ,4 ,0 ,0 ,6 ,0 ,10 ,4 ,14,9370 , 0 
9961.606,19,5 ,1 ,256 ,0 ,0 ,1 ,0 ,4 ,0 ,0 ,5 ,0 ,6 ,4 ,10,6238 , 0 
9961.696,17,5 ,6 ,907 ,0 ,0 ,9 ,3 ,0 ,1 ,0 ,13 ,0 ,14 ,0 ,14,8523 , 0 
9961.771,13,5 ,1 ,256 ,0 ,0 ,1 ,0 ,0 ,0 ,0 ,1 ,0 ,6 ,0 ,6,5533 , 0 
9961.786,3,5 ,1 ,256 ,0 ,0 ,0 ,0 ,0 ,0 ,0 ,0 ,0 ,1 ,0 ,1,4184 , 0 
10080.96,8,5 ,1 ,256 ,0 ,0 ,2 ,0 ,0 ,0 ,0 ,2 ,0 ,1 ,0 ,1,4746 , 0 
10081.077,11,5 ,5 ,813 ,0 ,0 ,1 ,0 ,0 ,0 ,0 ,1 ,0 ,5 ,0 ,5,6574 , 0 
10081.123,2,5 ,1 ,256 ,0 ,0 ,5 ,0 ,12 ,0 ,0 ,17 ,0 ,6 ,12 ,18,8226 , 0 
10081.138,6,5 ,2 ,512 ,0 ,0 ,6 ,4 ,5 ,0 ,0 ,15 ,0 ,9 ,5 ,14,10967 , 0 
10081.213,18,5 ,4 ,840 ,0 ,0 ,1 ,0 ,0 ,0 ,0 ,1 ,0 ,1 ,0 ,1,5956 , 0 
10081.235,4,5 ,8 ,512 ,0 ,0 ,0 ,0 ,0 ,0 ,0 ,0 ,0 ,1 ,0 ,1,5445 , 0 
10081.289,7,5 ,9 ,1083 ,0 ,0 ,4 ,4 ,0 ,0 ,0 ,8 ,0 ,11 ,0 ,11,11293 , 0 
10081.337,14,5 ,1 ,256 ,0 ,0 ,1 ,0 ,0 ,0 ,0 ,1 ,0 ,6 ,0 ,6,4867 , 0 
10081.35,15,5 ,11 ,1195 ,0 ,0 ,2 ,0 ,0 ,0 ,0 ,2 ,0 ,8 ,0 ,8,5762 , 0 
10081.359,20,5 ,5 ,804 ,0 ,0 ,0 ,0 ,0 ,0 ,0 ,0 ,0 ,2 ,0 ,2,5413 , 0 
10081.36,16,5 ,2 ,512 ,0 ,0 ,1 ,3 ,0 ,0 ,0 ,4 ,0 ,22 ,0 ,22,15334 , 1 
10081.443,10,5 ,14 ,512 ,0 ,0 ,1 ,0 ,0 ,0 ,0 ,1 ,0 ,5 ,0 ,5,5620 , 0 
10081.481,12,5 ,5 ,800 ,0 ,0 ,1 ,0 ,0 ,0 ,0 ,1 ,0 ,0 ,0 ,0,6071 , 0 
10081.596,9,5 ,5 ,800 ,0 ,0 ,5 ,0 ,4 ,0 ,0 ,9 ,0 ,7 ,4 ,11,12274 , 0 
10081.602,5,5 ,19 ,512 ,0 ,0 ,1 ,0 ,4 ,0 ,0 ,5 ,0 ,8 ,4 ,12,9606 , 0 
10081.606,19,5 ,1 ,256 ,0 ,0 ,1 ,0 ,4 ,0 ,0 ,5 ,0 ,5 ,4 ,9,6368 , 0 
10081.696,17,5 ,6 ,847 ,0 ,0 ,6 ,5 ,0 ,0 ,0 ,11 ,0 ,10 ,0 ,10,8061 , 0 
10081.771,13,5 ,1 ,256 ,0 ,0 ,1 ,0 ,0 ,0 ,0 ,1 ,0 ,4 ,0 ,4,5668 , 0 
10081.786,3,5 ,1 ,256 ,0 ,0 ,1 ,0 ,0 ,0 ,0 ,1 ,0 ,2 ,0 ,2,3778 , 0 
10200.96,8,5 ,1 ,256 ,0 ,0 ,1 ,0 ,0 ,0 ,0 ,1 ,0 ,1 ,0 ,1,4488 , 0 
10201.077,11,5 ,5 ,813 ,0 ,0 ,1 ,0 ,0 ,0 ,0 ,1 ,0 ,5 ,0 ,5,7070 , 0 
10201.123,2,5 ,1 ,256 ,0 ,0 ,3 ,0 ,6 ,0 ,0 ,9 ,0 ,4 ,6 ,10,7589 , 0 
10201.138,6,5 ,2 ,512 ,0 ,0 ,3 ,2 ,2 ,0 ,0 ,7 ,0 ,5 ,2 ,7,9554 , 0 
10201.213,18,5 ,4 ,819 ,0 ,0 ,1 ,0 ,0 ,0 ,0 ,1 ,0 ,1 ,0 ,1,6577 , 0 
10201.235,4,5 ,8 ,512 ,0 ,0 ,1 ,0 ,0 ,0 ,0 ,1 ,0 ,0 ,0 ,0,5751 , 0 
10201.289,7,5 ,16 ,768 ,0 ,0 ,6 ,2 ,0 ,1 ,0 ,9 ,0 ,8 ,0 ,8,11038 , 0 
10201.337,14,5 ,1 ,256 ,0 ,0 ,1 ,0 ,0 ,0 ,0 ,1 ,0 ,2 ,0 ,2,5518 , 0 
10201.35,15,5 ,11 ,1195 ,0 ,0 ,3 ,0 ,0 ,0 ,0 ,3 ,0 ,8 ,0 ,8,7010 , 0 
10201.359,20,5 ,5 ,804 ,0 ,0 ,2 ,0 ,0 ,0 ,0 ,2 ,0 ,0 ,0 ,0,6245 , 0 
10201.36,16,5 ,2 ,512 ,0 ,0 ,1 ,1 ,1 ,0 ,0 ,3 ,0 ,11 ,1 ,12,14342 , 0 
10201.443,10,5 ,14 ,512 ,0 ,0 ,1 ,0 ,0 ,0 ,0 ,1 ,0 ,3 ,0 ,3,5314 , 0 
10201.481,12,5 ,5 ,800 ,0 ,0 ,1 ,0 ,0 ,0 ,0 ,1 ,0 ,1 ,0 ,1,6481 , 0 
10201.596,9,5 ,5 ,800 ,0 ,0 ,3 ,0 ,1 ,1 ,1 ,6 ,0 ,6 ,2 ,8,11280 , 0 
10201.602,5,5 ,19 ,512 ,0 ,0 ,1 ,0 ,1 ,1 ,1 ,4 ,0 ,5 ,3 ,8,9493 , 0 
10201.606,19,5 ,1 ,256 ,0 ,0 ,1 ,0 ,1 ,1 ,1 ,4 ,0 ,4 ,3 ,7,6344 , 0 
10201.696,17,5 ,6 ,808 ,0 ,0 ,3 ,2 ,0 ,0 ,0 ,5 ,0 ,7 ,0 ,7,8613 , 0 
10201.771,13,5 ,1 ,256 ,0 ,0 ,1 ,0 ,0 ,0 ,0 ,1 ,0 ,4 ,0 ,4,5605 , 0 
10201.786,3,5 ,1 ,256 ,0 ,0 ,1 ,0 ,0 ,0 ,0 ,1 ,0 ,0 ,0 ,0,4242 , 0 
10320.96,8,5 ,1 ,256 ,0 ,0 ,1 ,0 ,2 ,0 ,0 ,3 ,0 ,1 ,2 ,3,4814 , 0 
10321.077,11,5 ,5 ,798 ,0 ,0 ,1 ,0 ,0 ,0 ,0 ,1 ,0 ,3 ,0 ,3,6643 , 0 
10321.123,2,5 ,1 ,256 ,0 ,0 ,2 ,0 ,5 ,0 ,0 ,7 ,0 ,3 ,5 ,8,8312 , 0 
10321.138,6,5 ,2 ,512 ,0 ,0 ,2 ,1 ,2 ,0 ,0 ,5 ,0 ,5 ,2 ,7,11047 , 0 
10321.213,18,5 ,4 ,804 ,0 ,0 ,2 ,1 ,0 ,0 ,0 ,3 ,0 ,1 ,0 ,1,6031 , 0 
10321.235,4,5 ,8 ,512 ,0 ,0 ,1 ,1 ,1 ,0 ,0 ,3 ,0 ,2 ,1 ,3,5547 , 0 
10321.289,7,5 ,16 ,768 ,0 ,0 ,3 ,1 ,0 ,0 ,0 ,4 ,0 ,4 ,0 ,4,11367 , 0 
10321.337,14,5 ,1 ,256 ,0 ,0 ,2 ,0 ,0 ,0 ,0 ,2 ,0 ,4 ,0 ,4,4937 , 0 
10321.35,15,5 ,11 ,1129 ,0 ,0 ,1 ,0 ,0 ,0 ,0 ,1 ,0 ,4 ,0 ,4,5862 , 0 
10321.359,20,5 ,5 ,804 ,0 ,0 ,1 ,0 ,0 ,0 ,0 ,1 ,0 ,1 ,0 ,1,5503 , 0 
10321.36,16,5 ,2 ,512 ,0 ,0 ,2 ,1 ,1 ,0 ,0 ,4 ,0 ,5 ,1 ,6,15427 , 0 
10321.443,10,5 ,14 ,512 ,0 ,0 ,2 ,0 ,0 ,0 ,0 ,2 ,0 ,1 ,0 ,1,5683 , 0 
10321.481,12,5 ,5 ,800 ,0 ,0 ,1 ,0 ,0 ,0 ,0 ,1 ,0 ,1 ,0 ,1,6159 , 0 
10321.596,9,5 ,5 ,800 ,0 ,0 ,1 ,0 ,0 ,0 ,0 ,1 ,0 ,4 ,0 ,4,12353 , 0 
10321.602,5,5 ,19 ,512 ,0 ,0 ,1 ,0 ,0 ,0 ,0 ,1 ,0 ,4 ,0 ,4,9697 , 0 
10321.606,19,5 ,1 ,256 ,0 ,0 ,2 ,0 ,0 ,0 ,0 ,2 ,0 ,1 ,0 ,1,6452 , 0 
10321.696,17,5 ,6 ,793 ,0 ,0 ,2 ,2 ,0 ,0 ,0 ,4 ,0 ,5 ,0 ,5,8151 , 0 
10321.771,13,5 ,1 ,256 ,0 ,0 ,1 ,0 ,0 ,0 ,0 ,1 ,0 ,1 ,0 ,1,5741 , 0 
10321.786,3,5 ,1 ,256 ,0 ,0 ,1 ,0 ,0 ,0 ,0 ,1 ,0 ,1 ,0 ,1,3832 , 0 
10440.96,8,5 ,1 ,256 ,0 ,0 ,2 ,0 ,0 ,0 ,0 ,2 ,0 ,0 ,0 ,0,4560 , 0 
10441.077,11,5 ,5 ,798 ,0 ,0 ,1 ,0 ,0 ,0 ,0 ,1 ,0 ,2 ,0 ,2,7133 , 0 
10441.123,2,5 ,1 ,256 ,0 ,0 ,1 ,0 ,0 ,0 ,0 ,1 ,0 ,1 ,0 ,1,7660 , 0 
10441.138,6,5 ,2 ,512 ,0 ,0 ,1 ,0 ,0 ,0 ,0 ,1 ,0 ,2 ,0 ,2,9653 , 0 
10441.213,18,5 ,4 ,804 ,0 ,0 ,1 ,0 ,0 ,0 ,0 ,1 ,0 ,1 ,0 ,1,6651 , 0 
10441.235,4,5 ,8 ,512 ,0 ,0 ,1 ,0 ,0 ,0 ,0 ,1 ,0 ,1 ,0 ,1,5808 , 0 
10441.289,7,5 ,16 ,768 ,0 ,0 ,1 ,0 ,0 ,0 ,0 ,1 ,0 ,1 ,0 ,1,11108 , 0 
10441.337,14,5 ,1 ,256 ,0 ,0 ,1 ,0 ,0 ,0 ,0 ,1 ,0 ,2 ,0 ,2,5590 , 0 
10441.35,15,5 ,11 ,1129 ,0 ,0 ,0 ,0 ,0 ,0 ,0 ,0 ,0 ,1 ,0 ,1,7062 , 0 
10441.359,20,5 ,5 ,804 ,0 ,0 ,2 ,0 ,0 ,0 ,0 ,2 ,0 ,1 ,0 ,1,6331 , 0 
10441.36,16,5 ,2 ,512 ,0 ,0 ,1 ,0 ,0 ,0 ,0 ,1 ,0 ,1 ,0 ,1,14411 , 0 
10441.443,10,5 ,14 ,512 ,0 ,0 ,2 ,0 ,0 ,0 ,0 ,2 ,0 ,1 ,0 ,1,5392 , 0 
10441.481,12,5 ,5 ,800 ,0 ,0 ,1 ,0 ,0 ,0 ,0 ,1 ,0 ,1 ,0 ,1,6540 , 0 
10441.596,9,5 ,5 ,800 ,0 ,0 ,1 ,0 ,0 ,0 ,0 ,1 ,0 ,1 ,0 ,1,11358 , 0 
10441.602,5,5 ,19 ,512 ,0 ,0 ,1 ,0 ,0 ,0 ,0 ,1 ,0 ,1 ,0 ,1,9598 , 0 
10441.606,19,5 ,1 ,256 ,0 ,0 ,1 ,0 ,0 ,0 ,0 ,1 ,0 ,3 ,0 ,3,6425 , 0 
10441.696,17,5 ,6 ,793 ,0 ,0 ,1 ,0 ,0 ,0 ,0 ,1 ,0 ,1 ,0 ,1,8683 , 0 
10441.771,13,5 ,1 ,256 ,0 ,0 ,1 ,0 ,0 ,0 ,0 ,1 ,0 ,1 ,0 ,1,5701 , 0 
10441.786,3,5 ,1 ,256 ,0 ,0 ,2 ,0 ,0 ,0 ,0 ,2 ,0 ,1 ,0 ,1,4319 , 0 
10560.96,8,5 ,1 ,256 ,0 ,0 ,1 ,0 ,0 ,0 ,1 ,2 ,0 ,1 ,1 ,2,4877 , 0 
10561.077,11,5 ,5 ,798 ,0 ,0 ,1 ,0 ,0 ,0 ,0 ,1 ,0 ,2 ,0 ,2,6709 , 0 
10561.123,2,5 ,1 ,256 ,0 ,0 ,2 ,0 ,3 ,0 ,0 ,5 ,0 ,3 ,3 ,6,8410 , 0 
10561.138,6,5 ,2 ,512 ,0 ,0 ,2 ,1 ,1 ,0 ,0 ,4 ,0 ,3 ,1 ,4,11120 , 0 
10561.213,18,5 ,19 ,523 ,0 ,0 ,3 ,1 ,0 ,1 ,0 ,5 ,0 ,2 ,0 ,2,6129 , 0 
10561.235,4,5 ,8 ,512 ,0 ,0 ,1 ,0 ,0 ,0 ,1 ,2 ,0 ,2 ,1 ,3,5629 , 0 
10561.289,7,5 ,16 ,768 ,0 ,0 ,2 ,0 ,0 ,0 ,0 ,2 ,0 ,4 ,0 ,4,11437 , 0 
10561.337,14,5 ,1 ,256 ,0 ,0 ,2 ,0 ,0 ,0 ,0 ,2 ,0 ,1 ,0 ,1,5017 , 0 
10561.35,15,5 ,11 ,1129 ,0 ,0 ,1 ,0 ,0 ,0 ,0 ,1 ,0 ,2 ,0 ,2,5921 , 0 
10561.359,20,5 ,5 ,804 ,0 ,0 ,1 ,0 ,0 ,0 ,0 ,1 ,0 ,0 ,0 ,0,5557 , 0 
10561.36,16,5 ,2 ,512 ,0 ,0 ,1 ,1 ,0 ,0 ,0 ,2 ,0 ,6 ,0 ,6,15512 , 1 
10561.443,10,5 ,14 ,512 ,0 ,0 ,1 ,0 ,0 ,0 ,0 ,1 ,0 ,1 ,0 ,1,5741 , 0 
10561.481,12,5 ,5 ,800 ,0 ,0 ,2 ,0 ,0 ,0 ,0 ,2 ,0 ,4 ,0 ,4,6243 , 0 
10561.596,9,5 ,5 ,800 ,0 ,0 ,2 ,0 ,0 ,0 ,0 ,2 ,0 ,2 ,0 ,2,12426 , 0 
10561.602,5,5 ,19 ,512 ,0 ,0 ,0 ,0 ,0 ,0 ,0 ,0 ,0 ,5 ,0 ,5,9774 , 0 
10561.606,19,5 ,1 ,256 ,0 ,0 ,1 ,0 ,1 ,0 ,0 ,2 ,0 ,5 ,1 ,6,6536 , 0 
10561.696,17,5 ,6 ,781 ,0 ,0 ,2 ,1 ,0 ,0 ,0 ,3 ,0 ,4 ,0 ,4,8221 , 0 
10561.771,13,5 ,1 ,256 ,0 ,0 ,1 ,0 ,0 ,0 ,0 ,1 ,0 ,2 ,0 ,2,5807 , 0 
10561.786,3,5 ,1 ,256 ,0 ,0 ,1 ,0 ,0 ,0 ,0 ,1 ,0 ,0 ,0 ,0,3887 , 0 
10680.96,8,5 ,1 ,256 ,0 ,0 ,1 ,0 ,0 ,1 ,0 ,2 ,0 ,2 ,1 ,3,4630 , 0 
10681.077,11,5 ,5 ,798 ,0 ,0 ,2 ,0 ,0 ,0 ,0 ,2 ,0 ,3 ,0 ,3,7212 , 0 
10681.123,2,5 ,1 ,256 ,0 ,0 ,1 ,0 ,0 ,0 ,0 ,1 ,0 ,0 ,0 ,0,7744 , 0 
10681.138,6,5 ,2 ,512 ,0 ,0 ,1 ,0 ,0 ,0 ,0 ,1 ,0 ,0 ,0 ,0,9722 , 0 
10681.213,18,5 ,19 ,523 ,0 ,0 ,4 ,0 ,0 ,0 ,0 ,4 ,0 ,3 ,0 ,3,6734 , 0 
10681.235,4,5 ,8 ,512 ,0 ,0 ,3 ,0 ,0 ,1 ,0 ,4 ,0 ,3 ,0 ,3,5891 , 0 
10681.289,7,5 ,16 ,768 ,0 ,0 ,1 ,0 ,0 ,0 ,0 ,1 ,0 ,1 ,0 ,1,11171 , 0 
10681.337,14,5 ,1 ,256 ,0 ,0 ,0 ,0 ,0 ,0 ,0 ,0 ,0 ,1 ,0 ,1,5651 , 0 
10681.35,15,5 ,11 ,1129 ,0 ,0 ,2 ,0 ,0 ,0 ,0 ,2 ,0 ,1 ,0 ,1,7151 , 0 
10681.359,20,5 ,5 ,804 ,0 ,0 ,1 ,0 ,0 ,0 ,0 ,1 ,0 ,2 ,0 ,2,6387 , 0 
10681.36,16,5 ,2 ,512 ,0 ,0 ,1 ,0 ,0 ,0 ,0 ,1 ,0 ,1 ,0 ,1,14484 , 1 
10681.443,10,5 ,14 ,512 ,0 ,0 ,1 ,0 ,0 ,0 ,0 ,1 ,0 ,0 ,0 ,0,5449 , 0 
10681.481,12,5 ,5 ,800 ,0 ,0 ,2 ,0 ,0 ,0 ,0 ,2 ,0 ,4 ,0 ,4,6613 , 0 
10681.596,9,5 ,5 ,800 ,0 ,0 ,1 ,0 ,0 ,0 ,0 ,1 ,0 ,2 ,0 ,2,11453 , 0 
10681.602,5,5 ,19 ,512 ,0 ,0 ,1 ,0 ,0 ,0 ,0 ,1 ,0 ,6 ,0 ,6,9704 , 0 
10681.606,19,5 ,1 ,256 ,0 ,0 ,1 ,0 ,0 ,0 ,0 ,1 ,0 ,6 ,0 ,6,6514 , 0 
10681.696,17,5 ,6 ,781 ,0 ,0 ,0 ,0 ,0 ,0 ,0 ,0 ,0 ,1 ,0 ,1,8754 , 0 
10681.771,13,5 ,1 ,256 ,0 ,0 ,1 ,0 ,0 ,0 ,0 ,1 ,0 ,2 ,0 ,2,5777 , 0 
10681.786,3,5 ,1 ,256 ,0 ,0 ,0 ,0 ,0 ,0 ,0 ,0 ,0 ,1 ,0 ,1,4370 , 0 
10800.96,8,5 ,1 ,256 ,0 ,0 ,2 ,0 ,0 ,0 ,0 ,2 ,0 ,1 ,0 ,1,4957 , 0 
10801.077,11,5 ,5 ,798 ,0 ,0 ,1 ,0 ,0 ,0 ,0 ,1 ,0 ,2 ,0 ,2,6767 , 0 
10801.123,2,5 ,1 ,256 ,0 ,0 ,2 ,0 ,1 ,0 ,0 ,3 ,0 ,2 ,1 ,3,8488 , 0 
10801.138,6,5 ,2 ,512 ,0 ,0 ,1 ,1 ,0 ,0 ,0 ,2 ,0 ,1 ,0 ,1,11207 , 0 
10801.214,18,5 ,19 ,523 ,0 ,0 ,2 ,0 ,0 ,0 ,0 ,2 ,0 ,1 ,0 ,1,6198 , 0 
10801.235,4,5 ,8 ,512 ,0 ,0 ,1 ,0 ,0 ,0 ,0 ,1 ,0 ,2 ,0 ,2,5684 , 0 
10801.289,7,5 ,16 ,768 ,0 ,0 ,1 ,0 ,0 ,0 ,0 ,1 ,0 ,2 ,0 ,2,11526 , 0 
10801.337,14,5 ,1 ,256 ,0 ,0 ,2 ,0 ,0 ,0 ,0 ,2 ,0 ,2 ,0 ,2,5094 , 0 
10801.35,15,5 ,11 ,1129 ,0 ,0 ,1 ,0 ,0 ,0 ,0 ,1 ,0 ,1 ,0 ,1,6013 , 0 
10801.359,20,5 ,5 ,804 ,0 ,0 ,0 ,0 ,0 ,0 ,0 ,0 ,0 ,0 ,0 ,0,5636 , 0 
10801.36,16,5 ,2 ,512 ,0 ,0 ,0 ,0 ,0 ,0 ,0 ,0 ,0 ,1 ,0 ,1,15574 , 1 
10801.443,10,5 ,14 ,512 ,0 ,0 ,0 ,0 ,0 ,0 ,0 ,0 ,0 ,2 ,0 ,2,5805 , 0 
10801.481,12,5 ,5 ,800 ,0 ,0 ,1 ,0 ,0 ,0 ,0 ,1 ,0 ,2 ,0 ,2,6299 , 0 
10801.596,9,5 ,5 ,800 ,0 ,0 ,2 ,0 ,0 ,0 ,0 ,2 ,0 ,0 ,0 ,0,12507 , 0 
10801.602,5,5 ,19 ,512 ,0 ,0 ,1 ,0 ,0 ,0 ,0 ,1 ,0 ,3 ,0 ,3,9867 , 0 
10801.606,19,5 ,1 ,256 ,0 ,0 ,0 ,0 ,0 ,0 ,0 ,0 ,0 ,2 ,0 ,2,6609 , 0 
10801.696,17,5 ,6 ,781 ,0 ,0 ,1 ,0 ,0 ,0 ,0 ,1 ,0 ,0 ,0 ,0,8288 , 0 
10801.771,13,5 ,1 ,256 ,0 ,0 ,1 ,0 ,0 ,0 ,0 ,1 ,0 ,1 ,0 ,1,5880 , 0 
10801.786,3,5 ,1 ,256 ,0 ,0 ,2 ,0 ,0 ,0 ,0 ,2 ,0 ,2 ,0 ,2,3972 , 0 
10920.96,8,5 ,1 ,256 ,0 ,0 ,1 ,0 ,0 ,0 ,0 ,1 ,0 ,1 ,0 ,1,4696 , 0 
10921.077,11,5 ,5 ,798 ,0 ,0 ,0 ,0 ,0 ,0 ,0 ,0 ,0 ,2 ,0 ,2,7271 , 0 
10921.123,2,5 ,1 ,256 ,0 ,0 ,1 ,0 ,2 ,0 ,0 ,3 ,0 ,3 ,2 ,5,7859 , 0 
10921.138,6,5 ,2 ,512 ,0 ,0 ,2 ,0 ,1 ,0 ,0 ,3 ,0 ,3 ,1 ,4,9805 , 0 
10921.213,18,5 ,19 ,523 ,0 ,0 ,1 ,0 ,0 ,0 ,0 ,1 ,0 ,1 ,0 ,1,6800 , 0 
10921.235,4,5 ,8 ,512 ,0 ,0 ,2 ,0 ,0 ,0 ,0 ,2 ,0 ,1 ,0 ,1,5972 , 0 
10921.289,7,5 ,16 ,768 ,0 ,0 ,0 ,1 ,0 ,0 ,0 ,1 ,0 ,3 ,0 ,3,11233 , 0 
10921.337,14,5 ,1 ,256 ,0 ,0 ,1 ,0 ,0 ,0 ,0 ,1 ,0 ,1 ,0 ,1,5730 , 0 
10921.35,15,5 ,11 ,1129 ,0 ,0 ,1 ,0 ,0 ,0 ,0 ,1 ,0 ,1 ,0 ,1,7223 , 0 
10921.359,20,5 ,5 ,804 ,0 ,0 ,1 ,0 ,0 ,0 ,0 ,1 ,0 ,0 ,0 ,0,6450 , 0 
10921.36,16,5 ,2 ,512 ,0 ,0 ,3 ,0 ,1 ,0 ,0 ,4 ,0 ,4 ,1 ,5,14602 , 0 
10921.443,10,5 ,14 ,512 ,0 ,0 ,1 ,0 ,0 ,0 ,0 ,1 ,0 ,1 ,0 ,1,5526 , 0 
10921.481,12,5 ,5 ,800 ,0 ,0 ,0 ,0 ,0 ,0 ,0 ,0 ,0 ,1 ,0 ,1,6680 , 0 
10921.596,9,5 ,5 ,800 ,0 ,0 ,2 ,0 ,0 ,0 ,0 ,2 ,0 ,1 ,0 ,1,11529 , 0 
10921.602,5,5 ,19 ,512 ,0 ,0 ,1 ,0 ,0 ,0 ,0 ,1 ,0 ,2 ,0 ,2,9776 , 0 
10921.606,19,5 ,1 ,256 ,0 ,0 ,2 ,0 ,0 ,0 ,0 ,2 ,0 ,2 ,0 ,2,6628 , 0 
10921.696,17,5 ,6 ,775 ,0 ,0 ,1 ,1 ,0 ,0 ,0 ,2 ,0 ,4 ,0 ,4,8815 , 0 
10921.771,13,5 ,1 ,256 ,0 ,0 ,1 ,0 ,0 ,0 ,0 ,1 ,0 ,2 ,0 ,2,5860 , 0 
10921.786,3,5 ,1 ,256 ,0 ,0 ,1 ,0 ,0 ,0 ,0 ,1 ,0 ,0 ,0 ,0,4427 , 0 
11040.96,8,5 ,1 ,256 ,0 ,0 ,3 ,0 ,0 ,0 ,0 ,3 ,0 ,1 ,0 ,1,5028 , 0 
11041.077,11,5 ,5 ,798 ,0 ,0 ,2 ,0 ,0 ,0 ,0 ,2 ,0 ,0 ,0 ,0,6850 , 0 
11041.123,2,5 ,1 ,256 ,0 ,0 ,2 ,0 ,2 ,0 ,0 ,4 ,0 ,2 ,2 ,4,8569 , 0 
11041.138,6,5 ,2 ,512 ,0 ,0 ,1 ,0 ,0 ,0 ,0 ,1 ,0 ,2 ,0 ,2,11273 , 0 
11041.213,18,5 ,19 ,523 ,0 ,0 ,2 ,0 ,0 ,0 ,0 ,2 ,0 ,0 ,0 ,0,6276 , 0 
11041.235,4,5 ,8 ,512 ,0 ,0 ,0 ,0 ,0 ,0 ,0 ,0 ,0 ,2 ,0 ,2,5737 , 0 
11041.289,7,5 ,16 ,768 ,0 ,0 ,1 ,1 ,0 ,0 ,0 ,2 ,0 ,2 ,0 ,2,11583 , 0 
11041.337,14,5 ,1 ,256 ,0 ,0 ,1 ,0 ,0 ,0 ,0 ,1 ,0 ,3 ,0 ,3,5154 , 0 
11041.35,15,5 ,11 ,1129 ,0 ,0 ,1 ,0 ,0 ,0 ,0 ,1 ,0 ,1 ,0 ,1,6083 , 0 
11041.359,20,5 ,5 ,804 ,0 ,0 ,2 ,0 ,0 ,0 ,0 ,2 ,0 ,0 ,0 ,0,5715 , 0 
11041.36,16,5 ,2 ,512 ,0 ,0 ,1 ,1 ,1 ,0 ,0 ,3 ,0 ,1 ,1 ,2,15645 , 0 
11041.443,10,5 ,14 ,512 ,0 ,0 ,2 ,0 ,0 ,0 ,0 ,2 ,0 ,1 ,0 ,1,5869 , 0 
11041.481,12,5 ,5 ,786 ,0 ,0 ,1 ,1 ,0 ,0 ,0 ,2 ,0 ,4 ,0 ,4,6395 , 0 
11041.596,9,5 ,5 ,800 ,0 ,0 ,1 ,0 ,0 ,0 ,0 ,1 ,0 ,2 ,0 ,2,12582 , 0 
11041.602,5,5 ,19 ,512 ,0 ,0 ,1 ,0 ,1 ,0 ,0 ,2 ,0 ,6 ,1 ,7,9990 , 0 
11041.606,19,5 ,1 ,256 ,0 ,0 ,1 ,0 ,1 ,0 ,0 ,2 ,0 ,3 ,1 ,4,6689 , 0 
11041.696,17,5 ,6 ,775 ,0 ,0 ,1 ,0 ,0 ,0 ,0 ,1 ,0 ,0 ,0 ,0,8357 , 0 
11041.771,13,5 ,1 ,256 ,0 ,0 ,1 ,0 ,0 ,0 ,0 ,1 ,0 ,1 ,0 ,1,5941 , 0 
11041.786,3,5 ,1 ,256 ,0 ,0 ,0 ,0 ,0 ,0 ,0 ,0 ,0 ,2 ,0 ,2,4021 , 0 
11160.96,8,5 ,1 ,256 ,0 ,0 ,1 ,0 ,1 ,0 ,0 ,2 ,0 ,0 ,1 ,1,4771 , 0 
11161.077,11,5 ,5 ,798 ,0 ,0 ,0 ,0 ,0 ,0 ,0 ,0 ,0 ,1 ,0 ,1,7326 , 0 
11161.123,2,5 ,1 ,256 ,0 ,0 ,1 ,0 ,0 ,0 ,0 ,1 ,0 ,0 ,0 ,0,7928 , 0 
11161.138,6,5 ,2 ,512 ,0 ,0 ,1 ,0 ,0 ,0 ,0 ,1 ,0 ,1 ,0 ,1,9874 , 0 
11161.213,18,5 ,19 ,523 ,0 ,0 ,1 ,0 ,0 ,0 ,0 ,1 ,0 ,2 ,0 ,2,6859 , 0 
11161.235,4,5 ,8 ,512 ,0 ,0 ,2 ,1 ,0 ,0 ,0 ,3 ,0 ,1 ,0 ,1,6044 , 0 
11161.289,7,5 ,16 ,768 ,0 ,0 ,3 ,0 ,0 ,0 ,0 ,3 ,0 ,3 ,0 ,3,11339 , 0 
11161.337,14,5 ,1 ,256 ,0 ,0 ,1 ,0 ,0 ,0 ,0 ,1 ,0 ,0 ,0 ,0,5823 , 0 
11161.35,15,5 ,11 ,1129 ,0 ,0 ,1 ,0 ,0 ,0 ,0 ,1 ,0 ,1 ,0 ,1,7300 , 0 
11161.359,20,5 ,5 ,804 ,0 ,0 ,1 ,0 ,0 ,0 ,0 ,1 ,0 ,0 ,0 ,0,6504 , 0 
11161.36,16,5 ,2 ,512 ,0 ,0 ,0 ,0 ,0 ,0 ,0 ,0 ,0 ,4 ,0 ,4,14678 , 0 
11161.443,10,5 ,14 ,512 ,0 ,0 ,0 ,0 ,0 ,0 ,0 ,0 ,0 ,0 ,0 ,0,5581 , 0 
11161.481,12,5 ,5 ,786 ,0 ,0 ,1 ,0 ,0 ,0 ,0 ,1 ,0 ,1 ,0 ,1,6737 , 0 
11161.596,9,5 ,5 ,800 ,0 ,0 ,1 ,0 ,0 ,0 ,0 ,1 ,0 ,2 ,0 ,2,11599 , 0 
11161.602,5,5 ,19 ,512 ,0 ,0 ,1 ,0 ,0 ,0 ,0 ,1 ,0 ,0 ,0 ,0,9859 , 0 
11161.606,19,5 ,1 ,256 ,0 ,0 ,1 ,0 ,0 ,0 ,0 ,1 ,0 ,1 ,0 ,1,6720 , 0 
11161.696,17,5 ,6 ,775 ,0 ,0 ,2 ,0 ,0 ,0 ,0 ,2 ,0 ,2 ,0 ,2,8892 , 0 
11161.771,13,5 ,1 ,256 ,0 ,0 ,0 ,0 ,0 ,0 ,0 ,0 ,0 ,3 ,0 ,3,5929 , 0 
11161.786,3,5 ,1 ,256 ,0 ,0 ,1 ,0 ,0 ,0 ,0 ,1 ,0 ,1 ,0 ,1,4490 , 0 
11280.96,8,5 ,1 ,256 ,0 ,0 ,1 ,0 ,0 ,0 ,0 ,1 ,0 ,1 ,0 ,1,5101 , 0 
11281.077,11,5 ,5 ,780 ,0 ,0 ,1 ,0 ,0 ,0 ,0 ,1 ,0 ,3 ,0 ,3,6917 , 0 
11281.123,2,5 ,1 ,256 ,0 ,0 ,2 ,0 ,1 ,0 ,0 ,3 ,0 ,1 ,1 ,2,8670 , 0 
11281.138,6,5 ,2 ,512 ,0 ,0 ,1 ,0 ,1 ,0 ,0 ,2 ,0 ,3 ,1 ,4,11363 , 0 
11281.213,18,5 ,19 ,512 ,0 ,0 ,1 ,0 ,0 ,0 ,0 ,1 ,0 ,1 ,0 ,1,6343 , 0 
11281.235,4,5 ,8 ,512 ,0 ,0 ,1 ,0 ,0 ,0 ,0 ,1 ,0 ,1 ,0 ,1,5813 , 0 
11281.289,7,5 ,16 ,768 ,0 ,0 ,0 ,0 ,0 ,0 ,0 ,0 ,0 ,0 ,0 ,0,11634 , 1 
11281.337,14,5 ,1 ,256 ,0 ,0 ,1 ,0 ,0 ,0 ,0 ,1 ,0 ,2 ,0 ,2,5222 , 0 
11281.35,15,5 ,11 ,1129 ,0 ,0 ,1 ,0 ,0 ,0 ,0 ,1 ,0 ,0 ,0 ,0,6150 , 0 
11281.359,20,5 ,5 ,804 ,0 ,0 ,2 ,0 ,0 ,0 ,0 ,2 ,0 ,2 ,0 ,2,5774 , 0 
11281.36,16,5 ,2 ,512 ,0 ,0 ,1 ,0 ,0 ,0 ,0 ,1 ,0 ,0 ,0 ,0,15718 , 0 
11281.443,10,5 ,14 ,512 ,0 ,0 ,2 ,0 ,0 ,0 ,0 ,2 ,0 ,0 ,0 ,0,5937 , 0 
11281.481,12,5 ,5 ,786 ,0 ,0 ,1 ,0 ,0 ,0 ,0 ,1 ,0 ,2 ,0 ,2,6465 , 0 
11281.596,9,5 ,5 ,800 ,0 ,0 ,0 ,0 ,0 ,0 ,0 ,0 ,0 ,0 ,0 ,0,12637 , 0 
11281.602,5,5 ,19 ,512 ,0 ,0 ,1 ,0 ,0 ,0 ,0 ,1 ,0 ,2 ,0 ,2,10079 , 0 
11281.606,19,5 ,1 ,256 ,0 ,0 ,1 ,0 ,0 ,0 ,0 ,1 ,0 ,3 ,0 ,3,6769 , 0 
11281.696,17,5 ,6 ,773 ,0 ,0 ,1 ,1 ,0 ,0 ,0 ,2 ,0 ,1 ,0 ,1,8416 , 0 
11281.771,13,5 ,1 ,256 ,0 ,0 ,1 ,0 ,0 ,0 ,0 ,1 ,0 ,0 ,0 ,0,6014 , 0 
11281.786,3,5 ,1 ,256 ,0 ,0 ,2 ,0 ,0 ,0 ,0 ,2 ,0 ,0 ,0 ,0,4083 , 0 
11400.96,8,8 ,1 ,256 ,0 ,0 ,6 ,4 ,3 ,2 ,2 ,17 ,0 ,20 ,5 ,25,5013 , 0 
11401.083,11,21 ,15 ,1580 ,0 ,0 ,11 ,6 ,3 ,7 ,3 ,30 ,0 ,19 ,6 ,25,7891 , 0 
11401.124,2,8 ,1 ,256 ,0 ,0 ,9 ,6 ,12 ,9 ,5 ,41 ,0 ,17 ,24 ,41,8529 , 0 
11401.139,6,25 ,2 ,523 ,0 ,0 ,11 ,6 ,9 ,10 ,3 ,39 ,0 ,20 ,19 ,39,10521 , 0 
11401.214,18,8 ,5 ,812 ,0 ,0 ,7 ,4 ,0 ,3 ,0 ,14 ,0 ,8 ,0 ,8,7107 , 0 
11401.235,4,8 ,19 ,512 ,0 ,0 ,6 ,4 ,2 ,2 ,1 ,15 ,0 ,6 ,3 ,9,6387 , 0 
11401.29,7,30 ,9 ,65535 ,0 ,0 ,13 ,1 ,6 ,2 ,4 ,26 ,0 ,18 ,27 ,45,11738 , 1 
11401.337,14,8 ,1 ,256 ,0 ,0 ,10 ,5 ,2 ,6 ,2 ,25 ,0 ,12 ,4 ,16,6276 , 0 
11401.35,15,25 ,9 ,1068 ,0 ,0 ,11 ,5 ,4 ,5 ,3 ,28 ,0 ,11 ,8 ,19,7911 , 0 
11401.36,20,8 ,12 ,1375 ,0 ,0 ,12 ,4 ,0 ,6 ,0 ,22 ,0 ,9 ,0 ,9,7069 , 0 
11401.361,16,25 ,2 ,531 ,0 ,0 ,14 ,7 ,4 ,12 ,3 ,40 ,0 ,19 ,17 ,36,15269 , 0 
11401.444,10,25 ,6 ,840 ,0 ,0 ,11 ,6 ,0 ,4 ,0 ,21 ,0 ,13 ,1 ,14,5913 , 0 
11401.482,12,8 ,5 ,812 ,0 ,0 ,6 ,3 ,3 ,2 ,1 ,15 ,0 ,10 ,5 ,15,7157 , 0 
11401.603,5,8 ,2 ,531 ,0 ,0 ,8 ,4 ,14 ,4 ,10 ,40 ,0 ,12 ,28 ,40,10562 , 0 
11401.607,19,8 ,1 ,256 ,0 ,0 ,10 ,4 ,13 ,7 ,10 ,44 ,0 ,11 ,28 ,39,7335 , 0 
11401.697,17,25 ,6 ,840 ,0 ,0 ,13 ,6 ,7 ,6 ,3 ,35 ,0 ,17 ,14 ,31,9471 , 0 
11401.723,9,25 ,5 ,812 ,0 ,0 ,11 ,5 ,9 ,7 ,2 ,34 ,0 ,17 ,18 ,35,12435 , 0 
11401.771,13,8 ,1 ,256 ,0 ,0 ,5 ,2 ,8 ,1 ,2 ,18 ,0 ,14 ,13 ,27,6245 , 0 
11401.786,3,8 ,1 ,256 ,0 ,0 ,5 ,3 ,0 ,1 ,0 ,9 ,0 ,15 ,0 ,15,4623 , 0 
11520.96,8,8 ,1 ,256 ,0 ,0 ,1 ,1 ,0 ,1 ,0 ,3 ,0 ,4 ,0 ,4,5178 , 0 
11521.082,11,65 ,5 ,924 ,0 ,0 ,18 ,10 ,0 ,12 ,1 ,41 ,0 ,43 ,2 ,45,7359 , 0 
11521.124,2,8 ,1 ,256 ,0 ,0 ,12 ,0 ,44 ,2 ,25 ,83 ,0 ,25 ,81 ,106,9069 , 0 
11521.139,6,63 ,2 ,512 ,0 ,0 ,14 ,8 ,7 ,12 ,5 ,46 ,0 ,42 ,18 ,60,11946 , 0 
11521.214,18,8 ,19 ,521 ,0 ,0 ,6 ,1 ,9 ,2 ,1 ,19 ,0 ,20 ,11 ,31,6649 , 0 
11521.235,4,8 ,19 ,521 ,0 ,0 ,2 ,2 ,0 ,1 ,0 ,5 ,0 ,7 ,0 ,7,5921 , 0 
11521.29,7,68 ,9 ,65535 ,0 ,0 ,19 ,0 ,0 ,0 ,0 ,19 ,0 ,41 ,0 ,41,11867 , 1 
11521.337,14,8 ,1 ,256 ,0 ,0 ,4 ,1 ,1 ,1 ,1 ,8 ,0 ,19 ,2 ,21,5373 , 0 
11521.35,15,65 ,11 ,1436 ,0 ,0 ,16 ,3 ,1 ,7 ,1 ,28 ,0 ,38 ,2 ,40,6523 , 0 
11521.36,20,8 ,12 ,1320 ,0 ,0 ,5 ,3 ,0 ,0 ,0 ,8 ,0 ,28 ,0 ,28,5908 , 0 
11521.361,16,65 ,2 ,512 ,0 ,0 ,18 ,5 ,7 ,14 ,2 ,46 ,0 ,45 ,18 ,63,16350 , 0 
11521.444,10,63 ,0 ,0 ,0 ,0 ,15 ,10 ,0 ,11 ,0 ,36 ,0 ,13 ,0 ,13,6493 , 0 
11521.482,12,8 ,18 ,898 ,0 ,0 ,8 ,5 ,4 ,2 ,1 ,20 ,0 ,32 ,6 ,38,6823 , 0 
11521.596,9,65 ,5 ,924 ,0 ,0 ,20 ,4 ,6 ,10 ,2 ,42 ,0 ,52 ,19 ,71,13258 , 0 
11521.603,5,8 ,2 ,512 ,0 ,0 ,13 ,8 ,17 ,3 ,14 ,55 ,0 ,43 ,36 ,79,10764 , 0 
11521.607,19,8 ,1 ,256 ,0 ,0 ,3 ,0 ,11 ,3 ,1 ,18 ,0 ,22 ,14 ,36,6951 , 0 
11521.697,17,65 ,16 ,768 ,0 ,0 ,17 ,4 ,0 ,5 ,0 ,26 ,0 ,32 ,0 ,32,8795 , 0 
11521.771,13,8 ,1 ,256 ,0 ,0 ,2 ,1 ,0 ,2 ,0 ,5 ,0 ,21 ,0 ,21,6150 , 0 
11521.786,3,8 ,1 ,256 ,0 ,0 ,2 ,1 ,0 ,0 ,0 ,3 ,0 ,3 ,0 ,3,4182 , 0 
11640.96,8,8 ,1 ,256 ,0 ,0 ,2 ,0 ,0 ,0 ,0 ,2 ,0 ,4 ,0 ,4,5138 , 0 
11641.078,11,69 ,5 ,898 ,0 ,0 ,8 ,4 ,7 ,6 ,6 ,31 ,0 ,23 ,13 ,36,8227 , 0 
11641.124,2,8 ,1 ,256 ,0 ,0 ,4 ,0 ,24 ,4 ,9 ,41 ,0 ,14 ,36 ,50,8823 , 0 
11641.139,6,69 ,2 ,520 ,0 ,0 ,12 ,6 ,11 ,4 ,3 ,36 ,0 ,19 ,15 ,34,11041 , 0 
11641.214,18,8 ,19 ,521 ,0 ,0 ,3 ,0 ,4 ,0 ,0 ,7 ,0 ,8 ,4 ,12,7297 , 0 
11641.235,4,8 ,19 ,521 ,0 ,0 ,2 ,0 ,0 ,0 ,0 ,2 ,0 ,5 ,0 ,5,6487 , 0 
11641.29,7,69 ,16 ,862 ,0 ,0 ,10 ,6 ,2 ,1 ,0 ,19 ,0 ,24 ,2 ,26,12047 , 0 
11641.337,14,8 ,1 ,256 ,0 ,0 ,2 ,0 ,1 ,1 ,0 ,4 ,0 ,8 ,1 ,9,6425 , 0 
11641.35,15,69 ,7 ,1364 ,0 ,0 ,12 ,9 ,0 ,4 ,0 ,25 ,0 ,24 ,0 ,24,8318 , 0 
11641.36,20,8 ,12 ,1444 ,0 ,0 ,5 ,3 ,0 ,0 ,0 ,8 ,0 ,8 ,0 ,8,7192 , 0 
11641.361,16,69 ,2 ,534 ,0 ,0 ,11 ,3 ,12 ,6 ,2 ,34 ,0 ,29 ,17 ,46,15736 , 0 
11641.444,10,69 ,14 ,521 ,0 ,0 ,10 ,8 ,0 ,4 ,0 ,22 ,0 ,9 ,0 ,9,6208 , 0 
11641.481,12,8 ,18 ,982 ,0 ,0 ,4 ,1 ,3 ,0 ,0 ,8 ,0 ,9 ,3 ,12,7352 , 0 
11641.596,9,69 ,5 ,898 ,0 ,0 ,12 ,4 ,16 ,7 ,4 ,43 ,0 ,28 ,22 ,50,13046 , 0 
11641.603,5,8 ,19 ,521 ,0 ,0 ,6 ,3 ,23 ,3 ,10 ,45 ,0 ,22 ,41 ,63,11269 , 0 
11641.606,19,8 ,1 ,256 ,0 ,0 ,2 ,0 ,22 ,2 ,5 ,31 ,0 ,7 ,30 ,37,7591 , 0 
11641.696,17,69 ,6 ,827 ,0 ,0 ,9 ,6 ,4 ,2 ,1 ,22 ,0 ,18 ,5 ,23,9745 , 0 
11641.771,13,8 ,1 ,256 ,0 ,0 ,2 ,0 ,0 ,0 ,0 ,2 ,0 ,7 ,0 ,7,6382 , 0 
11641.786,3,8 ,1 ,256 ,0 ,0 ,2 ,0 ,0 ,0 ,0 ,2 ,0 ,2 ,0 ,2,4731 , 0 
11760.96,8,8 ,1 ,256 ,0 ,0 ,2 ,1 ,0 ,0 ,0 ,3 ,0 ,2 ,0 ,2,5249 , 0 
11761.077,11,69 ,5 ,877 ,0 ,0 ,2 ,1 ,0 ,0 ,0 ,3 ,0 ,5 ,0 ,5,7433 , 0 
11761.123,2,8 ,1 ,256 ,0 ,0 ,2 ,1 ,6 ,1 ,0 ,10 ,0 ,7 ,7 ,14,9199 , 0 
11761.138,6,69 ,2 ,524 ,0 ,0 ,2 ,1 ,1 ,1 ,0 ,5 ,0 ,8 ,1 ,9,12056 , 0 
11761.213,18,8 ,19 ,521 ,0 ,0 ,1 ,0 ,1 ,0 ,0 ,2 ,0 ,3 ,1 ,4,6730 , 0 
11761.235,4,8 ,19 ,521 ,0 ,0 ,0 ,0 ,0 ,0 ,0 ,0 ,0 ,1 ,0 ,1,5990 , 0 
11761.289,7,69 ,16 ,835 ,0 ,0 ,2 ,1 ,2 ,0 ,0 ,5 ,0 ,5 ,2 ,7,11958 , 0 
11761.337,14,8 ,1 ,256 ,0 ,0 ,1 ,1 ,0 ,0 ,0 ,2 ,0 ,6 ,0 ,6,5451 , 0 
11761.35,15,69 ,7 ,1245 ,0 ,0 ,2 ,2 ,0 ,0 ,0 ,4 ,0 ,4 ,0 ,4,6600 , 0 
11761.36,20,8 ,12 ,1449 ,0 ,0 ,1 ,1 ,0 ,0 ,0 ,2 ,0 ,5 ,0 ,5,5983 , 0 
11761.36,16,69 ,2 ,524 ,0 ,0 ,2 ,1 ,3 ,0 ,0 ,6 ,0 ,5 ,3 ,8,16460 , 0 
11761.444,10,69 ,14 ,521 ,0 ,0 ,4 ,0 ,0 ,0 ,0 ,4 ,0 ,2 ,0 ,2,6571 , 0 
11761.481,12,8 ,18 ,982 ,0 ,0 ,1 ,0 ,1 ,0 ,0 ,2 ,0 ,4 ,1 ,5,6908 , 0 
11761.596,9,69 ,5 ,877 ,0 ,0 ,2 ,1 ,0 ,0 ,0 ,3 ,0 ,5 ,0 ,5,13345 , 0 
11761.602,5,8 ,19 ,521 ,0 ,0 ,3 ,0 ,2 ,1 ,0 ,6 ,0 ,7 ,2 ,9,10884 , 0 
11761.606,19,8 ,1 ,256 ,0 ,0 ,1 ,1 ,3 ,0 ,0 ,5 ,0 ,8 ,4 ,12,7076 , 0 
11761.696,17,69 ,6 ,812 ,0 ,0 ,2 ,1 ,0 ,0 ,0 ,3 ,0 ,2 ,0 ,2,8876 , 0 
11761.771,13,8 ,1 ,256 ,0 ,0 ,3 ,1 ,0 ,0 ,0 ,4 ,0 ,3 ,0 ,3,6245 , 0 
11761.786,3,8 ,1 ,256 ,0 ,0 ,1 ,1 ,0 ,0 ,0 ,2 ,0 ,2 ,0 ,2,4236 , 0 
11880.96,8,8 ,1 ,256 ,0 ,0 ,1 ,0 ,0 ,0 ,0 ,1 ,0 ,4 ,0 ,4,5206 , 0 
11881.077,11,69 ,5 ,832 ,0 ,0 ,3 ,1 ,0 ,0 ,0 ,4 ,0 ,5 ,0 ,5,8318 , 0 
11881.123,2,8 ,1 ,256 ,0 ,0 ,1 ,0 ,2 ,0 ,0 ,3 ,0 ,5 ,2 ,7,8901 , 0 
11881.138,6,69 ,2 ,524 ,0 ,0 ,2 ,0 ,1 ,0 ,0 ,3 ,0 ,3 ,1 ,4,11116 , 0 
11881.213,18,8 ,19 ,512 ,0 ,0 ,2 ,1 ,2 ,0 ,0 ,5 ,0 ,3 ,2 ,5,7398 , 0 
11881.235,4,8 ,19 ,512 ,0 ,0 ,2 ,1 ,0 ,0 ,0 ,3 ,0 ,3 ,0 ,3,6552 , 0 
11881.289,7,69 ,16 ,808 ,0 ,0 ,2 ,1 ,0 ,0 ,0 ,3 ,0 ,5 ,0 ,5,12122 , 0 
11881.337,14,8 ,1 ,256 ,0 ,0 ,2 ,0 ,1 ,0 ,0 ,3 ,0 ,3 ,1 ,4,6518 , 0 
11881.35,15,69 ,7 ,1229 ,0 ,0 ,2 ,0 ,0 ,0 ,0 ,2 ,0 ,3 ,0 ,3,8386 , 0 
11881.36,20,8 ,12 ,1294 ,0 ,0 ,2 ,1 ,0 ,0 ,0 ,3 ,0 ,3 ,0 ,3,7267 , 0 
11881.36,16,69 ,2 ,524 ,0 ,0 ,2 ,0 ,1 ,0 ,0 ,3 ,0 ,6 ,1 ,7,15820 , 0 
11881.444,10,69 ,14 ,517 ,0 ,0 ,1 ,1 ,0 ,0 ,0 ,2 ,0 ,2 ,0 ,2,6286 , 0 
11881.481,12,8 ,18 ,901 ,0 ,0 ,2 ,1 ,1 ,0 ,0 ,4 ,0 ,2 ,1 ,3,7454 , 0 
11881.596,9,69 ,5 ,832 ,0 ,0 ,2 ,1 ,0 ,0 ,0 ,3 ,0 ,5 ,0 ,5,13132 , 0 
11881.602,5,8 ,19 ,512 ,0 ,0 ,2 ,1 ,2 ,0 ,0 ,5 ,0 ,8 ,2 ,10,11382 , 0 
11881.606,19,8 ,1 ,256 ,0 ,0 ,2 ,0 ,7 ,0 ,0 ,9 ,0 ,3 ,7 ,10,7679 , 0 
11881.696,17,69 ,6 ,823 ,0 ,0 ,2 ,1 ,0 ,0 ,0 ,3 ,0 ,3 ,0 ,3,9823 , 0 
11881.771,13,8 ,1 ,256 ,0 ,0 ,0 ,0 ,0 ,0 ,0 ,0 ,0 ,4 ,0 ,4,6465 , 0 
11881.786,3,8 ,1 ,256 ,0 ,0 ,2 ,0 ,0 ,0 ,0 ,2 ,0 ,3 ,0 ,3,4811 , 0 
12000.96,8,8 ,1 ,256 ,0 ,0 ,1 ,0 ,0 ,0 ,0 ,1 ,0 ,3 ,0 ,3,5314 , 0 
12001.078,11,69 ,15 ,943 ,0 ,0 ,9 ,9 ,9 ,5 ,2 ,34 ,0 ,33 ,16 ,49,7925 , 0 
12001.123,2,8 ,1 ,256 ,0 ,0 ,6 ,0 ,4 ,2 ,3 ,15 ,0 ,15 ,7 ,22,9347 , 0 
12001.138,6,69 ,2 ,512 ,0 ,0 ,2 ,4 ,1 ,0 ,1 ,8 ,0 ,11 ,2 ,13,12281 , 0 
12001.214,18,8 ,19 ,512 ,0 ,0 ,7 ,0 ,1 ,0 ,2 ,10 ,0 ,12 ,3 ,15,6886 , 0 
12001.235,4,8 ,19 ,512 ,0 ,0 ,2 ,2 ,0 ,0 ,0 ,4 ,0 ,8 ,0 ,8,6081 , 0 
12001.289,7,69 ,9 ,300 ,0 ,0 ,8 ,9 ,1 ,5 ,1 ,24 ,0 ,20 ,8 ,28,12355 , 0 
12001.337,14,8 ,1 ,256 ,0 ,0 ,1 ,0 ,0 ,0 ,0 ,1 ,0 ,9 ,0 ,9,5524 , 0 
12001.35,15,69 ,7 ,662 ,0 ,0 ,10 ,7 ,2 ,9 ,2 ,30 ,0 ,20 ,24 ,44,7127 , 0 
12001.36,20,8 ,12 ,914 ,0 ,0 ,10 ,4 ,0 ,2 ,0 ,16 ,0 ,14 ,0 ,14,6218 , 0 
12001.36,16,69 ,9 ,300 ,0 ,0 ,6 ,8 ,2 ,3 ,2 ,21 ,0 ,14 ,4 ,18,16810 , 0 
12001.444,10,69 ,14 ,517 ,0 ,0 ,1 ,0 ,0 ,0 ,0 ,1 ,0 ,1 ,0 ,1,6641 , 0 
12001.482,12,8 ,11 ,664 ,0 ,0 ,8 ,8 ,1 ,3 ,1 ,21 ,0 ,21 ,2 ,23,7133 , 0 
12001.597,9,69 ,11 ,65535 ,0 ,0 ,13 ,6 ,15 ,17 ,1 ,52 ,0 ,23 ,66 ,89,13917 , 1 
12001.606,19,8 ,1 ,256 ,0 ,0 ,6 ,0 ,6 ,2 ,7 ,21 ,0 ,16 ,14 ,30,7242 , 0 
12001.668,5,8 ,9 ,300 ,0 ,0 ,12 ,6 ,0 ,12 ,2 ,32 ,0 ,31 ,18 ,49,11345 , 0 
12001.696,17,69 ,16 ,848 ,0 ,0 ,4 ,3 ,0 ,1 ,0 ,8 ,0 ,9 ,0 ,9,9069 , 0 
12001.771,13,8 ,1 ,256 ,0 ,0 ,5 ,0 ,0 ,0 ,0 ,5 ,0 ,12 ,0 ,12,6360 , 0 
12001.786,3,8 ,1 ,256 ,0 ,0 ,1 ,0 ,0 ,0 ,0 ,1 ,0 ,0 ,0 ,0,4286 , 0 
12120.96,8,8 ,1 ,256 ,0 ,0 ,1 ,0 ,0 ,0 ,0 ,1 ,0 ,6 ,0 ,6,5300 , 0 
12121.078,11,69 ,9 ,300 ,0 ,0 ,15 ,13 ,14 ,12 ,5 ,59 ,0 ,51 ,30 ,81,9012 , 0 
12121.123,2,8 ,1 ,256 ,0 ,0 ,8 ,0 ,2 ,1 ,1 ,12 ,0 ,27 ,3 ,30,9156 , 0 
12121.138,6,69 ,2 ,512 ,0 ,0 ,8 ,5 ,0 ,3 ,0 ,16 ,0 ,9 ,0 ,9,11450 , 0 
12121.214,18,8 ,19 ,525 ,0 ,0 ,7 ,6 ,3 ,1 ,2 ,19 ,0 ,27 ,5 ,32,7723 , 0 
12121.235,4,8 ,19 ,512 ,0 ,0 ,2 ,6 ,0 ,0 ,0 ,8 ,0 ,8 ,0 ,8,6735 , 0 
12121.29,7,69 ,9 ,300 ,0 ,0 ,9 ,11 ,1 ,6 ,1 ,28 ,0 ,22 ,10 ,32,12507 , 0 
12121.337,14,8 ,1 ,256 ,0 ,0 ,1 ,0 ,1 ,0 ,1 ,3 ,0 ,11 ,2 ,13,6604 , 0 
12121.35,15,69 ,9 ,300 ,0 ,0 ,10 ,12 ,1 ,6 ,2 ,31 ,0 ,29 ,16 ,45,8891 , 0 
12121.36,20,8 ,11 ,1154 ,0 ,0 ,12 ,11 ,0 ,3 ,0 ,26 ,0 ,32 ,0 ,32,7677 , 0 
12121.361,16,69 ,9 ,300 ,0 ,0 ,1 ,10 ,0 ,0 ,0 ,11 ,0 ,30 ,1 ,31,16051 , 0 
12121.444,10,69 ,14 ,517 ,0 ,0 ,2 ,0 ,1 ,0 ,1 ,4 ,0 ,7 ,2 ,9,6387 , 0 
12121.482,12,8 ,18 ,924 ,0 ,0 ,14 ,10 ,5 ,5 ,1 ,35 ,0 ,30 ,6 ,36,7871 , 0 
12121.604,9,69 ,5 ,827 ,0 ,0 ,19 ,6 ,19 ,17 ,3 ,64 ,0 ,32 ,72 ,104,13898 , 1 
12121.607,19,8 ,1 ,256 ,0 ,0 ,8 ,0 ,26 ,0 ,4 ,38 ,0 ,25 ,32 ,57,7954 , 0 
12121.61,5,8 ,19 ,512 ,0 ,0 ,12 ,4 ,9 ,7 ,1 ,33 ,0 ,57 ,31 ,88,11889 , 0 
12121.696,17,69 ,16 ,848 ,0 ,0 ,3 ,0 ,0 ,0 ,0 ,3 ,0 ,12 ,0 ,12,9933 , 0 
12121.771,13,8 ,1 ,256 ,0 ,0 ,7 ,0 ,0 ,0 ,0 ,7 ,0 ,15 ,0 ,15,6694 , 0 
12121.786,3,8 ,1 ,256 ,0 ,0 ,0 ,0 ,0 ,0 ,0 ,0 ,0 ,2 ,0 ,2,4888 , 0 
12240.96,8,8 ,1 ,256 ,0 ,0 ,2 ,0 ,0 ,0 ,0 ,2 ,0 ,3 ,0 ,3,5410 , 0 
12241.079,11,69 ,9 ,300 ,0 ,0 ,17 ,16 ,28 ,19 ,6 ,86 ,0 ,43 ,67 ,110,8803 , 0 
12241.123,2,8 ,1 ,256 ,0 ,0 ,5 ,0 ,2 ,0 ,0 ,7 ,0 ,15 ,3 ,18,9559 , 0 
12241.138,6,69 ,2 ,512 ,0 ,0 ,3 ,0 ,0 ,0 ,0 ,3 ,0 ,9 ,0 ,9,12378 , 0 
12241.214,18,8 ,19 ,512 ,0 ,0 ,4 ,1 ,0 ,2 ,2 ,9 ,0 ,20 ,2 ,22,7055 , 0 
12241.235,4,8 ,19 ,512 ,0 ,0 ,2 ,3 ,0 ,0 ,0 ,5 ,0 ,6 ,0 ,6,6222 , 0 
12241.337,14,8 ,1 ,256 ,0 ,0 ,1 ,0 ,1 ,1 ,0 ,3 ,0 ,7 ,2 ,9,5671 , 0 
12241.35,15,69 ,7 ,796 ,0 ,0 ,16 ,13 ,24 ,15 ,5 ,73 ,0 ,27 ,53 ,80,7910 , 0 
12241.36,20,8 ,11 ,646 ,0 ,0 ,6 ,10 ,0 ,2 ,0 ,18 ,0 ,28 ,0 ,28,6582 , 0 
12241.361,16,69 ,2 ,512 ,0 ,0 ,5 ,7 ,0 ,1 ,1 ,14 ,0 ,23 ,3 ,26,17106 , 0 
12241.428,7,69 ,9 ,65535 ,0 ,0 ,10 ,14 ,12 ,9 ,4 ,49 ,0 ,32 ,23 ,55,12890 , 0 
12241.444,10,69 ,14 ,512 ,0 ,0 ,1 ,1 ,0 ,1 ,0 ,3 ,0 ,3 ,0 ,3,6720 , 0 
12241.484,12,8 ,11 ,697 ,0 ,0 ,14 ,9 ,0 ,6 ,0 ,29 ,0 ,22 ,0 ,22,7539 , 0 
12241.597,9,69 ,11 ,697 ,0 ,0 ,18 ,10 ,32 ,24 ,9 ,93 ,0 ,37 ,105 ,142,14832 , 1 
12241.603,5,8 ,9 ,300 ,0 ,0 ,9 ,5 ,17 ,4 ,6 ,41 ,0 ,40 ,28 ,68,11982 , 0 
12241.607,19,8 ,1 ,256 ,0 ,0 ,5 ,0 ,12 ,1 ,3 ,21 ,0 ,14 ,19 ,33,7553 , 0 
12241.696,17,69 ,7 ,796 ,0 ,0 ,5 ,2 ,0 ,1 ,0 ,8 ,0 ,9 ,0 ,9,9260 , 0 
12241.771,13,8 ,1 ,256 ,0 ,0 ,4 ,0 ,0 ,0 ,0 ,4 ,0 ,9 ,0 ,9,6493 , 0 
12241.786,3,8 ,1 ,256 ,0 ,0 ,1 ,0 ,0 ,0 ,0 ,1 ,0 ,1 ,0 ,1,4350 , 0 
12360.96,8,8 ,1 ,256 ,0 ,0 ,1 ,0 ,0 ,0 ,0 ,1 ,0 ,3 ,0 ,3,5371 , 0 
12361.078,11,69 ,5 ,816 ,0 ,0 ,9 ,6 ,1 ,5 ,1 ,22 ,0 ,24 ,6 ,30,9263 , 0 
12361.124,2,8 ,1 ,256 ,0 ,0 ,4 ,0 ,21 ,0 ,0 ,25 ,0 ,15 ,22 ,37,9313 , 0 
12361.138,6,69 ,2 ,512 ,0 ,0 ,2 ,3 ,0 ,0 ,0 ,5 ,0 ,13 ,0 ,13,11600 , 0 
12361.214,18,8 ,19 ,545 ,0 ,0 ,4 ,2 ,0 ,0 ,0 ,6 ,0 ,15 ,0 ,15,7853 , 0 
12361.235,4,8 ,19 ,545 ,0 ,0 ,1 ,3 ,0 ,0 ,0 ,4 ,0 ,7 ,0 ,7,6864 , 0 
12361.29,7,69 ,16 ,941 ,0 ,0 ,6 ,4 ,3 ,1 ,1 ,15 ,0 ,15 ,13 ,28,12736 , 0 
12361.337,14,8 ,1 ,256 ,0 ,0 ,1 ,0 ,0 ,0 ,0 ,1 ,0 ,4 ,0 ,4,6688 , 0 
12361.35,15,69 ,7 ,1306 ,0 ,0 ,8 ,4 ,3 ,4 ,0 ,19 ,0 ,16 ,6 ,22,9138 , 0 
12361.36,20,8 ,12 ,1242 ,0 ,0 ,6 ,7 ,0 ,1 ,0 ,14 ,0 ,15 ,0 ,15,7823 , 0 
12361.361,16,69 ,2 ,512 ,0 ,0 ,6 ,2 ,16 ,0 ,1 ,25 ,0 ,15 ,21 ,36,16436 , 0 
12361.444,10,69 ,14 ,512 ,0 ,0 ,1 ,0 ,0 ,0 ,0 ,1 ,0 ,2 ,0 ,2,6470 , 0 
12361.482,12,8 ,5 ,816 ,0 ,0 ,9 ,4 ,6 ,1 ,0 ,20 ,0 ,15 ,6 ,21,8141 , 0 
12361.596,9,69 ,16 ,941 ,0 ,0 ,7 ,6 ,0 ,5 ,1 ,19 ,0 ,23 ,5 ,28,14160 , 0 
12361.609,19,8 ,1 ,256 ,0 ,0 ,3 ,0 ,21 ,1 ,1 ,26 ,0 ,12 ,22 ,34,8133 , 0 
12361.697,17,69 ,16 ,941 ,0 ,0 ,4 ,6 ,0 ,1 ,0 ,11 ,0 ,11 ,0 ,11,10143 , 0 
12361.728,5,8 ,19 ,545 ,0 ,0 ,7 ,4 ,13 ,2 ,1 ,27 ,0 ,24 ,16 ,40,12249 , 0 
12361.771,13,8 ,1 ,256 ,0 ,0 ,7 ,0 ,0 ,0 ,0 ,7 ,0 ,11 ,0 ,11,6823 , 0 
12361.786,3,8 ,1 ,256 ,0 ,0 ,2 ,0 ,0 ,0 ,0 ,2 ,0 ,0 ,0 ,0,4945 , 0 
12480.96,8,8 ,1 ,256 ,0 ,0 ,1 ,0 ,0 ,0 ,0 ,1 ,0 ,3 ,0 ,3,5488 , 0 
12481.077,11,69 ,5 ,905 ,0 ,0 ,2 ,1 ,0 ,0 ,0 ,3 ,0 ,8 ,0 ,8,8894 , 0 
12481.123,2,8 ,1 ,256 ,0 ,0 ,1 ,0 ,6 ,0 ,0 ,7 ,0 ,4 ,7 ,11,9655 , 0 
12481.138,6,69 ,2 ,512 ,0 ,0 ,2 ,1 ,0 ,0 ,0 ,3 ,0 ,5 ,0 ,5,12472 , 0 
12481.213,18,8 ,19 ,526 ,0 ,0 ,2 ,1 ,0 ,0 ,0 ,3 ,0 ,2 ,0 ,2,7148 , 0 
12481.235,4,8 ,19 ,526 ,0 ,0 ,1 ,1 ,0 ,0 ,0 ,2 ,0 ,2 ,0 ,2,6310 , 0 
12481.289,7,69 ,16 ,868 ,0 ,0 ,2 ,1 ,1 ,1 ,0 ,5 ,0 ,5 ,1 ,6,12980 , 0 
12481.337,14,8 ,1 ,256 ,0 ,0 ,1 ,0 ,0 ,0 ,0 ,1 ,0 ,3 ,0 ,3,5741 , 0 
12481.35,15,69 ,7 ,1254 ,0 ,0 ,2 ,1 ,0 ,0 ,0 ,3 ,0 ,3 ,0 ,3,8007 , 0 
12481.36,20,8 ,12 ,1242 ,0 ,0 ,3 ,0 ,0 ,0 ,0 ,3 ,0 ,3 ,0 ,3,6654 , 0 
12481.36,16,69 ,2 ,512 ,0 ,0 ,1 ,1 ,4 ,1 ,0 ,7 ,0 ,5 ,5 ,10,17235 , 0 
12481.444,10,69 ,14 ,512 ,0 ,0 ,2 ,0 ,0 ,0 ,0 ,2 ,0 ,1 ,0 ,1,6778 , 0 
12481.481,12,8 ,5 ,907 ,0 ,0 ,1 ,2 ,0 ,0 ,0 ,3 ,0 ,6 ,0 ,6,7652 , 0 
12481.596,9,69 ,16 ,868 ,0 ,0 ,3 ,1 ,0 ,0 ,0 ,4 ,0 ,6 ,0 ,6,14971 , 0 
12481.602,5,8 ,19 ,526 ,0 ,0 ,2 ,1 ,3 ,0 ,0 ,6 ,0 ,9 ,3 ,12,12143 , 0 
12481.606,19,8 ,1 ,256 ,0 ,0 ,2 ,0 ,6 ,0 ,0 ,8 ,0 ,2 ,7 ,9,7672 , 0 
12481.696,17,69 ,16 ,868 ,0 ,0 ,3 ,1 ,0 ,0 ,0 ,4 ,0 ,3 ,0 ,3,9347 , 0 
12481.771,13,8 ,1 ,256 ,0 ,0 ,1 ,0 ,0 ,0 ,0 ,1 ,0 ,4 ,0 ,4,6577 , 0 
12481.786,3,8 ,1 ,256 ,0 ,0 ,2 ,0 ,0 ,0 ,0 ,2 ,0 ,1 ,0 ,1,4425 , 0 
12600.96,8,8 ,1 ,256 ,0 ,0 ,2 ,0 ,0 ,0 ,0 ,2 ,0 ,1 ,0 ,1,5434 , 0 
12601.077,11,69 ,5 ,905 ,0 ,0 ,2 ,0 ,0 ,0 ,0 ,2 ,0 ,2 ,0 ,2,9345 , 0 
12601.123,2,8 ,1 ,256 ,0 ,0 ,2 ,0 ,3 ,0 ,0 ,5 ,0 ,6 ,3 ,9,9416 , 0 
12601.138,6,69 ,2 ,512 ,0 ,0 ,1 ,0 ,0 ,0 ,0 ,1 ,0 ,1 ,0 ,1,11662 , 0 
12601.213,18,8 ,19 ,526 ,0 ,0 ,1 ,0 ,0 ,0 ,0 ,1 ,0 ,3 ,0 ,3,7922 , 0 
12601.235,4,8 ,19 ,526 ,0 ,0 ,1 ,0 ,0 ,0 ,0 ,1 ,0 ,1 ,0 ,1,6943 , 0 
12601.289,7,69 ,16 ,868 ,0 ,0 ,2 ,0 ,1 ,0 ,0 ,3 ,0 ,1 ,1 ,2,12833 , 0 
12601.337,14,8 ,1 ,256 ,0 ,0 ,1 ,0 ,0 ,0 ,0 ,1 ,0 ,2 ,0 ,2,6759 , 0 
12601.36,20,8 ,12 ,1252 ,0 ,0 ,2 ,1 ,0 ,0 ,0 ,3 ,0 ,2 ,0 ,2,7898 , 0 
12601.36,16,69 ,2 ,512 ,0 ,0 ,1 ,1 ,2 ,0 ,0 ,4 ,0 ,3 ,2 ,5,16533 , 0 
12601.444,10,69 ,14 ,512 ,0 ,0 ,1 ,0 ,0 ,0 ,0 ,1 ,0 ,1 ,0 ,1,6530 , 0 
12601.45,15,69 ,7 ,1164 ,0 ,0 ,1 ,1 ,0 ,0 ,0 ,2 ,0 ,2 ,0 ,2,9214 , 0 
12601.481,12,8 ,5 ,907 ,0 ,0 ,3 ,0 ,1 ,0 ,0 ,4 ,0 ,1 ,1 ,2,8224 , 0 
12601.596,9,69 ,16 ,868 ,0 ,0 ,0 ,0 ,0 ,0 ,0 ,0 ,0 ,3 ,0 ,3,14228 , 0 
12601.602,5,8 ,19 ,526 ,0 ,0 ,2 ,0 ,1 ,0 ,0 ,3 ,0 ,4 ,1 ,5,12376 , 0 
12601.606,19,8 ,1 ,256 ,0 ,0 ,2 ,0 ,1 ,0 ,0 ,3 ,0 ,1 ,1 ,2,8231 , 0 
12601.696,17,69 ,16 ,853 ,0 ,0 ,1 ,1 ,0 ,0 ,0 ,2 ,0 ,3 ,0 ,3,10234 , 0 
12601.771,13,8 ,1 ,256 ,0 ,0 ,2 ,0 ,0 ,0 ,0 ,2 ,0 ,1 ,0 ,1,6898 , 0 
12601.786,3,8 ,1 ,256 ,0 ,0 ,0 ,0 ,0 ,0 ,0 ,0 ,0 ,0 ,0 ,0,4994 , 0 
12720.96,8,8 ,1 ,256 ,0 ,0 ,0 ,0 ,1 ,0 ,0 ,1 ,0 ,3 ,1 ,4,5562 , 0 
12721.077,11,69 ,5 ,905 ,0 ,0 ,1 ,0 ,0 ,0 ,0 ,1 ,0 ,5 ,0 ,5,8973 , 0 
12721.127,2,8 ,1 ,256 ,0 ,0 ,23 ,0 ,71 ,0 ,0 ,94 ,98 ,20 ,71 ,189,10002 , 0 
12721.213,18,8 ,19 ,526 ,0 ,0 ,2 ,0 ,0 ,0 ,0 ,2 ,0 ,2 ,0 ,2,7222 , 0 
12721.235,4,8 ,8 ,573 ,0 ,0 ,3 ,1 ,0 ,1 ,0 ,5 ,0 ,0 ,0 ,0,6478 , 0 
12721.275,6,69 ,2 ,512 ,0 ,120 ,1 ,14 ,0 ,0 ,0 ,135 ,0 ,84 ,0 ,84,13354 , 1 
12721.29,7,69 ,16 ,777 ,0 ,0 ,0 ,17 ,0 ,0 ,0 ,17 ,0 ,44 ,0 ,44,13191 , 0 
12721.337,14,8 ,1 ,256 ,0 ,0 ,1 ,0 ,0 ,0 ,0 ,1 ,0 ,39 ,0 ,39,5902 , 0 
12721.35,15,69 ,7 ,1164 ,0 ,0 ,1 ,0 ,0 ,0 ,0 ,1 ,0 ,1 ,0 ,1,8087 , 0 
12721.36,20,8 ,12 ,1268 ,0 ,0 ,1 ,1 ,0 ,0 ,0 ,2 ,0 ,2 ,0 ,2,6768 , 0 
12721.361,16,69 ,2 ,512 ,0 ,0 ,25 ,13 ,44 ,0 ,0 ,82 ,100 ,35 ,44 ,179,18028 , 0 
12721.444,10,69 ,14 ,512 ,0 ,0 ,26 ,0 ,0 ,0 ,0 ,26 ,108 ,0 ,0 ,108,7036 , 0 
12721.481,12,8 ,5 ,907 ,0 ,0 ,2 ,0 ,1 ,0 ,0 ,3 ,0 ,1 ,1 ,2,7746 , 0 
12721.596,9,69 ,16 ,777 ,0 ,0 ,2 ,13 ,0 ,0 ,0 ,15 ,0 ,23 ,0 ,23,15202 , 0 
12721.609,5,8 ,19 ,526 ,0 ,0 ,1 ,0 ,1 ,0 ,0 ,2 ,0 ,21 ,1 ,22,12270 , 0 
12721.611,19,8 ,1 ,256 ,0 ,0 ,1 ,0 ,1 ,0 ,1 ,3 ,0 ,22 ,2 ,24,7807 , 0 
12721.697,17,69 ,16 ,777 ,0 ,0 ,25 ,16 ,0 ,0 ,0 ,41 ,101 ,21 ,0 ,122,9771 , 0 
12721.771,13,8 ,1 ,256 ,0 ,0 ,1 ,0 ,0 ,0 ,0 ,1 ,0 ,19 ,0 ,19,6720 , 0 
12721.786,3,8 ,1 ,256 ,0 ,0 ,2 ,0 ,0 ,0 ,0 ,2 ,0 ,0 ,0 ,0,4514 , 0 
12840.96,8,8 ,1 ,256 ,0 ,0 ,1 ,0 ,0 ,0 ,0 ,1 ,0 ,4 ,0 ,4,5503 , 0 
12841.077,11,69 ,5 ,905 ,0 ,0 ,3 ,0 ,0 ,0 ,0 ,3 ,0 ,1 ,0 ,1,9429 , 0 
12841.124,2,8 ,1 ,256 ,0 ,0 ,27 ,0 ,78 ,0 ,0 ,105 ,114 ,21 ,78 ,213,9868 , 0 
12841.213,18,8 ,19 ,526 ,0 ,0 ,1 ,0 ,0 ,0 ,0 ,1 ,0 ,6 ,0 ,6,8020 , 0 
12841.235,4,8 ,8 ,573 ,0 ,0 ,4 ,0 ,0 ,0 ,0 ,4 ,0 ,1 ,0 ,1,7026 , 0 
12841.277,6,69 ,2 ,512 ,0 ,120 ,1 ,16 ,0 ,0 ,0 ,137 ,0 ,90 ,0 ,90,12590 , 1 
12841.29,7,69 ,16 ,786 ,0 ,0 ,2 ,15 ,0 ,0 ,0 ,17 ,0 ,42 ,0 ,42,13110 , 0 
12841.337,14,8 ,1 ,256 ,0 ,0 ,1 ,0 ,0 ,0 ,0 ,1 ,0 ,39 ,0 ,39,6912 , 0 
12841.35,15,69 ,7 ,1164 ,0 ,0 ,1 ,0 ,0 ,0 ,0 ,1 ,0 ,1 ,0 ,1,9286 , 0 
12841.36,20,8 ,12 ,1268 ,0 ,0 ,2 ,0 ,0 ,0 ,0 ,2 ,0 ,0 ,0 ,0,7989 , 0 
12841.361,16,69 ,2 ,512 ,0 ,0 ,26 ,14 ,48 ,0 ,0 ,88 ,115 ,37 ,48 ,200,17358 , 0 
12841.444,10,69 ,14 ,512 ,0 ,0 ,25 ,0 ,0 ,0 ,0 ,25 ,108 ,0 ,0 ,108,6798 , 0 
12841.481,12,8 ,5 ,907 ,0 ,0 ,1 ,0 ,0 ,0 ,0 ,1 ,0 ,1 ,0 ,1,8338 , 0 
12841.596,9,69 ,16 ,786 ,0 ,0 ,1 ,18 ,0 ,0 ,0 ,19 ,0 ,25 ,0 ,25,14465 , 0 
12841.603,5,8 ,19 ,526 ,0 ,0 ,1 ,0 ,0 ,0 ,0 ,1 ,0 ,20 ,0 ,20,12512 , 0 
12841.606,19,8 ,1 ,256 ,0 ,0 ,1 ,0 ,0 ,1 ,0 ,2 ,0 ,23 ,0 ,23,8329 , 0 
12841.697,17,69 ,16 ,786 ,0 ,0 ,26 ,15 ,0 ,0 ,0 ,41 ,108 ,23 ,0 ,131,10665 , 0 
12841.771,13,8 ,1 ,256 ,0 ,0 ,1 ,0 ,0 ,0 ,0 ,1 ,0 ,20 ,0 ,20,7014 , 0 
12841.786,3,8 ,1 ,256 ,0 ,0 ,1 ,0 ,0 ,0 ,0 ,1 ,0 ,2 ,0 ,2,5072 , 0 
12960.96,8,8 ,1 ,256 ,0 ,0 ,1 ,0 ,0 ,0 ,0 ,1 ,0 ,1 ,0 ,1,5621 , 0 
12961.077,11,69 ,5 ,905 ,0 ,0 ,0 ,0 ,0 ,0 ,0 ,0 ,0 ,0 ,0 ,0,9092 , 0 
12961.124,2,8 ,1 ,256 ,0 ,0 ,25 ,0 ,84 ,0 ,0 ,109 ,102 ,21 ,84 ,207,10428 , 0 
12961.139,6,69 ,2 ,512 ,0 ,120 ,1 ,18 ,0 ,0 ,0 ,139 ,0 ,83 ,0 ,83,14256 , 1 
12961.214,18,8 ,19 ,526 ,0 ,0 ,1 ,0 ,0 ,0 ,0 ,1 ,0 ,0 ,0 ,0,7292 , 0 
12961.235,4,8 ,8 ,573 ,0 ,0 ,2 ,0 ,0 ,0 ,0 ,2 ,0 ,1 ,0 ,1,6541 , 0 
12961.29,7,69 ,16 ,789 ,0 ,0 ,1 ,19 ,0 ,0 ,0 ,20 ,0 ,47 ,0 ,47,13529 , 0 
12961.343,14,8 ,1 ,256 ,0 ,0 ,1 ,0 ,0 ,0 ,0 ,1 ,0 ,38 ,0 ,38,6010 , 0 
12961.35,15,69 ,7 ,1148 ,0 ,0 ,1 ,0 ,0 ,0 ,0 ,1 ,0 ,2 ,0 ,2,8212 , 0 
12961.36,20,8 ,12 ,1298 ,0 ,0 ,1 ,1 ,0 ,0 ,0 ,2 ,0 ,2 ,0 ,2,6851 , 0 
12961.371,16,69 ,2 ,534 ,0 ,0 ,26 ,14 ,53 ,0 ,0 ,93 ,98 ,36 ,53 ,187,18944 , 0 
12961.444,10,69 ,14 ,512 ,0 ,0 ,27 ,0 ,0 ,0 ,0 ,27 ,111 ,0 ,0 ,111,7309 , 0 
12961.481,12,8 ,5 ,907 ,0 ,0 ,1 ,0 ,1 ,0 ,0 ,2 ,0 ,1 ,1 ,2,7832 , 0 
12961.596,9,69 ,16 ,786 ,0 ,0 ,1 ,17 ,0 ,0 ,0 ,18 ,0 ,22 ,0 ,22,15509 , 0 
12961.603,5,8 ,19 ,526 ,0 ,0 ,1 ,0 ,1 ,0 ,0 ,2 ,0 ,22 ,1 ,23,12450 , 0 
12961.606,19,8 ,1 ,256 ,0 ,0 ,1 ,0 ,1 ,0 ,0 ,2 ,0 ,22 ,1 ,23,7952 , 0 
12961.697,17,69 ,16 ,786 ,0 ,0 ,25 ,18 ,0 ,0 ,0 ,43 ,103 ,23 ,0 ,126,10239 , 0 
12961.771,13,8 ,1 ,256 ,0 ,0 ,2 ,0 ,0 ,0 ,0 ,2 ,0 ,21 ,0 ,21,6836 , 0 
12961.786,3,8 ,1 ,256 ,0 ,0 ,1 ,0 ,0 ,0 ,0 ,1 ,0 ,0 ,0 ,0,4572 , 0 
13080.96,8,8 ,1 ,256 ,0 ,0 ,1 ,0 ,0 ,0 ,0 ,1 ,0 ,2 ,0 ,2,5579 , 0 
13081.077,11,69 ,5 ,905 ,0 ,0 ,1 ,0 ,0 ,0 ,0 ,1 ,0 ,2 ,0 ,2,9498 , 0 
13081.123,2,8 ,1 ,256 ,0 ,0 ,5 ,0 ,24 ,0 ,0 ,29 ,1 ,4 ,24 ,29,9991 , 0 
13081.138,6,69 ,2 ,512 ,0 ,0 ,2 ,4 ,0 ,0 ,0 ,6 ,0 ,19 ,0 ,19,12693 , 0 
13081.214,18,8 ,19 ,526 ,0 ,0 ,1 ,0 ,0 ,0 ,0 ,1 ,0 ,0 ,0 ,0,8091 , 0 
13081.235,4,8 ,8 ,573 ,0 ,0 ,0 ,0 ,0 ,0 ,0 ,0 ,0 ,1 ,0 ,1,7128 , 0 
13081.289,7,69 ,16 ,796 ,0 ,0 ,2 ,5 ,0 ,0 ,0 ,7 ,0 ,9 ,0 ,9,13210 , 0 
13081.337,14,8 ,1 ,256 ,0 ,0 ,1 ,0 ,0 ,0 ,0 ,1 ,0 ,8 ,0 ,8,6986 , 0 
13081.35,15,69 ,7 ,1148 ,0 ,0 ,1 ,0 ,0 ,0 ,0 ,1 ,0 ,1 ,0 ,1,9352 , 0 
13081.36,20,8 ,12 ,1298 ,0 ,0 ,2 ,0 ,0 ,0 ,0 ,2 ,0 ,0 ,0 ,0,8057 , 0 
13081.361,16,69 ,2 ,512 ,0 ,0 ,4 ,4 ,15 ,0 ,0 ,23 ,1 ,8 ,15 ,24,17598 , 0 
13081.444,10,69 ,14 ,512 ,0 ,0 ,5 ,0 ,0 ,0 ,0 ,5 ,1 ,1 ,0 ,2,6881 , 0 
13081.481,12,8 ,5 ,907 ,0 ,0 ,1 ,0 ,0 ,0 ,0 ,1 ,0 ,0 ,0 ,0,8402 , 0 
13081.596,9,69 ,16 ,796 ,0 ,0 ,0 ,5 ,0 ,0 ,0 ,5 ,0 ,6 ,0 ,6,14588 , 0 
13081.602,5,8 ,19 ,526 ,0 ,0 ,1 ,0 ,0 ,0 ,0 ,1 ,0 ,5 ,0 ,5,12586 , 0 
13081.606,19,8 ,1 ,256 ,0 ,0 ,1 ,0 ,0 ,0 ,0 ,1 ,0 ,5 ,0 ,5,8419 , 0 
13081.696,17,69 ,16 ,796 ,0 ,0 ,5 ,5 ,0 ,0 ,0 ,10 ,0 ,6 ,0 ,6,10797 , 0 
13081.771,13,8 ,1 ,256 ,0 ,0 ,1 ,0 ,0 ,0 ,0 ,1 ,0 ,6 ,0 ,6,7099 , 0 
13081.786,3,8 ,1 ,256 ,0 ,0 ,2 ,0 ,0 ,0 ,0 ,2 ,0 ,0 ,0 ,0,5141 , 0 
13200.96,8,8 ,1 ,256 ,0 ,0 ,1 ,0 ,0 ,0 ,0 ,1 ,0 ,2 ,0 ,2,5682 , 0 
13201.077,11,69 ,5 ,905 ,0 ,0 ,2 ,0 ,0 ,0 ,0 ,2 ,0 ,3 ,0 ,3,9190 , 0 
13201.123,2,8 ,1 ,256 ,0 ,0 ,3 ,0 ,8 ,0 ,0 ,11 ,0 ,3 ,8 ,11,10552 , 0 
13201.138,6,69 ,2 ,512 ,0 ,0 ,0 ,2 ,0 ,0 ,0 ,2 ,0 ,5 ,0 ,5,14318 , 0 
13201.214,18,8 ,19 ,526 ,0 ,0 ,2 ,0 ,0 ,0 ,0 ,2 ,0 ,3 ,0 ,3,7378 , 0 
13201.235,4,8 ,8 ,573 ,0 ,0 ,3 ,0 ,0 ,0 ,0 ,3 ,0 ,1 ,0 ,1,6619 , 0 
13201.289,7,69 ,16 ,781 ,0 ,0 ,1 ,1 ,0 ,0 ,0 ,2 ,0 ,4 ,0 ,4,13607 , 0 
13201.337,14,8 ,1 ,256 ,0 ,0 ,1 ,0 ,0 ,0 ,0 ,1 ,0 ,5 ,0 ,5,6096 , 0 
13201.35,15,69 ,7 ,1133 ,0 ,0 ,2 ,0 ,0 ,0 ,0 ,2 ,0 ,2 ,0 ,2,8280 , 0 
13201.36,20,8 ,12 ,1284 ,0 ,0 ,2 ,0 ,0 ,0 ,0 ,2 ,0 ,3 ,0 ,3,6922 , 0 
13201.36,16,69 ,2 ,512 ,0 ,0 ,2 ,2 ,4 ,0 ,0 ,8 ,0 ,3 ,4 ,7,19074 , 0 
13201.444,10,69 ,14 ,512 ,0 ,0 ,3 ,0 ,0 ,0 ,0 ,3 ,0 ,0 ,0 ,0,7378 , 0 
13201.481,12,8 ,5 ,907 ,0 ,0 ,1 ,0 ,0 ,0 ,0 ,1 ,0 ,4 ,0 ,4,7904 , 0 
13201.596,9,69 ,16 ,781 ,0 ,0 ,2 ,2 ,0 ,0 ,0 ,4 ,0 ,6 ,0 ,6,15615 , 0 
13201.602,5,8 ,19 ,526 ,0 ,0 ,1 ,0 ,0 ,0 ,0 ,1 ,0 ,4 ,0 ,4,12540 , 0 
13201.606,19,8 ,1 ,256 ,0 ,0 ,0 ,0 ,0 ,0 ,0 ,0 ,0 ,6 ,0 ,6,8049 , 0 
13201.696,17,69 ,16 ,781 ,0 ,0 ,1 ,1 ,0 ,0 ,0 ,2 ,0 ,2 ,0 ,2,10304 , 0 
13201.771,13,8 ,1 ,256 ,0 ,0 ,1 ,0 ,0 ,0 ,0 ,1 ,0 ,1 ,0 ,1,6918 , 0 
13201.786,3,8 ,1 ,256 ,0 ,0 ,1 ,0 ,0 ,0 ,0 ,1 ,0 ,0 ,0 ,0,4636 , 0 
13320.96,8,8 ,1 ,256 ,0 ,0 ,1 ,0 ,0 ,0 ,0 ,1 ,0 ,2 ,0 ,2,5640 , 0 
13321.077,11,69 ,5 ,905 ,0 ,0 ,1 ,0 ,0 ,0 ,0 ,1 ,0 ,5 ,0 ,5,9564 , 0 
13321.123,2,8 ,1 ,256 ,0 ,0 ,1 ,0 ,2 ,0 ,0 ,3 ,0 ,0 ,2 ,2,10053 , 0 
13321.138,6,69 ,2 ,512 ,0 ,0 ,1 ,0 ,0 ,0 ,0 ,1 ,0 ,2 ,0 ,2,12769 , 0 
13321.213,18,8 ,19 ,526 ,0 ,0 ,2 ,0 ,0 ,0 ,0 ,2 ,0 ,2 ,0 ,2,8157 , 0 
13321.235,4,8 ,8 ,539 ,0 ,0 ,1 ,0 ,0 ,0 ,0 ,1 ,0 ,2 ,0 ,2,7184 , 0 
13321.289,7,69 ,16 ,773 ,0 ,0 ,2 ,1 ,1 ,0 ,0 ,4 ,0 ,5 ,1 ,6,13298 , 0 
13321.337,14,8 ,1 ,256 ,0 ,0 ,1 ,0 ,0 ,0 ,0 ,1 ,0 ,1 ,0 ,1,7044 , 0 
13321.35,15,69 ,7 ,1109 ,0 ,0 ,1 ,1 ,0 ,0 ,0 ,2 ,0 ,2 ,0 ,2,9420 , 0 
13321.359,20,8 ,5 ,890 ,0 ,0 ,5 ,2 ,0 ,1 ,0 ,8 ,0 ,1 ,0 ,1,8173 , 0 
13321.36,16,69 ,2 ,512 ,0 ,0 ,1 ,0 ,2 ,0 ,0 ,3 ,0 ,2 ,2 ,4,17690 , 0 
13321.444,10,69 ,14 ,512 ,0 ,0 ,1 ,0 ,0 ,0 ,0 ,1 ,0 ,0 ,0 ,0,6943 , 0 
13321.481,12,8 ,5 ,907 ,0 ,0 ,2 ,0 ,1 ,0 ,1 ,4 ,0 ,5 ,2 ,7,8496 , 0 
13321.596,9,69 ,16 ,781 ,0 ,0 ,1 ,0 ,0 ,0 ,0 ,1 ,0 ,0 ,0 ,0,14652 , 0 
13321.602,5,8 ,19 ,526 ,0 ,0 ,0 ,0 ,2 ,0 ,1 ,3 ,0 ,8 ,3 ,11,12703 , 0 
13321.606,19,8 ,1 ,256 ,0 ,0 ,1 ,0 ,2 ,0 ,1 ,4 ,0 ,0 ,3 ,3,8502 , 0 
13321.696,17,69 ,16 ,781 ,0 ,0 ,2 ,0 ,0 ,0 ,0 ,2 ,0 ,1 ,0 ,1,10863 , 0 
13321.771,13,8 ,1 ,256 ,0 ,0 ,1 ,0 ,0 ,0 ,0 ,1 ,0 ,1 ,0 ,1,7164 , 0 
13321.786,3,8 ,1 ,256 ,0 ,0 ,1 ,0 ,0 ,0 ,0 ,1 ,0 ,0 ,0 ,0,5196 , 0 
13440.96,8,8 ,1 ,256 ,0 ,0 ,2 ,0 ,0 ,0 ,0 ,2 ,0 ,0 ,0 ,0,5795 , 0 
13441.078,11,69 ,5 ,840 ,0 ,0 ,5 ,3 ,3 ,0 ,0 ,11 ,0 ,19 ,3 ,22,9353 , 0 
13441.124,2,8 ,1 ,256 ,0 ,0 ,10 ,0 ,24 ,1 ,3 ,38 ,0 ,15 ,30 ,45,10765 , 0 
13441.139,6,69 ,2 ,514 ,0 ,0 ,10 ,5 ,14 ,0 ,0 ,29 ,0 ,20 ,14 ,34,14643 , 0 
13441.213,18,8 ,19 ,526 ,0 ,0 ,1 ,0 ,0 ,0 ,0 ,1 ,0 ,5 ,0 ,5,7458 , 0 
13441.235,4,8 ,8 ,533 ,0 ,0 ,2 ,0 ,0 ,0 ,0 ,2 ,0 ,1 ,0 ,1,6713 , 0 
13441.29,7,69 ,17 ,1130 ,0 ,0 ,11 ,9 ,0 ,2 ,0 ,22 ,0 ,24 ,1 ,25,13830 , 0 
13441.337,14,8 ,1 ,256 ,0 ,0 ,1 ,0 ,0 ,0 ,0 ,1 ,0 ,9 ,0 ,9,6161 , 0 
13441.35,15,69 ,11 ,1294 ,0 ,0 ,7 ,3 ,0 ,1 ,0 ,11 ,0 ,21 ,0 ,21,8469 , 0 
13441.359,20,8 ,5 ,840 ,0 ,0 ,3 ,3 ,0 ,0 ,0 ,6 ,0 ,7 ,0 ,7,7038 , 0 
13441.361,16,69 ,2 ,514 ,0 ,0 ,5 ,5 ,0 ,3 ,3 ,16 ,0 ,36 ,3 ,39,19286 , 1 
13441.444,10,69 ,14 ,512 ,0 ,0 ,3 ,0 ,0 ,0 ,0 ,3 ,0 ,7 ,0 ,7,7452 , 0 
13441.481,12,8 ,5 ,855 ,0 ,0 ,0 ,3 ,0 ,1 ,0 ,4 ,0 ,8 ,0 ,8,8048 , 0 
13441.596,9,69 ,5 ,885 ,0 ,0 ,11 ,3 ,0 ,1 ,0 ,15 ,0 ,25 ,0 ,25,15840 , 0 
13441.603,5,8 ,19 ,526 ,0 ,0 ,6 ,0 ,15 ,0 ,0 ,21 ,0 ,18 ,16 ,34,12860 , 0 
13441.606,19,8 ,1 ,256 ,0 ,0 ,2 ,0 ,15 ,0 ,0 ,17 ,0 ,11 ,15 ,26,8161 , 0 
13441.697,17,69 ,6 ,874 ,0 ,0 ,10 ,5 ,9 ,1 ,0 ,25 ,0 ,17 ,10 ,27,10551 , 0 
13441.771,13,8 ,1 ,256 ,0 ,0 ,1 ,0 ,0 ,0 ,0 ,1 ,0 ,8 ,0 ,8,7001 , 0 
13441.786,3,8 ,1 ,256 ,0 ,0 ,1 ,0 ,0 ,0 ,0 ,1 ,0 ,3 ,0 ,3,4702 , 0 
13560.96,8,8 ,1 ,256 ,0 ,0 ,1 ,0 ,0 ,0 ,0 ,1 ,0 ,1 ,0 ,1,5698 , 0 
13561.124,2,8 ,1 ,256 ,0 ,0 ,6 ,0 ,20 ,0 ,0 ,26 ,0 ,5 ,20 ,25,10226 , 0 
13561.138,6,69 ,2 ,515 ,0 ,0 ,5 ,5 ,10 ,0 ,0 ,20 ,0 ,14 ,10 ,24,12954 , 0 
13561.166,11,69 ,5 ,814 ,0 ,0 ,3 ,2 ,1 ,0 ,0 ,6 ,0 ,9 ,1 ,10,9667 , 0 
13561.213,18,8 ,19 ,526 ,0 ,0 ,0 ,0 ,0 ,0 ,0 ,0 ,0 ,5 ,0 ,5,8226 , 0 
13561.235,4,8 ,8 ,533 ,0 ,0 ,1 ,0 ,0 ,0 ,0 ,1 ,0 ,1 ,0 ,1,7266 , 0 
13561.29,7,69 ,17 ,1082 ,0 ,0 ,6 ,6 ,0 ,0 ,0 ,12 ,0 ,14 ,0 ,14,13457 , 0 
13561.337,14,8 ,1 ,256 ,0 ,0 ,0 ,0 ,0 ,0 ,0 ,0 ,0 ,5 ,0 ,5,7128 , 0 
13561.35,15,69 ,11 ,1204 ,0 ,0 ,2 ,1 ,0 ,0 ,0 ,3 ,0 ,12 ,0 ,12,9502 , 0 
13561.359,20,8 ,5 ,814 ,0 ,0 ,1 ,2 ,0 ,0 ,0 ,3 ,0 ,5 ,0 ,5,8248 , 0 
13561.36,16,69 ,2 ,515 ,0 ,0 ,2 ,5 ,0 ,0 ,0 ,7 ,0 ,21 ,0 ,21,17830 , 1 
13561.444,10,69 ,14 ,512 ,0 ,0 ,1 ,0 ,0 ,0 ,0 ,1 ,0 ,4 ,0 ,4,7033 , 0 
13561.481,12,8 ,5 ,814 ,0 ,0 ,2 ,1 ,0 ,0 ,0 ,3 ,0 ,5 ,0 ,5,8573 , 0 
13561.596,9,69 ,5 ,814 ,0 ,0 ,7 ,2 ,0 ,0 ,0 ,9 ,0 ,10 ,0 ,10,14767 , 0 
13561.603,5,8 ,19 ,526 ,0 ,0 ,4 ,0 ,8 ,0 ,0 ,12 ,0 ,11 ,8 ,19,12892 , 0 
13561.606,19,8 ,1 ,256 ,0 ,0 ,1 ,0 ,8 ,0 ,0 ,9 ,0 ,8 ,8 ,16,8638 , 0 
13561.697,17,69 ,6 ,807 ,0 ,0 ,9 ,4 ,6 ,0 ,0 ,19 ,0 ,10 ,6 ,16,11033 , 0 
13561.771,13,8 ,1 ,256 ,0 ,0 ,1 ,0 ,0 ,0 ,0 ,1 ,0 ,9 ,0 ,9,7265 , 0 
13561.786,3,8 ,1 ,256 ,0 ,0 ,1 ,0 ,0 ,0 ,0 ,1 ,0 ,0 ,0 ,0,5260 , 0 
13680.96,8,8 ,1 ,256 ,0 ,0 ,1 ,0 ,1 ,0 ,0 ,2 ,0 ,2 ,1 ,3,5864 , 0 
13681.077,11,69 ,5 ,814 ,0 ,0 ,0 ,0 ,1 ,0 ,0 ,1 ,0 ,6 ,1 ,7,9417 , 0 
13681.124,2,8 ,1 ,256 ,0 ,0 ,6 ,0 ,18 ,0 ,0 ,24 ,0 ,8 ,18 ,26,10887 , 0 
13681.138,6,69 ,2 ,512 ,0 ,0 ,6 ,5 ,9 ,0 ,0 ,20 ,0 ,11 ,9 ,20,14846 , 0 
13681.213,18,8 ,19 ,526 ,0 ,0 ,1 ,0 ,0 ,0 ,0 ,1 ,0 ,0 ,0 ,0,7518 , 0 
13681.235,4,8 ,8 ,533 ,0 ,0 ,1 ,1 ,0 ,0 ,0 ,2 ,0 ,2 ,0 ,2,6787 , 0 
13681.29,7,69 ,17 ,1035 ,0 ,0 ,7 ,5 ,0 ,0 ,0 ,12 ,0 ,12 ,0 ,12,13971 , 0 
13681.337,14,8 ,1 ,256 ,0 ,0 ,1 ,0 ,0 ,0 ,0 ,1 ,0 ,6 ,0 ,6,6229 , 0 
13681.35,15,69 ,11 ,1204 ,0 ,0 ,2 ,1 ,0 ,0 ,0 ,3 ,0 ,10 ,0 ,10,8543 , 0 
13681.359,20,8 ,5 ,814 ,0 ,0 ,1 ,0 ,0 ,0 ,0 ,1 ,0 ,1 ,0 ,1,7102 , 0 
13681.36,16,69 ,2 ,512 ,0 ,0 ,1 ,4 ,0 ,0 ,0 ,5 ,0 ,26 ,0 ,26,19406 , 1 
13681.444,10,69 ,14 ,512 ,0 ,0 ,1 ,0 ,0 ,0 ,0 ,1 ,0 ,5 ,0 ,5,7516 , 0 
13681.481,12,8 ,5 ,814 ,0 ,0 ,1 ,0 ,0 ,0 ,0 ,1 ,0 ,1 ,0 ,1,8114 , 0 
13681.596,9,69 ,5 ,814 ,0 ,0 ,5 ,0 ,0 ,0 ,0 ,5 ,0 ,9 ,0 ,9,15944 , 0 
13681.603,5,8 ,19 ,526 ,0 ,0 ,1 ,0 ,1 ,0 ,0 ,2 ,0 ,12 ,1 ,13,12962 , 0 
13681.606,19,8 ,1 ,256 ,0 ,0 ,1 ,0 ,1 ,0 ,0 ,2 ,0 ,5 ,1 ,6,8238 , 0 
13681.697,17,69 ,6 ,792 ,0 ,0 ,6 ,4 ,5 ,0 ,0 ,15 ,0 ,11 ,5 ,16,10697 , 0 
13681.771,13,8 ,1 ,256 ,0 ,0 ,1 ,0 ,0 ,0 ,0 ,1 ,0 ,5 ,0 ,5,7075 , 0 
13681.786,3,8 ,1 ,256 ,0 ,0 ,1 ,0 ,0 ,0 ,0 ,1 ,0 ,0 ,0 ,0,4752 , 0 
13800.96,8,8 ,1 ,256 ,0 ,0 ,0 ,0 ,0 ,0 ,0 ,0 ,0 ,1 ,0 ,1,5755 , 0 
13801.077,11,69 ,5 ,797 ,0 ,0 ,1 ,1 ,0 ,0 ,0 ,2 ,0 ,6 ,0 ,6,9749 , 0 
13801.123,2,8 ,1 ,256 ,0 ,0 ,3 ,0 ,4 ,0 ,0 ,7 ,0 ,3 ,4 ,7,10323 , 0 
13801.138,6,69 ,2 ,512 ,0 ,0 ,2 ,1 ,2 ,0 ,0 ,5 ,0 ,3 ,2 ,5,13071 , 0 
13801.213,18,8 ,19 ,526 ,0 ,0 ,3 ,0 ,0 ,0 ,0 ,3 ,0 ,2 ,0 ,2,8305 , 0 
13801.235,4,8 ,8 ,533 ,0 ,0 ,1 ,0 ,0 ,0 ,0 ,1 ,0 ,1 ,0 ,1,7321 , 0 
13801.289,7,69 ,17 ,1050 ,0 ,0 ,2 ,1 ,0 ,0 ,0 ,3 ,0 ,3 ,0 ,3,13546 , 0 
13801.337,14,8 ,1 ,256 ,0 ,0 ,1 ,0 ,0 ,0 ,0 ,1 ,0 ,4 ,0 ,4,7211 , 0 
13801.35,15,69 ,11 ,1204 ,0 ,0 ,2 ,0 ,0 ,0 ,0 ,2 ,0 ,3 ,0 ,3,9582 , 0 
13801.359,20,8 ,5 ,797 ,0 ,0 ,2 ,1 ,0 ,0 ,0 ,3 ,0 ,1 ,0 ,1,8319 , 0 
13801.36,16,69 ,2 ,512 ,0 ,0 ,1 ,1 ,0 ,0 ,0 ,2 ,0 ,7 ,0 ,7,17919 , 0 
13801.444,10,69 ,14 ,512 ,0 ,0 ,1 ,0 ,0 ,0 ,0 ,1 ,0 ,3 ,0 ,3,7123 , 0 
13801.481,12,8 ,5 ,797 ,0 ,0 ,0 ,1 ,0 ,0 ,0 ,1 ,0 ,4 ,0 ,4,8653 , 0 
13801.596,9,69 ,5 ,797 ,0 ,0 ,3 ,1 ,0 ,0 ,0 ,4 ,0 ,6 ,0 ,6,14886 , 0 
13801.602,5,8 ,19 ,526 ,0 ,0 ,2 ,0 ,4 ,0 ,0 ,6 ,0 ,5 ,4 ,9,13027 , 0 
13801.606,19,8 ,1 ,256 ,0 ,0 ,1 ,0 ,4 ,0 ,0 ,5 ,0 ,5 ,4 ,9,8730 , 0 
13801.696,17,69 ,6 ,789 ,0 ,0 ,2 ,1 ,1 ,0 ,0 ,4 ,0 ,2 ,1 ,3,11128 , 0 
13801.771,13,8 ,1 ,256 ,0 ,0 ,1 ,0 ,0 ,0 ,0 ,1 ,0 ,2 ,0 ,2,7340 , 0 
13801.786,3,8 ,1 ,256 ,0 ,0 ,2 ,0 ,0 ,0 ,0 ,2 ,0 ,0 ,0 ,0,5318 , 0 
13920.96,8,8 ,1 ,256 ,0 ,0 ,1 ,0 ,0 ,0 ,0 ,1 ,0 ,0 ,0 ,0,5928 , 0 
13921.077,11,69 ,5 ,797 ,0 ,0 ,2 ,0 ,1 ,0 ,0 ,3 ,0 ,1 ,1 ,2,9511 , 0 
13921.123,2,8 ,1 ,256 ,0 ,0 ,2 ,0 ,5 ,0 ,1 ,8 ,0 ,2 ,7 ,9,10993 , 0 
13921.138,6,69 ,2 ,512 ,0 ,0 ,2 ,1 ,2 ,1 ,1 ,7 ,0 ,5 ,4 ,9,14950 , 0 
13921.213,18,8 ,19 ,526 ,0 ,0 ,1 ,0 ,0 ,0 ,0 ,1 ,0 ,2 ,0 ,2,7604 , 0 
13921.235,4,8 ,8 ,533 ,0 ,0 ,1 ,0 ,0 ,0 ,0 ,1 ,0 ,1 ,0 ,1,6851 , 0 
13921.289,7,69 ,16 ,770 ,0 ,0 ,6 ,2 ,0 ,1 ,0 ,9 ,0 ,6 ,0 ,6,14087 , 0 
13921.337,14,8 ,1 ,256 ,0 ,0 ,1 ,0 ,0 ,0 ,0 ,1 ,0 ,3 ,0 ,3,6306 , 0 
13921.35,15,69 ,11 ,1140 ,0 ,0 ,1 ,1 ,0 ,0 ,0 ,2 ,0 ,7 ,0 ,7,8614 , 0 
13921.359,20,8 ,5 ,797 ,0 ,0 ,1 ,0 ,0 ,0 ,0 ,1 ,0 ,2 ,0 ,2,7178 , 0 
13921.36,16,69 ,2 ,512 ,0 ,0 ,2 ,1 ,1 ,0 ,0 ,4 ,0 ,8 ,1 ,9,19503 , 0 
13921.444,10,69 ,14 ,512 ,0 ,0 ,2 ,0 ,0 ,0 ,0 ,2 ,0 ,1 ,0 ,1,7578 , 0 
13921.481,12,8 ,5 ,797 ,0 ,0 ,1 ,0 ,0 ,0 ,0 ,1 ,0 ,3 ,0 ,3,8201 , 0 
13921.596,9,69 ,5 ,797 ,0 ,0 ,1 ,0 ,0 ,0 ,0 ,1 ,0 ,8 ,0 ,8,16028 , 0 
13921.602,5,8 ,19 ,526 ,0 ,0 ,1 ,0 ,1 ,0 ,0 ,2 ,0 ,3 ,1 ,4,13081 , 0 
13921.606,19,8 ,1 ,256 ,0 ,0 ,1 ,0 ,1 ,0 ,0 ,2 ,0 ,2 ,1 ,3,8362 , 0 
13921.696,17,69 ,6 ,775 ,0 ,0 ,2 ,1 ,1 ,1 ,1 ,6 ,0 ,7 ,2 ,9,10784 , 0 
13921.771,13,8 ,1 ,256 ,0 ,0 ,1 ,0 ,0 ,0 ,0 ,1 ,0 ,1 ,0 ,1,7152 , 0 
13921.786,3,8 ,1 ,256 ,0 ,0 ,1 ,0 ,0 ,0 ,0 ,1 ,0 ,2 ,0 ,2,4832 , 0 
14040.96,8,8 ,1 ,256 ,0 ,0 ,1 ,0 ,0 ,0 ,0 ,1 ,0 ,4 ,0 ,4,5819 , 0 
14041.077,11,69 ,5 ,797 ,0 ,0 ,1 ,0 ,1 ,0 ,0 ,2 ,0 ,2 ,1 ,3,9820 , 0 
14041.123,2,8 ,1 ,256 ,0 ,0 ,0 ,0 ,1 ,0 ,0 ,1 ,0 ,4 ,1 ,5,10415 , 0 
14041.138,6,69 ,2 ,512 ,0 ,0 ,2 ,0 ,1 ,0 ,0 ,3 ,0 ,2 ,1 ,3,13172 , 0 
14041.213,18,8 ,19 ,512 ,0 ,0 ,1 ,1 ,0 ,0 ,0 ,2 ,0 ,1 ,0 ,1,8376 , 0 
14041.235,4,8 ,8 ,533 ,0 ,0 ,1 ,0 ,0 ,0 ,0 ,1 ,0 ,2 ,0 ,2,7392 , 0 
14041.289,7,69 ,16 ,770 ,0 ,0 ,2 ,0 ,0 ,0 ,0 ,2 ,0 ,2 ,0 ,2,13611 , 0 
14041.337,14,8 ,1 ,256 ,0 ,0 ,1 ,0 ,0 ,0 ,0 ,1 ,0 ,1 ,0 ,1,7272 , 0 
14041.35,15,69 ,11 ,1116 ,0 ,0 ,1 ,1 ,0 ,0 ,0 ,2 ,0 ,3 ,0 ,3,9660 , 0 
14041.359,20,8 ,5 ,797 ,0 ,0 ,1 ,0 ,0 ,0 ,0 ,1 ,0 ,0 ,0 ,0,8391 , 0 
14041.36,16,69 ,2 ,512 ,0 ,0 ,1 ,0 ,0 ,0 ,0 ,1 ,0 ,3 ,0 ,3,17987 , 0 
14041.444,10,69 ,14 ,512 ,0 ,0 ,0 ,0 ,0 ,0 ,0 ,0 ,0 ,1 ,0 ,1,7174 , 0 
14041.481,12,8 ,5 ,797 ,0 ,0 ,2 ,0 ,0 ,0 ,0 ,2 ,0 ,0 ,0 ,0,8715 , 0 
14041.596,9,69 ,5 ,797 ,0 ,0 ,1 ,0 ,0 ,0 ,0 ,1 ,0 ,2 ,0 ,2,14949 , 0 
14041.602,5,8 ,19 ,512 ,0 ,0 ,1 ,1 ,1 ,0 ,0 ,3 ,0 ,2 ,1 ,3,13123 , 0 
14041.606,19,8 ,1 ,256 ,0 ,0 ,2 ,0 ,3 ,0 ,0 ,5 ,0 ,2 ,3 ,5,8811 , 0 
14041.696,17,69 ,6 ,772 ,0 ,0 ,1 ,1 ,0 ,0 ,0 ,2 ,0 ,3 ,0 ,3,11204 , 0 
14041.771,13,8 ,1 ,256 ,0 ,0 ,1 ,0 ,0 ,0 ,0 ,1 ,0 ,1 ,0 ,1,7410 , 0 
14041.786,3,8 ,1 ,256 ,0 ,0 ,2 ,0 ,0 ,0 ,0 ,2 ,0 ,0 ,0 ,0,5382 , 0 
14160.96,8,8 ,1 ,256 ,0 ,0 ,1 ,0 ,0 ,0 ,0 ,1 ,0 ,2 ,0 ,2,5999 , 0 
14161.077,11,69 ,5 ,772 ,0 ,0 ,1 ,1 ,0 ,0 ,0 ,2 ,0 ,2 ,0 ,2,9581 , 0 
14161.123,2,8 ,1 ,256 ,0 ,0 ,3 ,0 ,1 ,0 ,0 ,4 ,0 ,2 ,1 ,3,11093 , 0 
14161.138,6,69 ,2 ,512 ,0 ,0 ,0 ,1 ,0 ,0 ,0 ,1 ,0 ,3 ,0 ,3,15028 , 0 
14161.213,18,8 ,19 ,512 ,0 ,0 ,0 ,1 ,0 ,0 ,0 ,1 ,0 ,1 ,0 ,1,7671 , 0 
14161.235,4,8 ,8 ,533 ,0 ,0 ,1 ,0 ,0 ,0 ,0 ,1 ,0 ,0 ,0 ,0,6924 , 0 
14161.289,7,69 ,16 ,770 ,0 ,0 ,1 ,0 ,0 ,0 ,0 ,1 ,0 ,3 ,0 ,3,14163 , 0 
14161.337,14,8 ,1 ,256 ,0 ,0 ,1 ,0 ,0 ,0 ,0 ,1 ,0 ,3 ,0 ,3,6393 , 0 
14161.35,15,69 ,11 ,1116 ,0 ,0 ,1 ,0 ,0 ,0 ,0 ,1 ,0 ,2 ,0 ,2,8681 , 0 
14161.359,20,8 ,5 ,797 ,0 ,0 ,1 ,0 ,0 ,0 ,0 ,1 ,0 ,1 ,0 ,1,7237 , 0 
14161.36,16,69 ,2 ,512 ,0 ,0 ,1 ,0 ,0 ,0 ,0 ,1 ,0 ,4 ,0 ,4,19589 , 1 
14161.444,10,69 ,14 ,512 ,0 ,0 ,2 ,0 ,0 ,0 ,0 ,2 ,0 ,0 ,0 ,0,7656 , 0 
14161.481,12,8 ,5 ,797 ,0 ,0 ,1 ,0 ,0 ,0 ,0 ,1 ,0 ,2 ,0 ,2,8278 , 0 
14161.596,9,69 ,5 ,772 ,0 ,0 ,2 ,1 ,0 ,0 ,0 ,3 ,0 ,2 ,0 ,2,16125 , 0 
14161.602,5,8 ,19 ,512 ,0 ,0 ,2 ,0 ,2 ,0 ,0 ,4 ,0 ,3 ,2 ,5,13196 , 0 
14161.606,19,8 ,1 ,256 ,0 ,0 ,2 ,0 ,3 ,0 ,0 ,5 ,0 ,3 ,3 ,6,8448 , 0 
14161.696,17,69 ,6 ,772 ,0 ,0 ,2 ,0 ,0 ,0 ,0 ,2 ,0 ,1 ,0 ,1,10857 , 0 
14161.771,13,8 ,1 ,256 ,0 ,0 ,1 ,0 ,0 ,0 ,0 ,1 ,0 ,4 ,0 ,4,7234 , 0 
14161.786,3,8 ,1 ,256 ,0 ,0 ,2 ,0 ,0 ,0 ,0 ,2 ,0 ,1 ,0 ,1,4900 , 0 
14280.96,8,8 ,1 ,256 ,0 ,0 ,1 ,0 ,0 ,0 ,0 ,1 ,0 ,1 ,0 ,1,5903 , 0 
14281.077,11,69 ,5 ,772 ,0 ,0 ,0 ,0 ,0 ,0 ,0 ,0 ,0 ,2 ,0 ,2,9899 , 0 
14281.123,2,8 ,1 ,256 ,0 ,0 ,1 ,0 ,2 ,0 ,1 ,4 ,0 ,3 ,3 ,6,10491 , 0 
14281.138,6,69 ,2 ,512 ,0 ,0 ,2 ,0 ,2 ,0 ,0 ,4 ,0 ,2 ,2 ,4,13241 , 0 
14281.213,18,8 ,19 ,512 ,0 ,0 ,2 ,0 ,0 ,0 ,0 ,2 ,0 ,2 ,0 ,2,8546 , 0 
14281.235,4,8 ,8 ,533 ,0 ,0 ,1 ,0 ,0 ,0 ,0 ,1 ,0 ,1 ,0 ,1,7474 , 0 
14281.289,7,69 ,17 ,1028 ,0 ,0 ,4 ,1 ,0 ,1 ,0 ,6 ,0 ,2 ,0 ,2,13701 , 0 
14281.337,14,8 ,1 ,256 ,0 ,0 ,2 ,0 ,0 ,0 ,0 ,2 ,0 ,2 ,0 ,2,7346 , 0 
14281.35,15,69 ,11 ,1116 ,0 ,0 ,2 ,0 ,0 ,0 ,0 ,2 ,0 ,3 ,0 ,3,9736 , 0 
14281.359,20,8 ,5 ,797 ,0 ,0 ,2 ,0 ,0 ,0 ,0 ,2 ,0 ,0 ,0 ,0,8457 , 0 
14281.36,16,69 ,2 ,512 ,0 ,0 ,2 ,0 ,0 ,0 ,1 ,3 ,0 ,3 ,1 ,4,18067 , 1 
14281.444,10,69 ,14 ,512 ,0 ,0 ,1 ,0 ,0 ,0 ,0 ,1 ,0 ,0 ,0 ,0,7232 , 0 
14281.481,12,8 ,5 ,797 ,0 ,0 ,1 ,0 ,0 ,0 ,0 ,1 ,0 ,0 ,0 ,0,8797 , 0 
14281.596,9,69 ,5 ,772 ,0 ,0 ,1 ,0 ,0 ,0 ,0 ,1 ,0 ,5 ,0 ,5,15042 , 0 
14281.602,5,8 ,19 ,512 ,0 ,0 ,1 ,0 ,0 ,0 ,0 ,1 ,0 ,2 ,0 ,2,13240 , 0 
14281.606,19,8 ,1 ,256 ,0 ,0 ,1 ,0 ,0 ,0 ,0 ,1 ,0 ,1 ,0 ,1,8945 , 0 
14281.696,17,69 ,6 ,769 ,0 ,0 ,1 ,1 ,1 ,0 ,0 ,3 ,0 ,4 ,1 ,5,11267 , 0 
14281.771,13,8 ,1 ,256 ,0 ,0 ,1 ,0 ,0 ,0 ,0 ,1 ,0 ,0 ,0 ,0,7485 , 0 
14281.786,3,8 ,1 ,256 ,0 ,0 ,0 ,0 ,0 ,0 ,0 ,0 ,0 ,1 ,0 ,1,5433 , 0 
14400.96,8,8 ,1 ,256 ,0 ,0 ,1 ,0 ,0 ,0 ,0 ,1 ,0 ,0 ,0 ,0,6066 , 0 
14401.077,11,69 ,5 ,772 ,0 ,0 ,2 ,0 ,1 ,0 ,0 ,3 ,0 ,2 ,1 ,3,9657 , 0 
14401.123,2,8 ,1 ,256 ,0 ,0 ,1 ,0 ,0 ,0 ,0 ,1 ,0 ,0 ,1 ,1,11180 , 0 
14401.138,6,69 ,2 ,512 ,0 ,0 ,1 ,0 ,0 ,0 ,0 ,1 ,0 ,2 ,0 ,2,15123 , 0 
14401.213,18,8 ,19 ,512 ,0 ,0 ,1 ,0 ,0 ,0 ,0 ,1 ,0 ,2 ,0 ,2,7807 , 0 
14401.235,4,8 ,8 ,533 ,0 ,0 ,2 ,0 ,0 ,0 ,0 ,2 ,0 ,1 ,0 ,1,7013 , 0 
14401.289,7,69 ,17 ,1028 ,0 ,0 ,3 ,0 ,0 ,0 ,0 ,3 ,0 ,1 ,0 ,1,14235 , 0 
14401.337,14,8 ,1 ,256 ,0 ,0 ,0 ,0 ,0 ,0 ,0 ,0 ,0 ,1 ,0 ,1,6461 , 0 
14401.35,15,69 ,11 ,1091 ,0 ,0 ,2 ,1 ,0 ,0 ,0 ,3 ,0 ,4 ,0 ,4,8768 , 0 
14401.359,20,8 ,5 ,797 ,0 ,0 ,1 ,0 ,0 ,0 ,0 ,1 ,0 ,3 ,0 ,3,7292 , 0 
14401.36,16,69 ,2 ,512 ,0 ,0 ,1 ,0 ,0 ,1 ,0 ,2 ,0 ,5 ,0 ,5,19661 , 1 
14401.444,10,69 ,14 ,512 ,0 ,0 ,1 ,0 ,0 ,0 ,0 ,1 ,0 ,1 ,0 ,1,7707 , 0 
14401.481,12,8 ,5 ,797 ,0 ,0 ,2 ,0 ,0 ,0 ,0 ,2 ,0 ,2 ,0 ,2,8347 , 0 
14401.596,9,69 ,5 ,768 ,0 ,0 ,1 ,1 ,0 ,0 ,0 ,2 ,0 ,5 ,0 ,5,16208 , 0 
14401.602,5,8 ,19 ,512 ,0 ,0 ,1 ,0 ,2 ,0 ,0 ,3 ,0 ,4 ,2 ,6,13298 , 0 
14401.606,19,8 ,1 ,256 ,0 ,0 ,1 ,0 ,2 ,0 ,0 ,3 ,0 ,1 ,2 ,3,8524 , 0 
14401.696,17,69 ,6 ,769 ,0 ,0 ,1 ,0 ,0 ,0 ,0 ,1 ,0 ,3 ,0 ,3,10922 , 0 
14401.771,13,8 ,1 ,256 ,0 ,0 ,1 ,0 ,0 ,0 ,0 ,1 ,0 ,1 ,0 ,1,7303 , 0 
14401.786,3,8 ,1 ,256 ,0 ,0 ,2 ,0 ,0 ,0 ,0 ,2 ,0 ,0 ,0 ,0,4971 , 0 
14520.96,8,8 ,1 ,256 ,0 ,0 ,2 ,0 ,0 ,0 ,0 ,2 ,0 ,2 ,0 ,2,5966 , 0 
14521.077,11,69 ,5 ,772 ,0 ,0 ,2 ,0 ,0 ,0 ,0 ,2 ,0 ,2 ,0 ,2,9974 , 0 
14521.123,2,8 ,1 ,256 ,0 ,0 ,2 ,0 ,1 ,0 ,0 ,3 ,0 ,1 ,1 ,2,10570 , 0 
14521.138,6,69 ,2 ,512 ,0 ,0 ,1 ,0 ,0 ,0 ,0 ,1 ,0 ,1 ,0 ,1,13302 , 0 
14521.213,18,8 ,19 ,512 ,0 ,0 ,1 ,0 ,0 ,0 ,0 ,1 ,0 ,0 ,0 ,0,8619 , 0 
14521.235,4,8 ,8 ,519 ,0 ,0 ,1 ,0 ,0 ,0 ,0 ,1 ,0 ,1 ,0 ,1,7534 , 0 
14521.289,7,69 ,17 ,1028 ,0 ,0 ,2 ,0 ,0 ,0 ,0 ,2 ,0 ,2 ,0 ,2,13770 , 0 
14521.337,14,8 ,1 ,256 ,0 ,0 ,1 ,0 ,0 ,0 ,0 ,1 ,0 ,3 ,0 ,3,7409 , 0 
14521.35,15,69 ,11 ,1091 ,0 ,0 ,1 ,0 ,0 ,0 ,0 ,1 ,0 ,2 ,0 ,2,9788 , 0 
14521.359,20,8 ,5 ,797 ,0 ,0 ,1 ,0 ,0 ,0 ,0 ,1 ,0 ,0 ,0 ,0,8528 , 0 
14521.36,16,69 ,2 ,512 ,0 ,0 ,1 ,1 ,0 ,0 ,0 ,2 ,0 ,3 ,0 ,3,18154 , 0 
14521.444,10,69 ,14 ,512 ,0 ,0 ,1 ,0 ,0 ,0 ,0 ,1 ,0 ,0 ,0 ,0,7305 , 0 
14521.481,12,8 ,5 ,797 ,0 ,0 ,1 ,0 ,0 ,0 ,0 ,1 ,0 ,1 ,0 ,1,8892 , 0 
14521.596,9,69 ,5 ,768 ,0 ,0 ,2 ,0 ,0 ,0 ,0 ,2 ,0 ,5 ,0 ,5,15112 , 0 
14521.602,5,8 ,19 ,512 ,0 ,0 ,1 ,1 ,0 ,0 ,0 ,2 ,0 ,3 ,0 ,3,13335 , 0 
14521.606,19,8 ,1 ,256 ,0 ,0 ,2 ,0 ,1 ,0 ,0 ,3 ,0 ,4 ,1 ,5,9036 , 0 
14521.696,17,69 ,6 ,768 ,0 ,0 ,0 ,0 ,0 ,0 ,0 ,0 ,0 ,2 ,0 ,2,11333 , 0 
14521.771,13,8 ,1 ,256 ,0 ,0 ,1 ,0 ,0 ,0 ,0 ,1 ,0 ,3 ,0 ,3,7558 , 0 
14521.786,3,8 ,1 ,256 ,0 ,0 ,1 ,0 ,0 ,0 ,0 ,1 ,0 ,2 ,0 ,2,5485 , 0 
14640.96,8,8 ,1 ,256 ,0 ,0 ,1 ,0 ,1 ,0 ,0 ,2 ,0 ,1 ,1 ,2,6126 , 0 
14641.077,11,69 ,5 ,772 ,0 ,0 ,1 ,0 ,0 ,0 ,0 ,1 ,0 ,1 ,0 ,1,9723 , 0 
14641.123,2,8 ,1 ,256 ,0 ,0 ,1 ,0 ,2 ,0 ,0 ,3 ,0 ,4 ,2 ,6,11260 , 0 
14641.138,6,69 ,2 ,512 ,0 ,0 ,2 ,0 ,2 ,0 ,0 ,4 ,0 ,3 ,2 ,5,15214 , 0 
14641.213,18,8 ,19 ,512 ,0 ,0 ,1 ,0 ,0 ,0 ,0 ,1 ,0 ,1 ,0 ,1,7877 , 0 
14641.235,4,8 ,8 ,519 ,0 ,0 ,1 ,1 ,0 ,0 ,0 ,2 ,0 ,1 ,0 ,1,7073 , 0 
14641.289,7,69 ,17 ,1024 ,0 ,0 ,1 ,2 ,0 ,0 ,0 ,3 ,0 ,2 ,0 ,2,14317 , 0 
14641.337,14,8 ,1 ,256 ,0 ,0 ,1 ,0 ,0 ,0 ,0 ,1 ,0 ,0 ,0 ,0,6533 , 0 
14641.35,15,69 ,11 ,1091 ,0 ,0 ,1 ,0 ,0 ,0 ,0 ,1 ,0 ,1 ,0 ,1,8840 , 0 
14641.359,20,8 ,5 ,797 ,0 ,0 ,1 ,0 ,0 ,0 ,0 ,1 ,0 ,1 ,0 ,1,7367 , 0 
14641.36,16,69 ,2 ,512 ,0 ,0 ,1 ,0 ,0 ,0 ,0 ,1 ,0 ,4 ,0 ,4,19745 , 0 
14641.444,10,69 ,14 ,512 ,0 ,0 ,1 ,0 ,0 ,0 ,0 ,1 ,0 ,1 ,0 ,1,7769 , 0 
14641.481,12,8 ,5 ,797 ,0 ,0 ,1 ,0 ,0 ,0 ,0 ,1 ,0 ,1 ,0 ,1,8415 , 0 
14641.596,9,69 ,5 ,768 ,0 ,0 ,1 ,0 ,0 ,0 ,0 ,1 ,0 ,0 ,0 ,0,16282 , 0 
14641.602,5,8 ,19 ,512 ,0 ,0 ,1 ,0 ,0 ,0 ,0 ,1 ,0 ,1 ,0 ,1,13403 , 0 
14641.606,19,8 ,1 ,256 ,0 ,0 ,1 ,0 ,0 ,0 ,0 ,1 ,0 ,1 ,0 ,1,8618 , 0 
14641.696,17,69 ,6 ,768 ,0 ,0 ,3 ,0 ,2 ,0 ,0 ,5 ,0 ,2 ,2 ,4,11009 , 0 
14641.771,13,8 ,1 ,256 ,0 ,0 ,1 ,0 ,0 ,0 ,0 ,1 ,0 ,1 ,0 ,1,7381 , 0 
14641.786,3,8 ,1 ,256 ,0 ,0 ,1 ,0 ,0 ,0 ,0 ,1 ,0 ,0 ,0 ,0,5021 , 0 
14760.96,8,8 ,1 ,256 ,0 ,0 ,1 ,0 ,0 ,0 ,0 ,1 ,0 ,1 ,0 ,1,6047 , 0 
14761.078,11,69 ,5 ,772 ,0 ,0 ,0 ,0 ,0 ,0 ,0 ,0 ,0 ,1 ,0 ,1,10042 , 0 
14761.123,2,8 ,1 ,256 ,0 ,0 ,1 ,0 ,1 ,0 ,0 ,2 ,0 ,0 ,1 ,1,10641 , 0 
14761.138,6,69 ,2 ,512 ,0 ,0 ,2 ,0 ,1 ,0 ,0 ,3 ,0 ,2 ,1 ,3,13399 , 0 
14761.213,18,8 ,19 ,512 ,0 ,0 ,0 ,0 ,0 ,0 ,0 ,0 ,0 ,2 ,0 ,2,8676 , 0 
14761.235,4,8 ,8 ,519 ,0 ,0 ,2 ,0 ,0 ,0 ,0 ,2 ,0 ,1 ,0 ,1,7638 , 0 
14761.289,7,69 ,17 ,1024 ,0 ,0 ,1 ,0 ,0 ,0 ,0 ,1 ,0 ,1 ,0 ,1,13846 , 0 
14761.337,14,8 ,1 ,256 ,0 ,0 ,1 ,0 ,0 ,0 ,0 ,1 ,0 ,1 ,0 ,1,7465 , 0 
14761.35,15,69 ,11 ,1091 ,0 ,0 ,1 ,0 ,0 ,0 ,0 ,1 ,0 ,0 ,0 ,0,9872 , 0 
14761.359,20,8 ,5 ,797 ,0 ,0 ,0 ,0 ,0 ,0 ,0 ,0 ,0 ,1 ,0 ,1,8577 , 0 
14761.36,16,69 ,2 ,512 ,0 ,0 ,1 ,0 ,0 ,0 ,0 ,1 ,0 ,1 ,0 ,1,18218 , 0 
14761.444,10,69 ,14 ,512 ,0 ,0 ,2 ,0 ,0 ,0 ,0 ,2 ,0 ,1 ,0 ,1,7365 , 0 
14761.481,12,8 ,5 ,797 ,0 ,0 ,2 ,0 ,0 ,0 ,0 ,2 ,0 ,0 ,0 ,0,8968 , 0 
14761.596,9,69 ,5 ,768 ,0 ,0 ,1 ,0 ,0 ,0 ,0 ,1 ,0 ,1 ,0 ,1,15206 , 0 
14761.602,5,8 ,19 ,512 ,0 ,0 ,0 ,0 ,0 ,0 ,0 ,0 ,0 ,2 ,0 ,2,13425 , 0 
14761.613,19,8 ,1 ,256 ,0 ,0 ,2 ,0 ,0 ,0 ,0 ,2 ,0 ,1 ,0 ,1,9110 , 0 
14761.696,17,69 ,6 ,768 ,0 ,0 ,1 ,1 ,0 ,0 ,0 ,2 ,0 ,1 ,0 ,1,11410 , 0 
14761.771,13,8 ,1 ,256 ,0 ,0 ,0 ,0 ,0 ,0 ,0 ,0 ,0 ,1 ,0 ,1,7621 , 0 
14761.786,3,8 ,1 ,256 ,0 ,0 ,0 ,0 ,0 ,0 ,0 ,0 ,0 ,1 ,0 ,1,5546 , 0 
14880.96,8,8 ,1 ,256 ,0 ,0 ,1 ,0 ,0 ,0 ,0 ,1 ,0 ,1 ,0 ,1,6190 , 0 
14881.078,11,85 ,5 ,861 ,0 ,0 ,9 ,7 ,0 ,10 ,0 ,26 ,0 ,15 ,1 ,16,10074 , 0 
14881.124,2,8 ,1 ,256 ,0 ,0 ,6 ,0 ,14 ,0 ,12 ,32 ,0 ,18 ,31 ,49,11505 , 0 
14881.138,6,85 ,2 ,537 ,0 ,0 ,9 ,6 ,1 ,11 ,1 ,28 ,0 ,22 ,9 ,31,15594 , 0 
14881.213,18,8 ,19 ,512 ,0 ,0 ,0 ,0 ,0 ,0 ,0 ,0 ,0 ,6 ,0 ,6,7958 , 0 
14881.235,4,8 ,8 ,519 ,0 ,0 ,1 ,0 ,0 ,0 ,0 ,1 ,0 ,0 ,0 ,0,7138 , 0 
14881.337,14,8 ,1 ,256 ,0 ,0 ,7 ,0 ,3 ,0 ,2 ,12 ,0 ,11 ,6 ,17,6721 , 0 
14881.352,15,87 ,9 ,1416 ,0 ,0 ,7 ,2 ,1 ,5 ,1 ,16 ,0 ,13 ,2 ,15,9102 , 0 
14881.359,20,8 ,5 ,861 ,0 ,0 ,2 ,5 ,0 ,0 ,0 ,7 ,0 ,9 ,0 ,9,7496 , 0 
14881.365,16,87 ,2 ,512 ,0 ,0 ,10 ,5 ,12 ,7 ,4 ,38 ,0 ,25 ,27 ,52,20219 , 0 
14881.374,7,90 ,17 ,65535 ,0 ,0 ,11 ,0 ,11 ,1 ,1 ,24 ,0 ,16 ,15 ,31,14520 , 1 
14881.444,10,85 ,14 ,512 ,0 ,0 ,9 ,6 ,0 ,6 ,0 ,21 ,0 ,11 ,0 ,11,8016 , 0 
14881.481,12,8 ,5 ,861 ,0 ,0 ,0 ,4 ,0 ,0 ,0 ,4 ,0 ,11 ,0 ,11,8537 , 0 
14881.604,9,89 ,5 ,861 ,0 ,0 ,10 ,4 ,5 ,8 ,5 ,32 ,0 ,24 ,18 ,42,16711 , 0 
14881.606,19,8 ,1 ,256 ,0 ,0 ,0 ,0 ,0 ,0 ,1 ,1 ,0 ,11 ,1 ,12,8729 , 0 
14881.615,5,8 ,13 ,512 ,0 ,0 ,8 ,3 ,19 ,2 ,10 ,42 ,0 ,14 ,32 ,46,13932 , 0 
14881.697,17,85 ,16 ,998 ,0 ,0 ,9 ,1 ,8 ,7 ,0 ,25 ,0 ,21 ,15 ,36,11284 , 0 
14881.771,13,8 ,1 ,256 ,0 ,0 ,1 ,0 ,12 ,0 ,3 ,16 ,0 ,14 ,15 ,29,7581 , 0 
14881.786,3,8 ,1 ,256 ,0 ,0 ,1 ,0 ,0 ,0 ,0 ,1 ,0 ,6 ,0 ,6,5090 , 0 
15000.96,8,8 ,1 ,256 ,0 ,0 ,1 ,0 ,0 ,0 ,0 ,1 ,0 ,0 ,0 ,0,6111 , 0 
15001.078,11,8 ,5 ,912 ,0 ,0 ,17 ,9 ,3 ,16 ,3 ,48 ,0 ,45 ,9 ,54,10618 , 0 
15001.124,2,8 ,1 ,256 ,0 ,0 ,16 ,0 ,10 ,5 ,8 ,39 ,0 ,39 ,26 ,65,10951 , 0 
15001.139,6,8 ,2 ,512 ,0 ,0 ,18 ,10 ,4 ,17 ,2 ,51 ,0 ,49 ,12 ,61,14044 , 0 
15001.214,18,8 ,19 ,512 ,0 ,0 ,0 ,0 ,2 ,0 ,1 ,3 ,0 ,15 ,3 ,18,8803 , 0 
15001.235,4,8 ,8 ,519 ,0 ,0 ,1 ,0 ,0 ,0 ,0 ,1 ,0 ,0 ,0 ,0,7716 , 0 
15001.29,7,11 ,16 ,65535 ,0 ,0 ,19 ,1 ,0 ,2 ,0 ,22 ,0 ,50 ,2 ,52,14138 , 1 
15001.337,14,8 ,1 ,256 ,0 ,0 ,7 ,0 ,4 ,0 ,5 ,16 ,0 ,21 ,11 ,32,7618 , 0 
15001.35,15,8 ,0 ,0 ,0 ,0 ,16 ,4 ,0 ,9 ,0 ,29 ,0 ,42 ,0 ,42,10295 , 0 
15001.36,20,8 ,5 ,926 ,0 ,0 ,7 ,9 ,0 ,0 ,0 ,16 ,0 ,29 ,1 ,30,8868 , 0 
15001.381,16,8 ,7 ,65535 ,0 ,0 ,20 ,9 ,6 ,14 ,1 ,50 ,0 ,56 ,25 ,81,18846 , 0 
15001.444,10,8 ,0 ,0 ,0 ,0 ,17 ,8 ,0 ,13 ,0 ,38 ,0 ,24 ,0 ,24,7775 , 0 
15001.482,12,8 ,18 ,828 ,0 ,0 ,8 ,2 ,1 ,1 ,1 ,13 ,0 ,27 ,3 ,30,9178 , 0 
15001.596,9,8 ,16 ,768 ,0 ,0 ,17 ,8 ,6 ,12 ,0 ,43 ,0 ,65 ,24 ,89,15754 , 0 
15001.603,5,8 ,13 ,512 ,0 ,0 ,14 ,0 ,30 ,1 ,14 ,59 ,0 ,42 ,54 ,96,14025 , 0 
15001.606,19,8 ,1 ,256 ,0 ,0 ,1 ,0 ,2 ,1 ,1 ,5 ,0 ,21 ,3 ,24,9232 , 0 
15001.697,17,8 ,7 ,1033 ,0 ,0 ,20 ,4 ,0 ,7 ,0 ,31 ,0 ,38 ,2 ,40,11846 , 0 
15001.771,13,8 ,1 ,256 ,0 ,0 ,1 ,0 ,29 ,1 ,14 ,45 ,0 ,22 ,44 ,66,7808 , 0 
15001.786,3,8 ,1 ,256 ,0 ,0 ,1 ,0 ,0 ,0 ,0 ,1 ,0 ,6 ,0 ,6,5603 , 0 
15120.96,8,47 ,1 ,256 ,0 ,0 ,14 ,8 ,6 ,7 ,3 ,38 ,0 ,31 ,12 ,43,6511 , 0 
15121.078,11,46 ,5 ,870 ,0 ,0 ,21 ,0 ,0 ,4 ,0 ,25 ,0 ,74 ,0 ,74,10354 , 0 
15121.128,2,50 ,1 ,256 ,0 ,0 ,17 ,5 ,4 ,9 ,1 ,36 ,0 ,62 ,19 ,81,11842 , 0 
15121.138,6,50 ,2 ,512 ,0 ,0 ,18 ,2 ,1 ,5 ,0 ,26 ,0 ,43 ,4 ,47,15908 , 0 
15121.214,18,47 ,19 ,512 ,0 ,0 ,16 ,3 ,1 ,7 ,1 ,28 ,0 ,33 ,3 ,36,8317 , 0 
15121.236,4,47 ,19 ,512 ,0 ,0 ,13 ,7 ,0 ,7 ,0 ,27 ,0 ,27 ,1 ,28,7505 , 0 
15121.29,7,53 ,16 ,65535 ,0 ,0 ,21 ,0 ,0 ,0 ,0 ,21 ,0 ,50 ,4 ,54,14766 , 1 
15121.338,14,47 ,1 ,256 ,0 ,0 ,13 ,6 ,4 ,6 ,4 ,33 ,0 ,36 ,10 ,46,6980 , 0 
15121.35,15,50 ,7 ,1280 ,0 ,0 ,17 ,1 ,0 ,1 ,0 ,19 ,0 ,48 ,0 ,48,9333 , 0 
15121.36,20,47 ,5 ,870 ,0 ,0 ,19 ,4 ,0 ,2 ,0 ,25 ,0 ,40 ,0 ,40,7732 , 0 
15121.361,16,50 ,2 ,512 ,0 ,0 ,21 ,1 ,0 ,3 ,0 ,25 ,0 ,53 ,1 ,54,20577 , 0 
15121.444,10,47 ,14 ,512 ,0 ,0 ,15 ,6 ,0 ,8 ,0 ,29 ,0 ,20 ,0 ,20,8438 , 0 
15121.482,12,47 ,5 ,870 ,0 ,0 ,17 ,2 ,0 ,2 ,0 ,21 ,0 ,44 ,0 ,44,8807 , 0 
15121.596,9,48 ,16 ,768 ,0 ,0 ,21 ,0 ,0 ,1 ,0 ,22 ,0 ,63 ,0 ,63,16966 , 0 
15121.603,5,47 ,13 ,512 ,0 ,0 ,21 ,1 ,1 ,9 ,2 ,34 ,0 ,86 ,15 ,101,14413 , 0 
15121.686,19,47 ,1 ,256 ,0 ,0 ,14 ,8 ,4 ,9 ,3 ,38 ,0 ,62 ,14 ,76,9070 , 0 
15121.697,17,50 ,6 ,768 ,0 ,0 ,19 ,0 ,0 ,2 ,0 ,21 ,0 ,40 ,0 ,40,11549 , 0 
15121.771,13,47 ,1 ,256 ,0 ,0 ,15 ,6 ,1 ,10 ,2 ,34 ,0 ,46 ,4 ,50,7888 , 0 
15121.787,3,47 ,1 ,256 ,0 ,0 ,10 ,7 ,0 ,6 ,0 ,23 ,0 ,29 ,0 ,29,5276 , 0 
15240.96,8,55 ,1 ,256 ,0 ,0 ,7 ,6 ,1 ,3 ,0 ,17 ,0 ,20 ,4 ,24,6315 , 0 
15241.098,11,55 ,5 ,848 ,0 ,0 ,13 ,7 ,5 ,4 ,2 ,31 ,0 ,38 ,9 ,47,11039 , 0 
15241.124,2,55 ,1 ,256 ,0 ,0 ,9 ,2 ,31 ,3 ,7 ,52 ,0 ,31 ,42 ,73,11401 , 0 
15241.139,6,55 ,17 ,1783 ,0 ,0 ,12 ,6 ,5 ,4 ,3 ,30 ,0 ,23 ,12 ,35,14619 , 0 
15241.214,18,55 ,19 ,552 ,0 ,0 ,11 ,4 ,4 ,4 ,1 ,24 ,0 ,19 ,5 ,24,9262 , 0 
15241.236,4,55 ,19 ,552 ,0 ,0 ,9 ,3 ,0 ,3 ,0 ,15 ,0 ,14 ,0 ,14,7988 , 0 
15241.29,7,55 ,16 ,1107 ,0 ,0 ,11 ,5 ,0 ,3 ,0 ,19 ,0 ,29 ,4 ,33,14452 , 0 
15241.337,14,55 ,1 ,256 ,0 ,0 ,9 ,5 ,1 ,6 ,0 ,21 ,0 ,22 ,7 ,29,7871 , 0 
15241.35,15,55 ,9 ,1129 ,0 ,0 ,14 ,7 ,0 ,3 ,0 ,24 ,0 ,26 ,0 ,26,10673 , 0 
15241.36,20,55 ,11 ,1224 ,0 ,0 ,11 ,7 ,0 ,2 ,0 ,20 ,0 ,24 ,0 ,24,9173 , 0 
15241.361,16,55 ,2 ,540 ,0 ,0 ,13 ,4 ,15 ,3 ,4 ,39 ,0 ,28 ,24 ,52,19474 , 0 
15241.444,10,55 ,6 ,2233 ,0 ,0 ,11 ,5 ,0 ,4 ,0 ,20 ,0 ,15 ,0 ,15,8059 , 0 
15241.482,12,55 ,18 ,1224 ,0 ,0 ,10 ,5 ,0 ,5 ,0 ,20 ,0 ,34 ,0 ,34,9474 , 0 
15241.596,9,55 ,5 ,848 ,0 ,0 ,15 ,12 ,6 ,6 ,0 ,39 ,0 ,35 ,8 ,43,16625 , 0 
15241.603,5,55 ,19 ,552 ,0 ,0 ,13 ,5 ,26 ,3 ,3 ,50 ,0 ,43 ,34 ,77,14790 , 0 
15241.607,19,55 ,1 ,256 ,0 ,0 ,8 ,3 ,22 ,3 ,2 ,38 ,0 ,29 ,26 ,55,9592 , 0 
15241.697,17,55 ,16 ,1107 ,0 ,0 ,11 ,5 ,6 ,3 ,2 ,27 ,0 ,22 ,9 ,31,12230 , 0 
15241.771,13,55 ,1 ,256 ,0 ,0 ,9 ,3 ,3 ,3 ,0 ,18 ,0 ,21 ,3 ,24,8047 , 0 
15241.787,3,55 ,1 ,256 ,0 ,0 ,8 ,5 ,0 ,3 ,0 ,16 ,0 ,10 ,0 ,10,5807 , 0 
15360.96,8,55 ,1 ,256 ,0 ,0 ,2 ,2 ,0 ,0 ,0 ,4 ,0 ,7 ,0 ,7,6589 , 0 
15361.078,11,55 ,5 ,819 ,0 ,0 ,1 ,2 ,2 ,0 ,0 ,5 ,0 ,8 ,2 ,10,10457 , 0 
15361.124,2,55 ,1 ,256 ,0 ,0 ,1 ,2 ,7 ,1 ,0 ,11 ,0 ,8 ,7 ,15,11926 , 0 
15361.138,6,55 ,17 ,1452 ,0 ,0 ,3 ,2 ,1 ,0 ,0 ,6 ,0 ,5 ,1 ,6,16001 , 0 
15361.214,18,55 ,19 ,512 ,0 ,0 ,2 ,2 ,1 ,0 ,0 ,5 ,0 ,6 ,1 ,7,8414 , 0 
15361.235,4,55 ,19 ,512 ,0 ,0 ,2 ,2 ,0 ,0 ,0 ,4 ,0 ,4 ,0 ,4,7602 , 0 
15361.289,7,55 ,16 ,873 ,0 ,0 ,2 ,2 ,0 ,0 ,0 ,4 ,0 ,7 ,0 ,7,14872 , 0 
15361.337,14,55 ,1 ,256 ,0 ,0 ,2 ,2 ,0 ,0 ,0 ,4 ,0 ,9 ,0 ,9,7066 , 0 
15361.35,15,55 ,9 ,1167 ,0 ,0 ,3 ,1 ,0 ,0 ,0 ,4 ,0 ,3 ,0 ,3,9438 , 0 
15361.36,20,55 ,11 ,1170 ,0 ,0 ,4 ,2 ,0 ,0 ,0 ,6 ,0 ,5 ,0 ,5,7889 , 0 
15361.36,16,55 ,2 ,512 ,0 ,0 ,2 ,1 ,6 ,0 ,0 ,9 ,0 ,5 ,6 ,11,20718 , 0 
15361.444,10,55 ,6 ,1864 ,0 ,0 ,3 ,1 ,0 ,0 ,0 ,4 ,0 ,2 ,0 ,2,8526 , 0 
15361.483,12,55 ,18 ,1039 ,0 ,0 ,2 ,1 ,0 ,0 ,0 ,3 ,0 ,9 ,0 ,9,8901 , 0 
15361.596,9,55 ,5 ,819 ,0 ,0 ,2 ,2 ,1 ,0 ,0 ,5 ,0 ,6 ,1 ,7,17072 , 0 
15361.603,5,55 ,19 ,512 ,0 ,0 ,4 ,1 ,7 ,0 ,0 ,12 ,0 ,11 ,7 ,18,14594 , 0 
15361.607,19,55 ,1 ,256 ,0 ,0 ,3 ,2 ,13 ,0 ,0 ,18 ,0 ,9 ,13 ,22,9191 , 0 
15361.696,17,55 ,16 ,930 ,0 ,0 ,2 ,1 ,3 ,0 ,0 ,6 ,0 ,3 ,3 ,6,11665 , 0 
15361.771,13,55 ,1 ,256 ,0 ,0 ,1 ,2 ,0 ,0 ,0 ,3 ,0 ,8 ,0 ,8,7966 , 0 
15361.786,3,55 ,1 ,256 ,0 ,0 ,3 ,2 ,0 ,0 ,0 ,5 ,0 ,5 ,0 ,5,5347 , 0 
15480.96,8,55 ,1 ,256 ,0 ,0 ,2 ,0 ,0 ,0 ,0 ,2 ,0 ,2 ,0 ,2,6376 , 0 
15481.078,11,55 ,5 ,775 ,0 ,0 ,3 ,1 ,1 ,0 ,0 ,5 ,0 ,6 ,1 ,7,11152 , 0 
15481.123,2,55 ,1 ,256 ,0 ,0 ,3 ,0 ,6 ,0 ,0 ,9 ,0 ,5 ,6 ,11,11500 , 0 
15481.138,6,55 ,17 ,1380 ,0 ,0 ,2 ,1 ,2 ,0 ,0 ,5 ,0 ,6 ,2 ,8,14732 , 0 
15481.214,18,55 ,19 ,512 ,0 ,0 ,2 ,1 ,1 ,0 ,0 ,4 ,0 ,5 ,1 ,6,9350 , 0 
15481.235,4,55 ,19 ,512 ,0 ,0 ,2 ,0 ,0 ,0 ,0 ,2 ,0 ,2 ,0 ,2,8056 , 0 
15481.289,7,55 ,16 ,843 ,0 ,0 ,2 ,1 ,0 ,0 ,0 ,3 ,0 ,5 ,0 ,5,14533 , 0 
15481.337,14,55 ,1 ,256 ,0 ,0 ,1 ,0 ,0 ,0 ,0 ,1 ,0 ,3 ,0 ,3,7933 , 0 
15481.35,15,55 ,9 ,1091 ,0 ,0 ,2 ,1 ,0 ,0 ,0 ,3 ,0 ,3 ,0 ,3,10761 , 0 
15481.36,20,55 ,11 ,1094 ,0 ,0 ,2 ,1 ,0 ,0 ,0 ,3 ,0 ,3 ,0 ,3,9242 , 0 
15481.36,16,55 ,2 ,512 ,0 ,0 ,2 ,1 ,5 ,0 ,0 ,8 ,0 ,5 ,5 ,10,19608 , 0 
15481.444,10,55 ,6 ,1758 ,0 ,0 ,2 ,2 ,0 ,0 ,0 ,4 ,0 ,3 ,0 ,3,8135 , 0 
15481.481,12,55 ,18 ,986 ,0 ,0 ,2 ,1 ,0 ,0 ,0 ,3 ,0 ,6 ,0 ,6,9577 , 0 
15481.596,9,55 ,5 ,775 ,0 ,0 ,1 ,1 ,1 ,0 ,0 ,3 ,0 ,7 ,1 ,8,16708 , 0 
15481.602,5,55 ,19 ,512 ,0 ,0 ,1 ,0 ,4 ,0 ,0 ,5 ,0 ,5 ,4 ,9,14921 , 0 
15481.606,19,55 ,1 ,256 ,0 ,0 ,1 ,0 ,6 ,0 ,0 ,7 ,0 ,7 ,6 ,13,9694 , 0 
15481.696,17,55 ,16 ,843 ,0 ,0 ,2 ,1 ,3 ,0 ,0 ,6 ,0 ,3 ,3 ,6,12337 , 0 
15481.771,13,55 ,1 ,256 ,0 ,0 ,2 ,0 ,0 ,0 ,0 ,2 ,0 ,2 ,0 ,2,8116 , 0 
15481.786,3,55 ,1 ,256 ,0 ,0 ,1 ,0 ,0 ,0 ,0 ,1 ,0 ,3 ,0 ,3,5863 , 0 
15600.96,8,55 ,1 ,256 ,0 ,0 ,1 ,1 ,0 ,0 ,0 ,2 ,0 ,5 ,0 ,5,6658 , 0 
15601.078,11,55 ,5 ,796 ,0 ,0 ,1 ,1 ,1 ,0 ,0 ,3 ,0 ,2 ,1 ,3,10536 , 0 
15601.123,2,55 ,1 ,256 ,0 ,0 ,1 ,1 ,3 ,0 ,0 ,5 ,0 ,5 ,3 ,8,12012 , 0 
15601.138,6,55 ,17 ,1210 ,0 ,0 ,1 ,1 ,0 ,0 ,0 ,2 ,0 ,6 ,0 ,6,16086 , 0 
15601.214,18,55 ,19 ,512 ,0 ,0 ,1 ,0 ,1 ,0 ,0 ,2 ,0 ,1 ,1 ,2,8502 , 0 
15601.235,4,55 ,19 ,512 ,0 ,0 ,1 ,0 ,0 ,0 ,0 ,1 ,0 ,2 ,0 ,2,7675 , 0 
15601.289,7,55 ,16 ,849 ,0 ,0 ,3 ,1 ,0 ,0 ,0 ,4 ,0 ,4 ,0 ,4,14959 , 0 
15601.337,14,55 ,1 ,256 ,0 ,0 ,3 ,1 ,0 ,0 ,0 ,4 ,0 ,5 ,0 ,5,7155 , 0 
15601.35,15,55 ,9 ,1091 ,0 ,0 ,2 ,0 ,0 ,0 ,0 ,2 ,0 ,2 ,0 ,2,9501 , 0 
15601.36,20,55 ,11 ,1076 ,0 ,0 ,1 ,1 ,0 ,0 ,0 ,2 ,0 ,3 ,0 ,3,7959 , 0 
15601.36,16,55 ,2 ,512 ,0 ,0 ,2 ,0 ,3 ,0 ,0 ,5 ,0 ,4 ,3 ,7,20846 , 0 
15601.444,10,55 ,6 ,1758 ,0 ,0 ,2 ,0 ,0 ,0 ,0 ,2 ,0 ,2 ,0 ,2,8598 , 0 
15601.481,12,55 ,18 ,986 ,0 ,0 ,1 ,1 ,0 ,0 ,0 ,2 ,0 ,1 ,0 ,1,8973 , 0 
15601.596,9,55 ,5 ,796 ,0 ,0 ,1 ,1 ,0 ,0 ,0 ,2 ,0 ,6 ,0 ,6,17160 , 1 
15601.602,5,55 ,19 ,512 ,0 ,0 ,2 ,0 ,3 ,0 ,0 ,5 ,0 ,3 ,3 ,6,14730 , 0 
15601.606,19,55 ,1 ,256 ,0 ,0 ,1 ,1 ,4 ,0 ,0 ,6 ,0 ,3 ,4 ,7,9287 , 0 
15601.696,17,55 ,16 ,849 ,0 ,0 ,2 ,1 ,2 ,0 ,0 ,5 ,0 ,3 ,2 ,5,11767 , 0 
15601.771,13,55 ,1 ,256 ,0 ,0 ,1 ,1 ,0 ,0 ,0 ,2 ,0 ,4 ,0 ,4,8035 , 0 
15601.786,3,55 ,1 ,256 ,0 ,0 ,3 ,1 ,0 ,0 ,0 ,4 ,0 ,2 ,0 ,2,5424 , 0 
15720.96,8,55 ,1 ,256 ,0 ,0 ,2 ,0 ,0 ,0 ,0 ,2 ,0 ,3 ,0 ,3,6475 , 0 
15721.079,11,55 ,9 ,65535 ,0 ,0 ,15 ,9 ,30 ,15 ,3 ,72 ,0 ,22 ,46 ,68,12026 , 0 
15721.124,2,55 ,1 ,256 ,0 ,0 ,1 ,0 ,11 ,1 ,5 ,18 ,0 ,16 ,18 ,34,11695 , 0 
15721.138,6,55 ,2 ,512 ,0 ,0 ,9 ,5 ,1 ,3 ,1 ,19 ,0 ,16 ,2 ,18,15001 , 0 
15721.214,18,55 ,19 ,512 ,0 ,0 ,2 ,1 ,1 ,0 ,0 ,4 ,0 ,10 ,1 ,11,9486 , 0 
15721.235,4,55 ,19 ,512 ,0 ,0 ,2 ,1 ,0 ,0 ,0 ,3 ,0 ,3 ,0 ,3,8176 , 0 
15721.29,7,55 ,9 ,300 ,0 ,0 ,12 ,10 ,7 ,9 ,2 ,40 ,0 ,23 ,21 ,44,15035 , 0 
15721.337,14,55 ,1 ,256 ,0 ,0 ,1 ,0 ,1 ,0 ,0 ,2 ,0 ,6 ,2 ,8,8051 , 0 
15721.35,15,55 ,9 ,300 ,0 ,0 ,7 ,9 ,28 ,3 ,7 ,54 ,0 ,31 ,39 ,70,11406 , 0 
15721.36,20,55 ,11 ,663 ,0 ,0 ,2 ,11 ,0 ,0 ,0 ,13 ,0 ,20 ,0 ,20,9475 , 0 
15721.361,16,55 ,7 ,621 ,0 ,0 ,9 ,1 ,10 ,4 ,6 ,30 ,0 ,22 ,24 ,46,20053 , 0 
15721.444,10,55 ,14 ,599 ,0 ,0 ,8 ,3 ,0 ,3 ,0 ,14 ,0 ,8 ,0 ,8,8362 , 0 
15721.482,12,55 ,18 ,910 ,0 ,0 ,1 ,1 ,0 ,0 ,0 ,2 ,0 ,22 ,0 ,22,9697 , 0 
15721.597,9,55 ,11 ,65535 ,0 ,0 ,15 ,11 ,43 ,22 ,6 ,97 ,0 ,30 ,82 ,112,17650 , 1 
15721.603,5,55 ,19 ,512 ,0 ,0 ,10 ,7 ,14 ,6 ,5 ,42 ,0 ,29 ,32 ,61,15497 , 0 
15721.607,19,55 ,1 ,256 ,0 ,0 ,2 ,0 ,17 ,1 ,6 ,26 ,0 ,12 ,24 ,36,9870 , 0 
15721.697,17,55 ,7 ,673 ,0 ,0 ,11 ,6 ,3 ,7 ,1 ,28 ,0 ,14 ,10 ,24,12706 , 0 
15721.771,13,55 ,1 ,256 ,0 ,0 ,3 ,0 ,0 ,0 ,0 ,3 ,0 ,8 ,0 ,8,8348 , 0 
15721.786,3,55 ,1 ,256 ,0 ,0 ,1 ,0 ,0 ,0 ,0 ,1 ,0 ,0 ,0 ,0,5935 , 0 
15840.96,8,55 ,1 ,256 ,0 ,0 ,2 ,0 ,0 ,0 ,0 ,2 ,0 ,0 ,0 ,0,6715 , 0 
15841.081,11,55 ,15 ,606 ,0 ,0 ,15 ,10 ,11 ,14 ,0 ,50 ,0 ,27 ,28 ,55,11021 , 0 
15841.123,2,55 ,1 ,256 ,0 ,0 ,1 ,0 ,1 ,1 ,0 ,3 ,0 ,4 ,2 ,6,12102 , 0 
15841.138,6,55 ,2 ,512 ,0 ,0 ,2 ,1 ,0 ,1 ,0 ,4 ,0 ,8 ,0 ,8,16204 , 0 
15841.214,18,55 ,19 ,512 ,0 ,0 ,1 ,0 ,1 ,0 ,0 ,2 ,0 ,7 ,1 ,8,8609 , 0 
15841.235,4,55 ,19 ,512 ,0 ,0 ,1 ,0 ,0 ,0 ,0 ,1 ,0 ,1 ,0 ,1,7728 , 0 
15841.29,7,55 ,9 ,300 ,0 ,0 ,8 ,13 ,11 ,2 ,1 ,35 ,0 ,22 ,18 ,40,15325 , 0 
15841.337,14,55 ,1 ,256 ,0 ,0 ,1 ,0 ,1 ,0 ,0 ,2 ,0 ,3 ,1 ,4,7231 , 0 
15841.35,15,55 ,9 ,300 ,0 ,0 ,6 ,12 ,12 ,2 ,2 ,34 ,0 ,30 ,20 ,50,9867 , 0 
15841.36,20,55 ,11 ,871 ,0 ,0 ,6 ,12 ,0 ,2 ,0 ,20 ,0 ,18 ,0 ,18,8222 , 0 
15841.36,16,55 ,7 ,630 ,0 ,0 ,1 ,6 ,0 ,1 ,0 ,8 ,0 ,22 ,0 ,22,20964 , 0 
15841.444,10,55 ,14 ,568 ,0 ,0 ,3 ,1 ,0 ,0 ,0 ,4 ,0 ,3 ,0 ,3,8680 , 0 
15841.482,12,55 ,18 ,947 ,0 ,0 ,6 ,1 ,0 ,0 ,0 ,7 ,0 ,21 ,1 ,22,9122 , 0 
15841.596,9,55 ,5 ,813 ,0 ,0 ,15 ,5 ,23 ,11 ,1 ,55 ,0 ,24 ,73 ,97,17707 , 1 
15841.603,5,55 ,19 ,512 ,0 ,0 ,5 ,0 ,12 ,2 ,0 ,19 ,0 ,30 ,18 ,48,15043 , 0 
15841.607,19,55 ,1 ,256 ,0 ,0 ,0 ,0 ,13 ,2 ,0 ,15 ,0 ,3 ,15 ,18,9381 , 0 
15841.696,17,55 ,7 ,630 ,0 ,0 ,4 ,7 ,0 ,1 ,0 ,12 ,0 ,9 ,0 ,9,11940 , 0 
15841.771,13,55 ,1 ,256 ,0 ,0 ,0 ,0 ,0 ,0 ,0 ,0 ,0 ,3 ,0 ,3,8100 , 0 
15841.786,3,55 ,1 ,256 ,0 ,0 ,0 ,0 ,0 ,0 ,0 ,0 ,0 ,1 ,0 ,1,5475 , 0 
15960.96,8,55 ,1 ,256 ,0 ,0 ,0 ,0 ,0 ,0 ,0 ,0 ,0 ,3 ,0 ,3,6536 , 0 
15961.078,11,55 ,5 ,780 ,0 ,0 ,6 ,5 ,1 ,1 ,1 ,14 ,0 ,21 ,4 ,25,12218 , 0 
15961.124,2,55 ,1 ,256 ,0 ,0 ,5 ,0 ,13 ,0 ,0 ,18 ,0 ,17 ,13 ,30,11839 , 0 
15961.138,6,55 ,2 ,512 ,0 ,0 ,5 ,3 ,0 ,0 ,0 ,8 ,0 ,16 ,0 ,16,15132 , 0 
15961.214,18,55 ,19 ,512 ,0 ,0 ,2 ,0 ,2 ,0 ,0 ,4 ,0 ,5 ,2 ,7,9578 , 0 
15961.235,4,55 ,19 ,512 ,0 ,0 ,1 ,0 ,0 ,0 ,0 ,1 ,0 ,1 ,0 ,1,8239 , 0 
15961.289,7,55 ,16 ,899 ,0 ,0 ,8 ,4 ,1 ,5 ,1 ,19 ,0 ,20 ,7 ,27,15233 , 0 
15961.337,14,55 ,1 ,256 ,0 ,0 ,1 ,0 ,0 ,0 ,0 ,1 ,0 ,7 ,0 ,7,8120 , 0 
15961.35,15,55 ,9 ,1086 ,0 ,0 ,7 ,6 ,2 ,4 ,0 ,19 ,0 ,14 ,6 ,20,11621 , 0 
15961.36,20,55 ,12 ,1208 ,0 ,0 ,5 ,4 ,0 ,1 ,0 ,10 ,0 ,10 ,0 ,10,9608 , 0 
15961.36,16,55 ,2 ,512 ,0 ,0 ,7 ,4 ,7 ,1 ,0 ,19 ,0 ,22 ,9 ,31,20327 , 0 
15961.444,10,55 ,14 ,568 ,0 ,0 ,2 ,0 ,0 ,0 ,0 ,2 ,0 ,3 ,0 ,3,8435 , 0 
15961.482,12,55 ,18 ,947 ,0 ,0 ,2 ,0 ,2 ,0 ,0 ,4 ,0 ,12 ,2 ,14,9829 , 0 
15961.596,9,55 ,5 ,780 ,0 ,0 ,7 ,5 ,7 ,2 ,1 ,22 ,0 ,22 ,13 ,35,17945 , 0 
15961.603,5,55 ,19 ,512 ,0 ,0 ,6 ,0 ,15 ,0 ,1 ,22 ,0 ,21 ,18 ,39,15798 , 0 
15961.607,19,55 ,1 ,256 ,0 ,0 ,2 ,0 ,17 ,0 ,1 ,20 ,0 ,8 ,18 ,26,10005 , 0 
15961.697,17,55 ,16 ,899 ,0 ,0 ,6 ,5 ,0 ,1 ,0 ,12 ,0 ,13 ,0 ,13,12871 , 0 
15961.771,13,55 ,1 ,256 ,0 ,0 ,2 ,0 ,0 ,0 ,0 ,2 ,0 ,6 ,0 ,6,8448 , 0 
15961.786,3,55 ,1 ,256 ,0 ,0 ,2 ,0 ,0 ,0 ,0 ,2 ,0 ,1 ,0 ,1,5996 , 0 
16080.96,8,55 ,1 ,256 ,0 ,0 ,1 ,0 ,0 ,0 ,0 ,1 ,0 ,3 ,0 ,3,6799 , 0 
16081.078,11,55 ,5 ,781 ,0 ,0 ,2 ,1 ,0 ,1 ,0 ,4 ,0 ,9 ,0 ,9,11124 , 0 
16081.123,2,55 ,1 ,256 ,0 ,0 ,2 ,0 ,3 ,0 ,0 ,5 ,0 ,5 ,3 ,8,12207 , 0 
16081.138,6,55 ,2 ,512 ,0 ,0 ,2 ,1 ,0 ,0 ,0 ,3 ,0 ,5 ,0 ,5,16292 , 0 
16081.214,18,55 ,19 ,517 ,0 ,0 ,1 ,1 ,0 ,0 ,0 ,2 ,0 ,4 ,0 ,4,8696 , 0 
16081.235,4,55 ,19 ,517 ,0 ,0 ,1 ,1 ,0 ,0 ,0 ,2 ,0 ,3 ,0 ,3,7869 , 0 
16081.289,7,55 ,16 ,873 ,0 ,0 ,2 ,1 ,0 ,0 ,0 ,3 ,0 ,4 ,0 ,4,15430 , 0 
16081.337,14,55 ,1 ,256 ,0 ,0 ,1 ,0 ,0 ,0 ,0 ,1 ,0 ,3 ,0 ,3,7309 , 0 
16081.35,15,55 ,9 ,1068 ,0 ,0 ,3 ,1 ,0 ,0 ,0 ,4 ,0 ,3 ,0 ,3,9942 , 0 
16081.36,20,55 ,12 ,1207 ,0 ,0 ,2 ,0 ,0 ,0 ,0 ,2 ,0 ,3 ,0 ,3,8288 , 0 
16081.36,16,55 ,2 ,512 ,0 ,0 ,2 ,0 ,2 ,0 ,0 ,4 ,0 ,2 ,2 ,4,21065 , 0 
16081.444,10,55 ,14 ,552 ,0 ,0 ,1 ,0 ,0 ,0 ,0 ,1 ,0 ,2 ,0 ,2,8739 , 0 
16081.481,12,55 ,18 ,947 ,0 ,0 ,2 ,0 ,0 ,0 ,0 ,2 ,0 ,5 ,0 ,5,9191 , 0 
16081.596,9,55 ,5 ,781 ,0 ,0 ,2 ,1 ,1 ,0 ,0 ,4 ,0 ,5 ,1 ,6,17824 , 0 
16081.603,5,55 ,19 ,517 ,0 ,0 ,3 ,1 ,3 ,0 ,0 ,7 ,0 ,6 ,4 ,10,15191 , 0 
16081.606,19,55 ,1 ,256 ,0 ,0 ,1 ,0 ,6 ,0 ,0 ,7 ,0 ,3 ,6 ,9,9469 , 0 
16081.696,17,55 ,16 ,873 ,0 ,0 ,2 ,1 ,0 ,0 ,0 ,3 ,0 ,4 ,0 ,4,12010 , 0 
16081.771,13,55 ,1 ,256 ,0 ,0 ,0 ,0 ,0 ,0 ,0 ,0 ,0 ,5 ,0 ,5,8187 , 0 
16081.786,3,55 ,1 ,256 ,0 ,0 ,2 ,0 ,0 ,0 ,0 ,2 ,0 ,1 ,0 ,1,5555 , 0 
16200.96,8,55 ,1 ,256 ,0 ,0 ,2 ,0 ,0 ,0 ,0 ,2 ,0 ,1 ,0 ,1,6597 , 0 
16201.078,11,55 ,5 ,800 ,0 ,0 ,2 ,1 ,0 ,0 ,0 ,3 ,0 ,6 ,0 ,6,12301 , 0 
16201.123,2,55 ,1 ,256 ,0 ,0 ,2 ,0 ,4 ,0 ,0 ,6 ,0 ,3 ,4 ,7,11927 , 0 
16201.138,6,55 ,2 ,512 ,0 ,0 ,2 ,1 ,0 ,0 ,0 ,3 ,0 ,3 ,0 ,3,15211 , 0 
16201.214,18,55 ,19 ,517 ,0 ,0 ,3 ,0 ,2 ,0 ,0 ,5 ,0 ,4 ,2 ,6,9681 , 0 
16201.235,4,55 ,19 ,517 ,0 ,0 ,2 ,0 ,0 ,0 ,0 ,2 ,0 ,3 ,0 ,3,8305 , 0 
16201.289,7,55 ,16 ,843 ,0 ,0 ,2 ,1 ,0 ,0 ,0 ,3 ,0 ,6 ,0 ,6,15318 , 0 
16201.337,14,55 ,1 ,256 ,0 ,0 ,2 ,0 ,0 ,0 ,0 ,2 ,0 ,3 ,0 ,3,8206 , 0 
16201.35,15,55 ,9 ,1062 ,0 ,0 ,2 ,1 ,0 ,0 ,0 ,3 ,0 ,4 ,0 ,4,11717 , 0 
16201.36,20,55 ,12 ,1125 ,0 ,0 ,3 ,1 ,0 ,0 ,0 ,4 ,0 ,4 ,0 ,4,9694 , 0 
16201.36,16,55 ,2 ,512 ,0 ,0 ,2 ,1 ,2 ,0 ,0 ,5 ,0 ,5 ,2 ,7,20424 , 0 
16201.444,10,55 ,14 ,552 ,0 ,0 ,2 ,0 ,0 ,0 ,0 ,2 ,0 ,2 ,0 ,2,8501 , 0 
16201.481,12,55 ,18 ,832 ,0 ,0 ,2 ,1 ,1 ,0 ,0 ,4 ,0 ,5 ,1 ,6,9908 , 0 
16201.596,9,55 ,5 ,800 ,0 ,0 ,2 ,1 ,1 ,0 ,0 ,4 ,0 ,7 ,1 ,8,18050 , 0 
16201.603,5,55 ,19 ,517 ,0 ,0 ,2 ,0 ,3 ,0 ,0 ,5 ,0 ,9 ,3 ,12,15934 , 0 
16201.606,19,55 ,1 ,256 ,0 ,0 ,1 ,0 ,5 ,0 ,0 ,6 ,0 ,8 ,5 ,13,10099 , 0 
16201.696,17,55 ,16 ,843 ,0 ,0 ,2 ,1 ,0 ,0 ,0 ,3 ,0 ,3 ,0 ,3,12954 , 0 
16201.771,13,55 ,1 ,256 ,0 ,0 ,2 ,0 ,0 ,0 ,0 ,2 ,0 ,4 ,0 ,4,8548 , 0 
16201.786,3,55 ,1 ,256 ,0 ,0 ,2 ,0 ,0 ,0 ,0 ,2 ,0 ,2 ,0 ,2,6049 , 0 
16320.96,8,55 ,1 ,256 ,0 ,0 ,0 ,0 ,0 ,0 ,0 ,0 ,0 ,2 ,0 ,2,6861 , 0 
16321.078,11,55 ,5 ,800 ,0 ,0 ,2 ,0 ,0 ,0 ,0 ,2 ,0 ,3 ,0 ,3,11211 , 0 
16321.124,2,55 ,1 ,256 ,0 ,0 ,25 ,0 ,66 ,0 ,0 ,91 ,110 ,26 ,66 ,202,12567 , 0 
16321.214,18,55 ,19 ,517 ,0 ,0 ,0 ,0 ,0 ,0 ,0 ,0 ,0 ,0 ,0 ,0,8756 , 0 
16321.275,6,55 ,2 ,512 ,0 ,120 ,1 ,18 ,0 ,0 ,0 ,139 ,0 ,83 ,0 ,83,17207 , 1 
16321.29,7,55 ,16 ,794 ,0 ,0 ,1 ,18 ,0 ,0 ,0 ,19 ,0 ,45 ,0 ,45,15657 , 0 
16321.316,4,55 ,19 ,517 ,0 ,0 ,2 ,0 ,0 ,0 ,0 ,2 ,0 ,0 ,0 ,0,7931 , 0 
16321.337,14,55 ,1 ,256 ,0 ,0 ,2 ,0 ,0 ,0 ,0 ,2 ,0 ,37 ,0 ,37,7402 , 0 
16321.35,15,55 ,7 ,1053 ,0 ,0 ,2 ,2 ,0 ,1 ,0 ,5 ,0 ,3 ,0 ,3,10076 , 0 
16321.36,20,55 ,12 ,1125 ,0 ,0 ,1 ,0 ,0 ,0 ,0 ,1 ,0 ,1 ,0 ,1,8363 , 0 
16321.361,16,55 ,2 ,512 ,0 ,0 ,26 ,15 ,34 ,0 ,0 ,75 ,111 ,36 ,34 ,181,21761 , 0 
16321.444,10,55 ,14 ,552 ,0 ,0 ,26 ,0 ,0 ,0 ,0 ,26 ,111 ,0 ,0 ,111,9009 , 0 
16321.481,12,55 ,18 ,832 ,0 ,0 ,1 ,0 ,0 ,0 ,0 ,1 ,0 ,1 ,0 ,1,9322 , 0 
16321.596,9,55 ,5 ,800 ,0 ,0 ,1 ,0 ,1 ,0 ,1 ,3 ,0 ,29 ,2 ,31,17994 , 0 
16321.603,5,55 ,19 ,512 ,0 ,0 ,0 ,1 ,1 ,0 ,1 ,3 ,0 ,20 ,2 ,22,15330 , 0 
16321.615,19,55 ,1 ,256 ,0 ,0 ,2 ,0 ,2 ,0 ,1 ,5 ,0 ,25 ,3 ,28,9584 , 0 
16321.697,17,55 ,16 ,794 ,0 ,0 ,27 ,17 ,0 ,0 ,0 ,44 ,111 ,25 ,0 ,136,12440 , 0 
16321.771,13,55 ,1 ,256 ,0 ,0 ,1 ,0 ,0 ,0 ,0 ,1 ,0 ,18 ,0 ,18,8268 , 0 
16321.786,3,55 ,1 ,256 ,0 ,0 ,0 ,0 ,0 ,0 ,0 ,0 ,0 ,0 ,0 ,0,5612 , 0 
16440.96,8,55 ,1 ,256 ,0 ,0 ,1 ,0 ,0 ,0 ,0 ,1 ,0 ,1 ,0 ,1,6682 , 0 
16441.078,11,55 ,5 ,800 ,0 ,0 ,1 ,0 ,0 ,0 ,0 ,1 ,0 ,7 ,0 ,7,12391 , 0 
16441.124,2,55 ,1 ,256 ,0 ,0 ,26 ,0 ,66 ,0 ,0 ,92 ,109 ,18 ,66 ,193,12304 , 0 
16441.214,18,55 ,19 ,517 ,0 ,0 ,1 ,0 ,0 ,0 ,0 ,1 ,0 ,1 ,0 ,1,9745 , 0 
16441.235,4,55 ,19 ,517 ,0 ,0 ,0 ,0 ,0 ,0 ,0 ,0 ,0 ,0 ,0 ,0,8395 , 0 
16441.27,6,55 ,2 ,512 ,0 ,120 ,1 ,18 ,0 ,0 ,0 ,139 ,0 ,76 ,0 ,76,16113 , 1 
16441.29,7,55 ,16 ,818 ,0 ,0 ,1 ,12 ,2 ,0 ,0 ,15 ,0 ,44 ,2 ,46,15599 , 0 
16441.337,14,55 ,1 ,256 ,0 ,0 ,1 ,0 ,0 ,0 ,0 ,1 ,0 ,39 ,0 ,39,8301 , 0 
16441.35,15,55 ,7 ,1118 ,0 ,0 ,5 ,1 ,0 ,0 ,0 ,6 ,0 ,2 ,0 ,2,11819 , 0 
16441.36,20,55 ,12 ,1125 ,0 ,0 ,2 ,0 ,0 ,0 ,0 ,2 ,0 ,1 ,0 ,1,9763 , 0 
16441.361,16,55 ,2 ,512 ,0 ,0 ,25 ,16 ,32 ,0 ,0 ,73 ,109 ,40 ,32 ,181,21128 , 0 
16441.444,10,55 ,14 ,552 ,0 ,0 ,25 ,0 ,0 ,0 ,0 ,25 ,110 ,0 ,0 ,110,8762 , 0 
16441.482,12,55 ,18 ,832 ,0 ,0 ,1 ,0 ,0 ,0 ,0 ,1 ,0 ,2 ,0 ,2,10033 , 0 
16441.596,9,55 ,5 ,800 ,0 ,0 ,3 ,0 ,0 ,1 ,0 ,4 ,0 ,27 ,0 ,27,18206 , 0 
16441.603,5,55 ,19 ,512 ,0 ,0 ,2 ,0 ,0 ,1 ,0 ,3 ,0 ,25 ,1 ,26,16084 , 0 
16441.606,19,55 ,1 ,256 ,0 ,0 ,0 ,0 ,0 ,1 ,0 ,1 ,0 ,24 ,1 ,25,10207 , 0 
16441.697,17,55 ,16 ,818 ,0 ,0 ,24 ,17 ,0 ,0 ,0 ,41 ,109 ,22 ,0 ,131,13306 , 0 
16441.771,13,55 ,1 ,256 ,0 ,0 ,1 ,0 ,0 ,0 ,0 ,1 ,0 ,22 ,0 ,22,8646 , 0 
16441.786,3,55 ,1 ,256 ,0 ,0 ,1 ,0 ,0 ,0 ,0 ,1 ,0 ,1 ,0 ,1,6127 , 0 
16560.96,8,55 ,1 ,256 ,0 ,0 ,1 ,0 ,0 ,0 ,0 ,1 ,0 ,0 ,0 ,0,6931 , 0 
16561.078,11,55 ,5 ,800 ,0 ,0 ,0 ,0 ,0 ,0 ,0 ,0 ,0 ,1 ,0 ,1,11298 , 0 
16561.124,2,55 ,1 ,256 ,0 ,0 ,26 ,0 ,63 ,0 ,0 ,89 ,112 ,19 ,63 ,194,12945 , 0 
16561.214,18,55 ,19 ,517 ,0 ,0 ,1 ,0 ,1 ,0 ,0 ,2 ,0 ,2 ,1 ,3,8889 , 0 
16561.235,4,55 ,19 ,517 ,0 ,0 ,1 ,0 ,0 ,0 ,0 ,1 ,0 ,2 ,0 ,2,8029 , 0 
16561.272,6,55 ,2 ,512 ,0 ,120 ,1 ,15 ,0 ,0 ,0 ,136 ,0 ,80 ,0 ,80,18077 , 1 
16561.29,7,55 ,16 ,786 ,0 ,0 ,1 ,15 ,0 ,0 ,0 ,16 ,0 ,38 ,0 ,38,15893 , 0 
16561.337,14,55 ,1 ,256 ,0 ,0 ,1 ,0 ,0 ,0 ,0 ,1 ,0 ,40 ,0 ,40,7524 , 0 
16561.35,15,55 ,7 ,1118 ,0 ,0 ,2 ,0 ,0 ,0 ,0 ,2 ,0 ,1 ,0 ,1,10164 , 0 
16561.36,20,55 ,12 ,1160 ,0 ,0 ,0 ,1 ,0 ,0 ,0 ,1 ,0 ,1 ,0 ,1,8425 , 0 
16561.444,10,55 ,14 ,552 ,0 ,0 ,24 ,0 ,0 ,0 ,0 ,24 ,110 ,1 ,0 ,111,9286 , 0 
16561.481,12,55 ,18 ,832 ,0 ,0 ,1 ,0 ,1 ,0 ,0 ,2 ,0 ,0 ,1 ,1,9412 , 0 
16561.501,16,55 ,2 ,512 ,0 ,0 ,26 ,15 ,35 ,0 ,0 ,76 ,107 ,38 ,35 ,180,22513 , 0 
16561.596,9,55 ,5 ,800 ,0 ,0 ,1 ,0 ,0 ,0 ,0 ,1 ,0 ,25 ,0 ,25,18110 , 0 
16561.603,5,55 ,19 ,512 ,0 ,0 ,1 ,0 ,0 ,0 ,0 ,1 ,0 ,20 ,0 ,20,15478 , 0 
16561.606,19,55 ,1 ,256 ,0 ,0 ,1 ,0 ,1 ,0 ,0 ,2 ,0 ,20 ,1 ,21,9688 , 0 
16561.697,17,55 ,16 ,858 ,0 ,0 ,27 ,20 ,0 ,0 ,0 ,47 ,108 ,24 ,0 ,132,12872 , 0 
16561.771,13,55 ,1 ,256 ,0 ,0 ,2 ,0 ,0 ,0 ,0 ,2 ,0 ,21 ,0 ,21,8436 , 0 
16561.786,3,55 ,1 ,256 ,0 ,0 ,1 ,0 ,0 ,0 ,0 ,1 ,0 ,0 ,0 ,0,5695 , 0 
16680.96,8,55 ,1 ,256 ,0 ,0 ,2 ,0 ,0 ,0 ,0 ,2 ,0 ,1 ,0 ,1,6750 , 0 
16681.078,11,55 ,5 ,800 ,0 ,0 ,1 ,0 ,0 ,0 ,0 ,1 ,0 ,2 ,0 ,2,12457 , 0 
16681.124,2,55 ,1 ,256 ,0 ,0 ,6 ,0 ,20 ,0 ,0 ,26 ,0 ,5 ,20 ,25,12430 , 0 
16681.138,6,55 ,2 ,512 ,0 ,0 ,1 ,5 ,0 ,0 ,0 ,6 ,0 ,17 ,0 ,17,16216 , 0 
16681.214,18,55 ,19 ,517 ,0 ,0 ,1 ,0 ,0 ,0 ,0 ,1 ,0 ,0 ,0 ,0,9803 , 0 
16681.235,4,55 ,19 ,517 ,0 ,0 ,1 ,0 ,0 ,0 ,0 ,1 ,0 ,1 ,0 ,1,8450 , 0 
16681.289,7,55 ,16 ,787 ,0 ,0 ,1 ,5 ,0 ,0 ,0 ,6 ,0 ,12 ,0 ,12,15704 , 0 
16681.337,14,55 ,1 ,256 ,0 ,0 ,2 ,0 ,1 ,0 ,0 ,3 ,0 ,10 ,1 ,11,8370 , 0 
16681.35,15,55 ,7 ,1118 ,0 ,0 ,1 ,0 ,0 ,0 ,0 ,1 ,0 ,2 ,0 ,2,11894 , 0 
16681.36,20,55 ,12 ,1160 ,0 ,0 ,1 ,0 ,0 ,0 ,0 ,1 ,0 ,1 ,0 ,1,9843 , 0 
16681.361,16,55 ,2 ,512 ,0 ,0 ,5 ,4 ,9 ,0 ,0 ,18 ,0 ,10 ,9 ,19,21339 , 0 
16681.444,10,55 ,14 ,531 ,0 ,0 ,6 ,1 ,0 ,0 ,0 ,7 ,0 ,1 ,0 ,1,8862 , 0 
16681.482,12,55 ,18 ,832 ,0 ,0 ,0 ,0 ,0 ,0 ,0 ,0 ,0 ,0 ,0 ,0,10094 , 0 
16681.596,9,55 ,5 ,800 ,0 ,0 ,1 ,0 ,0 ,0 ,0 ,1 ,0 ,5 ,0 ,5,18277 , 0 
16681.602,5,55 ,19 ,512 ,0 ,0 ,1 ,0 ,0 ,0 ,0 ,1 ,0 ,5 ,0 ,5,16166 , 0 
16681.606,19,55 ,1 ,256 ,0 ,0 ,1 ,0 ,0 ,0 ,0 ,1 ,0 ,7 ,0 ,7,10301 , 0 
16681.696,17,55 ,16 ,787 ,0 ,0 ,5 ,4 ,0 ,0 ,0 ,9 ,0 ,4 ,0 ,4,13428 , 0 
16681.771,13,55 ,1 ,256 ,0 ,0 ,1 ,0 ,0 ,0 ,0 ,1 ,0 ,4 ,0 ,4,8735 , 0 
16681.786,3,55 ,1 ,256 ,0 ,0 ,1 ,0 ,0 ,0 ,0 ,1 ,0 ,1 ,0 ,1,6179 , 0 
16800.96,8,55 ,1 ,256 ,0 ,0 ,0 ,0 ,0 ,0 ,0 ,0 ,0 ,2 ,0 ,2,6995 , 0 
16801.078,11,55 ,5 ,800 ,0 ,0 ,2 ,0 ,0 ,0 ,0 ,2 ,0 ,4 ,0 ,4,11370 , 0 
16801.123,2,55 ,1 ,256 ,0 ,0 ,1 ,0 ,2 ,0 ,0 ,3 ,0 ,1 ,2 ,3,13011 , 0 
16801.138,6,55 ,2 ,512 ,0 ,0 ,1 ,1 ,0 ,0 ,0 ,2 ,0 ,5 ,0 ,5,18178 , 0 
16801.214,18,55 ,19 ,517 ,0 ,0 ,3 ,0 ,3 ,0 ,0 ,6 ,0 ,3 ,3 ,6,8989 , 0 
16801.235,4,55 ,19 ,517 ,0 ,0 ,2 ,0 ,0 ,0 ,0 ,2 ,0 ,1 ,0 ,1,8092 , 0 
16801.289,7,55 ,16 ,781 ,0 ,0 ,1 ,1 ,0 ,0 ,0 ,2 ,0 ,3 ,0 ,3,15964 , 0 
16801.337,14,55 ,1 ,256 ,0 ,0 ,0 ,0 ,0 ,0 ,0 ,0 ,0 ,1 ,0 ,1,7576 , 0 
16801.35,15,55 ,7 ,1105 ,0 ,0 ,0 ,0 ,0 ,0 ,0 ,0 ,0 ,2 ,0 ,2,10223 , 0 
16801.36,20,55 ,12 ,1116 ,0 ,0 ,3 ,1 ,0 ,0 ,0 ,4 ,0 ,2 ,0 ,2,8501 , 0 
16801.36,16,55 ,2 ,512 ,0 ,0 ,2 ,0 ,1 ,0 ,0 ,3 ,0 ,1 ,1 ,2,22592 , 0 
16801.444,10,55 ,14 ,531 ,0 ,0 ,1 ,0 ,0 ,0 ,0 ,1 ,0 ,0 ,0 ,0,9353 , 0 
16801.481,12,55 ,18 ,810 ,0 ,0 ,2 ,2 ,1 ,0 ,0 ,5 ,0 ,6 ,1 ,7,9514 , 0 
16801.596,9,55 ,5 ,800 ,0 ,0 ,1 ,0 ,0 ,0 ,0 ,1 ,0 ,2 ,0 ,2,18182 , 0 
16801.602,5,55 ,19 ,512 ,0 ,0 ,1 ,0 ,0 ,0 ,0 ,1 ,0 ,7 ,0 ,7,15554 , 0 
16801.606,19,55 ,1 ,256 ,0 ,0 ,1 ,0 ,3 ,0 ,0 ,4 ,0 ,4 ,3 ,7,9757 , 0 
16801.696,17,55 ,16 ,781 ,0 ,0 ,2 ,1 ,0 ,0 ,0 ,3 ,0 ,2 ,0 ,2,12950 , 0 
16801.771,13,55 ,1 ,256 ,0 ,0 ,1 ,0 ,0 ,0 ,0 ,1 ,0 ,2 ,0 ,2,8494 , 0 
16801.786,3,55 ,1 ,256 ,0 ,0 ,1 ,0 ,0 ,0 ,0 ,1 ,0 ,0 ,0 ,0,5755 , 0 
16920.96,8,55 ,1 ,256 ,0 ,0 ,2 ,0 ,0 ,0 ,0 ,2 ,0 ,0 ,0 ,0,6824 , 0 
16921.078,11,55 ,5 ,800 ,0 ,0 ,1 ,0 ,0 ,0 ,0 ,1 ,0 ,2 ,0 ,2,12527 , 0 
16921.123,2,55 ,1 ,256 ,0 ,0 ,1 ,0 ,3 ,0 ,0 ,4 ,0 ,2 ,3 ,5,12522 , 0 
16921.138,6,55 ,2 ,512 ,0 ,0 ,2 ,0 ,0 ,0 ,0 ,2 ,0 ,1 ,0 ,1,16280 , 0 
16921.214,18,55 ,19 ,517 ,0 ,0 ,1 ,0 ,1 ,0 ,0 ,2 ,0 ,1 ,1 ,2,9884 , 0 
16921.235,4,55 ,19 ,517 ,0 ,0 ,1 ,0 ,0 ,0 ,0 ,1 ,0 ,2 ,0 ,2,8530 , 0 
16921.289,7,55 ,16 ,781 ,0 ,0 ,1 ,0 ,1 ,0 ,0 ,2 ,0 ,2 ,1 ,3,15783 , 0 
16921.337,14,55 ,1 ,256 ,0 ,0 ,1 ,0 ,0 ,0 ,0 ,1 ,0 ,1 ,0 ,1,8443 , 0 
16921.35,15,55 ,7 ,1092 ,0 ,0 ,2 ,1 ,0 ,0 ,0 ,3 ,0 ,2 ,0 ,2,11971 , 0 
16921.36,20,55 ,12 ,1102 ,0 ,0 ,1 ,1 ,0 ,0 ,0 ,2 ,0 ,1 ,0 ,1,9914 , 0 
16921.36,16,55 ,2 ,512 ,0 ,0 ,2 ,0 ,3 ,0 ,0 ,5 ,0 ,3 ,3 ,6,21459 , 0 
16921.444,10,55 ,14 ,531 ,0 ,0 ,1 ,0 ,0 ,0 ,0 ,1 ,0 ,0 ,0 ,0,8923 , 0 
16921.482,12,55 ,18 ,810 ,0 ,0 ,2 ,0 ,1 ,0 ,0 ,3 ,0 ,0 ,1 ,1,10187 , 0 
16921.596,9,55 ,5 ,800 ,0 ,0 ,2 ,0 ,0 ,0 ,0 ,2 ,0 ,4 ,0 ,4,18389 , 0 
16921.602,5,55 ,19 ,512 ,0 ,0 ,1 ,0 ,0 ,0 ,0 ,1 ,0 ,2 ,0 ,2,16291 , 0 
16921.606,19,55 ,1 ,256 ,0 ,0 ,1 ,0 ,1 ,0 ,0 ,2 ,0 ,2 ,1 ,3,10382 , 0 
16921.696,17,55 ,16 ,792 ,0 ,0 ,0 ,1 ,0 ,0 ,0 ,1 ,0 ,3 ,0 ,3,13493 , 0 
16921.771,13,55 ,1 ,256 ,0 ,0 ,1 ,0 ,0 ,0 ,0 ,1 ,0 ,0 ,0 ,0,8813 , 0 
16921.786,3,55 ,1 ,256 ,0 ,0 ,1 ,0 ,0 ,0 ,0 ,1 ,0 ,1 ,0 ,1,6242 , 0 
17040.96,8,55 ,1 ,256 ,0 ,0 ,0 ,0 ,0 ,0 ,0 ,0 ,0 ,3 ,0 ,3,7057 , 0 
17041.078,11,55 ,5 ,800 ,0 ,0 ,1 ,0 ,0 ,0 ,0 ,1 ,0 ,11 ,0 ,11,11458 , 0 
17041.138,6,55 ,2 ,512 ,0 ,0 ,8 ,5 ,13 ,0 ,0 ,26 ,0 ,21 ,13 ,34,18487 , 0 
17041.14,2,55 ,1 ,256 ,0 ,0 ,8 ,0 ,24 ,0 ,2 ,34 ,0 ,11 ,28 ,39,13170 , 0 
17041.214,18,55 ,19 ,517 ,0 ,0 ,1 ,0 ,0 ,0 ,0 ,1 ,0 ,0 ,0 ,0,9052 , 0 
17041.235,4,55 ,19 ,517 ,0 ,0 ,1 ,0 ,0 ,0 ,0 ,1 ,0 ,0 ,0 ,0,8155 , 0 
17041.29,7,55 ,17 ,1133 ,0 ,0 ,10 ,6 ,0 ,1 ,0 ,17 ,0 ,20 ,1 ,21,16152 , 0 
17041.34,14,55 ,1 ,256 ,0 ,0 ,1 ,0 ,0 ,0 ,0 ,1 ,0 ,10 ,0 ,10,7700 , 0 
17041.35,15,55 ,9 ,1109 ,0 ,0 ,7 ,4 ,0 ,1 ,0 ,12 ,0 ,13 ,0 ,13,10383 , 0 
17041.36,20,55 ,12 ,1102 ,0 ,0 ,1 ,0 ,0 ,0 ,0 ,1 ,0 ,2 ,0 ,2,8580 , 0 
17041.361,16,55 ,2 ,512 ,0 ,0 ,6 ,6 ,0 ,2 ,2 ,16 ,0 ,27 ,2 ,29,22831 , 1 
17041.444,10,55 ,14 ,531 ,0 ,0 ,3 ,0 ,0 ,0 ,0 ,3 ,0 ,7 ,0 ,7,9424 , 0 
17041.481,12,55 ,18 ,810 ,0 ,0 ,1 ,0 ,0 ,0 ,0 ,1 ,0 ,1 ,0 ,1,9595 , 0 
17041.596,9,55 ,5 ,800 ,0 ,0 ,9 ,0 ,4 ,0 ,0 ,13 ,0 ,13 ,4 ,17,18351 , 0 
17041.61,5,55 ,19 ,512 ,0 ,0 ,2 ,0 ,4 ,0 ,0 ,6 ,0 ,11 ,4 ,15,15737 , 0 
17041.623,19,55 ,1 ,256 ,0 ,0 ,1 ,0 ,4 ,0 ,0 ,5 ,0 ,9 ,4 ,13,9866 , 0 
17041.697,17,55 ,6 ,838 ,0 ,0 ,11 ,7 ,6 ,1 ,0 ,25 ,0 ,19 ,6 ,25,13188 , 0 
17041.771,13,55 ,1 ,256 ,0 ,0 ,1 ,0 ,0 ,0 ,0 ,1 ,0 ,6 ,0 ,6,8613 , 0 
17041.786,3,55 ,1 ,256 ,0 ,0 ,1 ,0 ,0 ,0 ,0 ,1 ,0 ,0 ,0 ,0,5810 , 0 
17160.96,8,55 ,1 ,256 ,0 ,0 ,2 ,0 ,0 ,0 ,0 ,2 ,0 ,1 ,0 ,1,6887 , 0 
17161.078,11,55 ,5 ,800 ,0 ,0 ,1 ,0 ,0 ,0 ,0 ,1 ,0 ,9 ,0 ,9,12608 , 0 
17161.124,2,55 ,1 ,256 ,0 ,0 ,8 ,0 ,28 ,0 ,0 ,36 ,0 ,9 ,28 ,37,12715 , 0 
17161.138,6,55 ,2 ,512 ,0 ,0 ,9 ,6 ,16 ,0 ,0 ,31 ,0 ,17 ,16 ,33,16596 , 0 
17161.214,18,55 ,19 ,517 ,0 ,0 ,1 ,0 ,0 ,0 ,0 ,1 ,0 ,2 ,0 ,2,9962 , 0 
17161.235,4,55 ,19 ,517 ,0 ,0 ,1 ,0 ,0 ,0 ,0 ,1 ,0 ,2 ,0 ,2,8584 , 0 
17161.29,7,55 ,17 ,1170 ,0 ,0 ,6 ,9 ,0 ,0 ,0 ,15 ,0 ,19 ,0 ,19,15946 , 0 
17161.337,14,55 ,1 ,256 ,0 ,0 ,0 ,0 ,0 ,0 ,0 ,0 ,0 ,8 ,0 ,8,8539 , 0 
17161.35,15,55 ,9 ,1085 ,0 ,0 ,3 ,5 ,0 ,0 ,0 ,8 ,0 ,13 ,0 ,13,12107 , 0 
17161.36,20,55 ,12 ,1102 ,0 ,0 ,1 ,0 ,0 ,0 ,0 ,1 ,0 ,0 ,0 ,0,9970 , 0 
17161.36,16,55 ,2 ,512 ,0 ,0 ,3 ,6 ,0 ,0 ,0 ,9 ,0 ,32 ,0 ,32,21601 , 1 
17161.444,10,55 ,14 ,531 ,0 ,0 ,0 ,0 ,0 ,0 ,0 ,0 ,0 ,8 ,0 ,8,9012 , 0 
17161.482,12,55 ,18 ,810 ,0 ,0 ,1 ,0 ,0 ,0 ,0 ,1 ,0 ,1 ,0 ,1,10258 , 0 
17161.596,9,55 ,5 ,800 ,0 ,0 ,7 ,0 ,5 ,0 ,0 ,12 ,0 ,9 ,5 ,14,18568 , 0 
17161.603,5,55 ,19 ,512 ,0 ,0 ,1 ,0 ,5 ,0 ,0 ,6 ,0 ,13 ,5 ,18,16427 , 0 
17161.606,19,55 ,1 ,256 ,0 ,0 ,1 ,0 ,5 ,0 ,0 ,6 ,0 ,7 ,5 ,12,10477 , 0 
17161.697,17,55 ,6 ,881 ,0 ,0 ,10 ,7 ,9 ,0 ,0 ,26 ,0 ,15 ,9 ,24,13719 , 0 
17161.771,13,55 ,1 ,256 ,0 ,0 ,1 ,0 ,0 ,0 ,0 ,1 ,0 ,7 ,0 ,7,8885 , 0 
17161.786,3,55 ,1 ,256 ,0 ,0 ,2 ,0 ,0 ,0 ,0 ,2 ,0 ,2 ,0 ,2,6307 , 0 
17280.96,8,55 ,1 ,256 ,0 ,0 ,1 ,0 ,0 ,0 ,0 ,1 ,0 ,2 ,0 ,2,7134 , 0 
17281.078,11,55 ,5 ,800 ,0 ,0 ,2 ,0 ,0 ,0 ,0 ,2 ,0 ,6 ,0 ,6,11545 , 0 
17281.124,2,55 ,1 ,256 ,0 ,0 ,6 ,0 ,17 ,0 ,0 ,23 ,0 ,7 ,17 ,24,13300 , 0 
17281.138,6,55 ,2 ,512 ,0 ,0 ,6 ,4 ,9 ,0 ,0 ,19 ,0 ,11 ,9 ,20,18689 , 0 
17281.214,18,55 ,19 ,517 ,0 ,0 ,1 ,0 ,0 ,0 ,0 ,1 ,0 ,0 ,0 ,0,9124 , 0 
17281.235,4,55 ,19 ,517 ,0 ,0 ,1 ,0 ,0 ,0 ,0 ,1 ,0 ,0 ,0 ,0,8222 , 0 
17281.29,7,55 ,17 ,1084 ,0 ,0 ,6 ,5 ,0 ,0 ,0 ,11 ,0 ,14 ,0 ,14,16285 , 0 
17281.337,14,55 ,1 ,256 ,0 ,0 ,1 ,0 ,0 ,0 ,0 ,1 ,0 ,4 ,0 ,4,7774 , 0 
17281.35,15,55 ,9 ,1070 ,0 ,0 ,2 ,4 ,0 ,0 ,0 ,6 ,0 ,10 ,0 ,10,10487 , 0 
17281.36,20,55 ,12 ,1102 ,0 ,0 ,1 ,0 ,0 ,0 ,0 ,1 ,0 ,0 ,0 ,0,8668 , 0 
17281.36,16,55 ,2 ,512 ,0 ,0 ,2 ,4 ,0 ,0 ,0 ,6 ,0 ,25 ,0 ,25,22975 , 1 
17281.444,10,55 ,14 ,531 ,0 ,0 ,1 ,0 ,0 ,0 ,0 ,1 ,0 ,4 ,0 ,4,9490 , 0 
17281.481,12,55 ,18 ,810 ,0 ,0 ,1 ,0 ,0 ,0 ,0 ,1 ,0 ,0 ,0 ,0,9681 , 0 
17281.596,9,55 ,5 ,800 ,0 ,0 ,7 ,0 ,4 ,0 ,0 ,11 ,0 ,9 ,4 ,13,18511 , 0 
17281.603,5,55 ,19 ,512 ,0 ,0 ,0 ,0 ,4 ,0 ,0 ,4 ,0 ,14 ,4 ,18,15875 , 0 
17281.606,19,55 ,1 ,256 ,0 ,0 ,2 ,0 ,4 ,0 ,0 ,6 ,0 ,4 ,4 ,8,9953 , 0 
17281.697,17,55 ,6 ,800 ,0 ,0 ,6 ,4 ,5 ,0 ,0 ,15 ,0 ,11 ,5 ,16,13342 , 0 
17281.771,13,55 ,1 ,256 ,0 ,0 ,1 ,0 ,0 ,0 ,0 ,1 ,0 ,4 ,0 ,4,8687 , 0 
17281.786,3,55 ,1 ,256 ,0 ,0 ,1 ,0 ,0 ,0 ,0 ,1 ,0 ,1 ,0 ,1,5886 , 0 
17400.96,8,55 ,1 ,256 ,0 ,0 ,1 ,0 ,0 ,0 ,0 ,1 ,0 ,3 ,0 ,3,6953 , 0 
17401.078,11,55 ,5 ,800 ,0 ,0 ,1 ,0 ,0 ,0 ,0 ,1 ,0 ,7 ,0 ,7,12676 , 0 
17401.123,2,55 ,1 ,256 ,0 ,0 ,2 ,0 ,5 ,0 ,1 ,8 ,0 ,3 ,6 ,9,12804 , 0 
17401.138,6,55 ,2 ,512 ,0 ,0 ,2 ,1 ,3 ,0 ,1 ,7 ,0 ,4 ,4 ,8,16704 , 0 
17401.214,18,55 ,19 ,517 ,0 ,0 ,1 ,0 ,0 ,0 ,0 ,1 ,0 ,1 ,0 ,1,10025 , 0 
17401.235,4,55 ,19 ,517 ,0 ,0 ,2 ,0 ,0 ,0 ,0 ,2 ,0 ,1 ,0 ,1,8677 , 0 
17401.289,7,55 ,16 ,830 ,0 ,0 ,3 ,1 ,0 ,1 ,0 ,5 ,0 ,5 ,0 ,5,16042 , 0 
17401.337,14,55 ,1 ,256 ,0 ,0 ,2 ,0 ,0 ,0 ,0 ,2 ,0 ,4 ,0 ,4,8618 , 0 
17401.35,15,55 ,9 ,1063 ,0 ,0 ,1 ,5 ,0 ,0 ,0 ,6 ,0 ,6 ,0 ,6,12200 , 0 
17401.36,20,55 ,12 ,1083 ,0 ,0 ,1 ,0 ,0 ,0 ,0 ,1 ,0 ,1 ,0 ,1,10033 , 0 
17401.444,10,55 ,14 ,531 ,0 ,0 ,1 ,0 ,0 ,0 ,0 ,1 ,0 ,2 ,0 ,2,9068 , 0 
17401.482,12,55 ,18 ,810 ,0 ,0 ,2 ,0 ,0 ,0 ,0 ,2 ,0 ,1 ,0 ,1,10328 , 0 
17401.493,16,55 ,2 ,512 ,0 ,0 ,2 ,1 ,1 ,0 ,0 ,4 ,0 ,9 ,1 ,10,21698 , 0 
17401.596,9,55 ,5 ,800 ,0 ,0 ,4 ,0 ,5 ,0 ,0 ,9 ,0 ,3 ,5 ,8,18688 , 0 
17401.603,5,55 ,19 ,512 ,0 ,0 ,1 ,0 ,5 ,0 ,0 ,6 ,0 ,5 ,5 ,10,16542 , 0 
17401.606,19,55 ,1 ,256 ,0 ,0 ,1 ,0 ,5 ,0 ,0 ,6 ,0 ,4 ,5 ,9,10577 , 0 
17401.696,17,55 ,6 ,793 ,0 ,0 ,1 ,2 ,1 ,0 ,1 ,5 ,0 ,4 ,2 ,6,13815 , 0 
17401.771,13,55 ,1 ,256 ,0 ,0 ,1 ,0 ,0 ,0 ,0 ,1 ,0 ,3 ,0 ,3,8982 , 0 
17401.786,3,55 ,1 ,256 ,0 ,0 ,2 ,0 ,0 ,0 ,0 ,2 ,0 ,0 ,0 ,0,6369 , 0 
17520.96,8,55 ,1 ,256 ,0 ,0 ,1 ,0 ,0 ,0 ,0 ,1 ,0 ,0 ,0 ,0,7194 , 0 
17521.078,11,55 ,5 ,800 ,0 ,0 ,1 ,0 ,0 ,0 ,0 ,1 ,0 ,8 ,0 ,8,11609 , 0 
17521.123,2,55 ,1 ,256 ,0 ,0 ,2 ,0 ,4 ,0 ,0 ,6 ,0 ,1 ,5 ,6,13405 , 0 
17521.138,6,55 ,2 ,512 ,0 ,0 ,2 ,1 ,1 ,1 ,0 ,5 ,0 ,3 ,2 ,5,18814 , 0 
17521.214,18,55 ,19 ,517 ,0 ,0 ,1 ,0 ,0 ,1 ,1 ,3 ,0 ,0 ,2 ,2,9201 , 0 
17521.235,4,55 ,19 ,517 ,0 ,0 ,0 ,0 ,0 ,0 ,0 ,0 ,0 ,0 ,0 ,0,8273 , 0 
17521.289,7,55 ,16 ,830 ,0 ,0 ,5 ,1 ,0 ,0 ,0 ,6 ,0 ,5 ,0 ,5,16394 , 0 
17521.337,14,55 ,1 ,256 ,0 ,0 ,1 ,0 ,0 ,0 ,0 ,1 ,0 ,2 ,0 ,2,7855 , 0 
17521.35,15,55 ,9 ,1083 ,0 ,0 ,2 ,0 ,0 ,0 ,0 ,2 ,0 ,6 ,0 ,6,10582 , 0 
17521.359,20,55 ,5 ,811 ,0 ,0 ,5 ,1 ,0 ,1 ,0 ,7 ,0 ,2 ,0 ,2,8797 , 0 
17521.36,16,55 ,2 ,512 ,0 ,0 ,1 ,1 ,0 ,0 ,0 ,2 ,0 ,10 ,0 ,10,23051 , 0 
17521.444,10,55 ,14 ,531 ,0 ,0 ,1 ,0 ,0 ,0 ,0 ,1 ,0 ,1 ,0 ,1,9553 , 0 
17521.481,12,55 ,18 ,801 ,0 ,0 ,1 ,0 ,0 ,1 ,1 ,3 ,0 ,5 ,1 ,6,9760 , 0 
17521.596,9,55 ,5 ,800 ,0 ,0 ,2 ,0 ,0 ,0 ,0 ,2 ,0 ,5 ,0 ,5,18609 , 0 
17521.603,5,55 ,19 ,512 ,0 ,0 ,1 ,0 ,1 ,0 ,0 ,2 ,0 ,9 ,1 ,10,15976 , 0 
17521.606,19,55 ,1 ,256 ,0 ,0 ,1 ,0 ,1 ,0 ,1 ,3 ,0 ,2 ,3 ,5,10033 , 0 
17521.696,17,55 ,6 ,783 ,0 ,0 ,3 ,1 ,0 ,1 ,0 ,5 ,0 ,6 ,0 ,6,13424 , 0 
17521.771,13,55 ,1 ,256 ,0 ,0 ,1 ,0 ,0 ,0 ,0 ,1 ,0 ,1 ,0 ,1,8768 , 0 
17521.786,3,55 ,1 ,256 ,0 ,0 ,1 ,0 ,0 ,0 ,0 ,1 ,0 ,2 ,0 ,2,5952 , 0 
17640.96,8,55 ,1 ,256 ,0 ,0 ,1 ,0 ,0 ,0 ,0 ,1 ,0 ,0 ,0 ,0,7016 , 0 
17641.078,11,55 ,5 ,800 ,0 ,0 ,1 ,0 ,0 ,0 ,0 ,1 ,0 ,3 ,0 ,3,12759 , 0 
17641.123,2,55 ,1 ,256 ,0 ,0 ,2 ,0 ,2 ,0 ,0 ,4 ,0 ,3 ,2 ,5,12889 , 0 
17641.138,6,55 ,2 ,512 ,0 ,0 ,2 ,0 ,1 ,0 ,0 ,3 ,0 ,3 ,1 ,4,16787 , 0 
17641.214,18,55 ,19 ,517 ,0 ,0 ,2 ,0 ,0 ,0 ,0 ,2 ,0 ,0 ,0 ,0,10120 , 0 
17641.235,4,55 ,19 ,512 ,0 ,0 ,1 ,1 ,0 ,0 ,0 ,2 ,0 ,3 ,0 ,3,8759 , 0 
17641.289,7,55 ,16 ,830 ,0 ,0 ,2 ,0 ,0 ,0 ,0 ,2 ,0 ,2 ,0 ,2,16116 , 0 
17641.337,14,55 ,1 ,256 ,0 ,0 ,1 ,0 ,0 ,0 ,0 ,1 ,0 ,1 ,0 ,1,8674 , 0 
17641.35,15,55 ,9 ,1083 ,0 ,0 ,1 ,0 ,0 ,0 ,0 ,1 ,0 ,1 ,0 ,1,12265 , 0 
17641.36,20,55 ,5 ,811 ,0 ,0 ,2 ,0 ,0 ,0 ,0 ,2 ,0 ,0 ,0 ,0,10108 , 0 
17641.36,16,55 ,2 ,537 ,0 ,0 ,0 ,1 ,0 ,0 ,0 ,1 ,0 ,4 ,0 ,4,21772 , 0 
17641.444,10,55 ,14 ,531 ,0 ,0 ,2 ,0 ,0 ,0 ,0 ,2 ,0 ,1 ,0 ,1,9141 , 0 
17641.482,12,55 ,18 ,801 ,0 ,0 ,1 ,0 ,0 ,0 ,0 ,1 ,0 ,3 ,0 ,3,10429 , 0 
17641.596,9,55 ,5 ,800 ,0 ,0 ,1 ,0 ,0 ,0 ,0 ,1 ,0 ,2 ,0 ,2,18771 , 0 
17641.602,5,55 ,19 ,512 ,0 ,0 ,2 ,0 ,0 ,0 ,0 ,2 ,0 ,2 ,0 ,2,16665 , 0 
17641.606,19,55 ,1 ,256 ,0 ,0 ,1 ,0 ,1 ,0 ,0 ,2 ,0 ,1 ,1 ,2,10663 , 0 
17641.696,17,55 ,6 ,797 ,0 ,0 ,1 ,1 ,0 ,0 ,0 ,2 ,0 ,4 ,0 ,4,13890 , 0 
17641.771,13,55 ,1 ,256 ,0 ,0 ,1 ,0 ,0 ,0 ,0 ,1 ,0 ,1 ,0 ,1,9057 , 0 
17641.786,3,55 ,1 ,256 ,0 ,0 ,0 ,0 ,0 ,0 ,0 ,0 ,0 ,0 ,0 ,0,6421 , 0 
17760.96,8,55 ,1 ,256 ,0 ,0 ,1 ,0 ,0 ,0 ,0 ,1 ,0 ,1 ,0 ,1,7272 , 0 
17761.078,11,55 ,5 ,800 ,0 ,0 ,1 ,0 ,0 ,0 ,0 ,1 ,0 ,1 ,0 ,1,11665 , 0 
17761.123,2,55 ,1 ,256 ,0 ,0 ,2 ,0 ,1 ,0 ,0 ,3 ,0 ,1 ,1 ,2,13499 , 0 
17761.138,6,55 ,2 ,531 ,0 ,0 ,1 ,1 ,0 ,0 ,0 ,2 ,0 ,1 ,0 ,1,18881 , 0 
17761.214,18,55 ,19 ,517 ,0 ,0 ,0 ,0 ,0 ,0 ,0 ,0 ,0 ,2 ,0 ,2,9263 , 0 
17761.235,4,55 ,19 ,512 ,0 ,0 ,1 ,0 ,0 ,0 ,0 ,1 ,0 ,0 ,0 ,0,8353 , 0 
17761.289,7,55 ,16 ,830 ,0 ,0 ,1 ,0 ,0 ,0 ,0 ,1 ,0 ,0 ,0 ,0,16467 , 0 
17761.337,14,55 ,1 ,256 ,0 ,0 ,1 ,0 ,0 ,0 ,0 ,1 ,0 ,4 ,0 ,4,7938 , 0 
17761.35,15,55 ,9 ,1083 ,0 ,0 ,1 ,0 ,0 ,0 ,0 ,1 ,0 ,1 ,0 ,1,10640 , 0 
17761.359,20,55 ,5 ,798 ,0 ,0 ,2 ,0 ,0 ,0 ,0 ,2 ,0 ,2 ,0 ,2,8860 , 0 
17761.36,16,55 ,2 ,531 ,0 ,0 ,1 ,0 ,0 ,0 ,0 ,1 ,0 ,3 ,0 ,3,23141 , 1 
17761.444,10,55 ,14 ,531 ,0 ,0 ,1 ,0 ,0 ,0 ,0 ,1 ,0 ,0 ,0 ,0,9607 , 0 
17761.481,12,55 ,18 ,801 ,0 ,0 ,1 ,0 ,0 ,0 ,0 ,1 ,0 ,1 ,0 ,1,9814 , 0 
17761.596,9,55 ,5 ,800 ,0 ,0 ,0 ,0 ,0 ,0 ,0 ,0 ,0 ,2 ,0 ,2,18667 , 0 
17761.602,5,55 ,19 ,512 ,0 ,0 ,1 ,0 ,0 ,0 ,0 ,1 ,0 ,4 ,0 ,4,16049 , 0 
17761.606,19,55 ,1 ,256 ,0 ,0 ,1 ,0 ,0 ,0 ,0 ,1 ,0 ,2 ,0 ,2,10146 , 0 
17761.696,17,55 ,6 ,797 ,0 ,0 ,1 ,0 ,0 ,0 ,0 ,1 ,0 ,0 ,0 ,0,13494 , 0 
17761.771,13,55 ,1 ,256 ,0 ,0 ,1 ,0 ,0 ,0 ,0 ,1 ,0 ,2 ,0 ,2,8851 , 0 
17761.786,3,55 ,1 ,256 ,0 ,0 ,2 ,0 ,0 ,0 ,0 ,2 ,0 ,0 ,0 ,0,6022 , 0 
17880.96,8,55 ,1 ,256 ,0 ,0 ,2 ,0 ,0 ,0 ,0 ,2 ,0 ,1 ,0 ,1,7079 , 0 
17881.078,11,55 ,5 ,800 ,0 ,0 ,1 ,0 ,0 ,0 ,0 ,1 ,0 ,4 ,0 ,4,12834 , 0 
17881.123,2,55 ,1 ,256 ,0 ,0 ,0 ,0 ,1 ,0 ,1 ,2 ,0 ,1 ,2 ,3,12965 , 0 
17881.138,6,55 ,2 ,531 ,0 ,0 ,0 ,0 ,1 ,0 ,0 ,1 ,0 ,3 ,1 ,4,16876 , 0 
17881.214,18,55 ,19 ,517 ,0 ,0 ,2 ,0 ,0 ,0 ,0 ,2 ,0 ,0 ,0 ,0,10203 , 0 
17881.235,4,55 ,19 ,512 ,0 ,0 ,1 ,0 ,0 ,0 ,0 ,1 ,0 ,2 ,0 ,2,8820 , 0 
17881.289,7,55 ,17 ,1067 ,0 ,0 ,3 ,1 ,0 ,1 ,0 ,5 ,0 ,4 ,0 ,4,16208 , 0 
17881.337,14,55 ,1 ,256 ,0 ,0 ,1 ,0 ,0 ,0 ,0 ,1 ,0 ,0 ,0 ,0,8757 , 0 
17881.35,15,55 ,9 ,1080 ,0 ,0 ,1 ,1 ,0 ,0 ,0 ,2 ,0 ,4 ,0 ,4,12340 , 0 
17881.36,20,55 ,5 ,798 ,0 ,0 ,2 ,0 ,0 ,0 ,0 ,2 ,0 ,0 ,0 ,0,10190 , 0 
17881.36,16,55 ,2 ,531 ,0 ,0 ,2 ,0 ,0 ,0 ,1 ,3 ,0 ,3 ,1 ,4,21864 , 1 
17881.444,10,55 ,14 ,531 ,0 ,0 ,1 ,0 ,0 ,0 ,0 ,1 ,0 ,0 ,0 ,0,9202 , 0 
17881.482,12,55 ,18 ,813 ,0 ,0 ,1 ,0 ,0 ,0 ,0 ,1 ,0 ,2 ,0 ,2,10499 , 0 
17881.596,9,55 ,5 ,800 ,0 ,0 ,3 ,0 ,1 ,0 ,0 ,4 ,0 ,4 ,1 ,5,18879 , 0 
17881.602,5,55 ,19 ,512 ,0 ,0 ,0 ,0 ,1 ,0 ,0 ,1 ,0 ,4 ,1 ,5,16789 , 0 
17881.606,19,55 ,1 ,256 ,0 ,0 ,1 ,0 ,1 ,0 ,0 ,2 ,0 ,2 ,1 ,3,10764 , 0 
17881.696,17,55 ,6 ,797 ,0 ,0 ,1 ,0 ,1 ,0 ,0 ,2 ,0 ,3 ,1 ,4,13960 , 0 
17881.771,13,55 ,1 ,256 ,0 ,0 ,1 ,0 ,0 ,0 ,0 ,1 ,0 ,0 ,0 ,0,9125 , 0 
17881.786,3,55 ,1 ,256 ,0 ,0 ,1 ,0 ,0 ,0 ,0 ,1 ,0 ,1 ,0 ,1,6482 , 0 
18000.96,8,55 ,1 ,256 ,0 ,0 ,0 ,0 ,0 ,0 ,0 ,0 ,0 ,1 ,0 ,1,7327 , 0 
18001.078,11,55 ,5 ,800 ,0 ,0 ,1 ,0 ,0 ,0 ,0 ,1 ,0 ,3 ,0 ,3,11739 , 0 
18001.123,2,55 ,1 ,256 ,0 ,0 ,1 ,0 ,0 ,0 ,0 ,1 ,0 ,2 ,1 ,3,13590 , 0 
18001.138,6,55 ,2 ,531 ,0 ,0 ,1 ,0 ,0 ,0 ,0 ,1 ,0 ,0 ,0 ,0,18938 , 0 
18001.214,18,55 ,19 ,517 ,0 ,0 ,1 ,0 ,0 ,0 ,0 ,1 ,0 ,0 ,0 ,0,9337 , 0 
18001.235,4,55 ,19 ,512 ,0 ,0 ,1 ,0 ,0 ,0 ,0 ,1 ,0 ,0 ,0 ,0,8419 , 0 
18001.289,7,55 ,17 ,1067 ,0 ,0 ,4 ,0 ,0 ,0 ,0 ,4 ,0 ,2 ,0 ,2,16559 , 0 
18001.337,14,55 ,1 ,256 ,0 ,0 ,0 ,0 ,0 ,0 ,0 ,0 ,0 ,1 ,0 ,1,7995 , 0 
18001.35,15,55 ,9 ,1080 ,0 ,0 ,2 ,0 ,0 ,0 ,0 ,2 ,0 ,3 ,0 ,3,10716 , 0 
18001.359,20,55 ,5 ,798 ,0 ,0 ,1 ,0 ,0 ,0 ,0 ,1 ,0 ,0 ,0 ,0,8928 , 0 
18001.36,16,55 ,2 ,531 ,0 ,0 ,2 ,0 ,0 ,1 ,0 ,3 ,0 ,4 ,0 ,4,23221 , 1 
18001.444,10,55 ,14 ,531 ,0 ,0 ,1 ,0 ,0 ,0 ,0 ,1 ,0 ,1 ,0 ,1,9660 , 0 
18001.481,12,55 ,18 ,813 ,0 ,0 ,1 ,0 ,0 ,0 ,0 ,1 ,0 ,2 ,0 ,2,9908 , 0 
18001.596,9,55 ,5 ,800 ,0 ,0 ,0 ,0 ,0 ,0 ,0 ,0 ,0 ,6 ,0 ,6,18745 , 0 
18001.602,5,55 ,19 ,512 ,0 ,0 ,2 ,0 ,0 ,0 ,0 ,2 ,0 ,1 ,0 ,1,16146 , 0 
18001.606,19,55 ,1 ,256 ,0 ,0 ,0 ,0 ,0 ,0 ,0 ,0 ,0 ,1 ,0 ,1,10222 , 0 
18001.696,17,55 ,6 ,797 ,0 ,0 ,1 ,0 ,0 ,0 ,0 ,1 ,0 ,4 ,0 ,4,13567 , 0 
18001.771,13,55 ,1 ,256 ,0 ,0 ,1 ,0 ,0 ,0 ,0 ,1 ,0 ,1 ,0 ,1,8908 , 0 
18001.786,3,55 ,1 ,256 ,0 ,0 ,1 ,0 ,0 ,0 ,0 ,1 ,0 ,0 ,0 ,0,6078 , 0 
18120.96,8,55 ,1 ,256 ,0 ,0 ,2 ,0 ,0 ,0 ,0 ,2 ,0 ,3 ,0 ,3,7156 , 0 
18121.078,11,55 ,5 ,800 ,0 ,0 ,1 ,0 ,0 ,0 ,0 ,1 ,0 ,1 ,0 ,1,12892 , 0 
18121.123,2,55 ,1 ,256 ,0 ,0 ,3 ,0 ,3 ,0 ,0 ,6 ,0 ,2 ,3 ,5,13061 , 0 
18121.138,6,55 ,2 ,520 ,0 ,0 ,1 ,1 ,1 ,0 ,0 ,3 ,0 ,3 ,1 ,4,16987 , 0 
18121.214,18,55 ,19 ,517 ,0 ,0 ,1 ,0 ,0 ,0 ,0 ,1 ,0 ,2 ,0 ,2,10283 , 0 
18121.235,4,55 ,19 ,512 ,0 ,0 ,2 ,0 ,0 ,0 ,0 ,2 ,0 ,2 ,0 ,2,8898 , 0 
18121.289,7,55 ,17 ,1083 ,0 ,0 ,1 ,1 ,0 ,0 ,0 ,2 ,0 ,4 ,0 ,4,16274 , 0 
18121.337,14,55 ,1 ,256 ,0 ,0 ,2 ,0 ,0 ,0 ,0 ,2 ,0 ,3 ,0 ,3,8836 , 0 
18121.35,15,55 ,9 ,1074 ,0 ,0 ,1 ,1 ,0 ,0 ,0 ,2 ,0 ,3 ,0 ,3,12411 , 0 
18121.36,20,55 ,5 ,789 ,0 ,0 ,1 ,0 ,0 ,0 ,0 ,1 ,0 ,2 ,0 ,2,10251 , 0 
18121.36,16,55 ,2 ,520 ,0 ,0 ,1 ,1 ,0 ,0 ,0 ,2 ,0 ,5 ,0 ,5,21939 , 0 
18121.444,10,55 ,14 ,527 ,0 ,0 ,1 ,0 ,0 ,0 ,0 ,1 ,0 ,1 ,0 ,1,9277 , 0 
18121.482,12,55 ,18 ,813 ,0 ,0 ,0 ,0 ,0 ,0 ,0 ,0 ,0 ,0 ,0 ,0,10554 , 0 
18121.596,9,55 ,5 ,800 ,0 ,0 ,3 ,0 ,1 ,0 ,0 ,4 ,0 ,2 ,1 ,3,18974 , 0 
18121.602,5,55 ,19 ,512 ,0 ,0 ,1 ,0 ,1 ,0 ,0 ,2 ,0 ,5 ,1 ,6,16880 , 0 
18121.606,19,55 ,1 ,256 ,0 ,0 ,2 ,0 ,1 ,0 ,0 ,3 ,0 ,5 ,1 ,6,10851 , 0 
18121.696,17,55 ,6 ,797 ,0 ,0 ,2 ,0 ,1 ,0 ,0 ,3 ,0 ,1 ,1 ,2,14044 , 0 
18121.771,13,55 ,1 ,256 ,0 ,0 ,1 ,0 ,0 ,0 ,0 ,1 ,0 ,4 ,0 ,4,9197 , 0 
18121.786,3,55 ,1 ,256 ,0 ,0 ,1 ,0 ,0 ,0 ,0 ,1 ,0 ,3 ,0 ,3,6549 , 0 
18240.96,8,55 ,1 ,256 ,0 ,0 ,1 ,0 ,0 ,0 ,0 ,1 ,0 ,2 ,0 ,2,7395 , 0 
18241.078,11,55 ,5 ,786 ,0 ,0 ,1 ,1 ,0 ,0 ,0 ,2 ,0 ,4 ,0 ,4,11814 , 0 
18241.123,2,55 ,1 ,256 ,0 ,0 ,0 ,0 ,2 ,0 ,0 ,2 ,0 ,3 ,2 ,5,13676 , 0 
18241.138,6,55 ,2 ,520 ,0 ,0 ,2 ,0 ,2 ,0 ,0 ,4 ,0 ,1 ,2 ,3,19017 , 0 
18241.214,18,55 ,19 ,517 ,0 ,0 ,2 ,0 ,0 ,0 ,0 ,2 ,0 ,1 ,0 ,1,9406 , 0 
18241.235,4,55 ,19 ,512 ,0 ,0 ,1 ,0 ,0 ,0 ,0 ,1 ,0 ,0 ,0 ,0,8481 , 0 
18241.289,7,55 ,17 ,1083 ,0 ,0 ,1 ,0 ,0 ,0 ,0 ,1 ,0 ,1 ,0 ,1,16626 , 0 
18241.337,14,55 ,1 ,256 ,0 ,0 ,1 ,0 ,0 ,0 ,0 ,1 ,0 ,2 ,0 ,2,8090 , 0 
18241.35,15,55 ,9 ,1074 ,0 ,0 ,1 ,0 ,0 ,0 ,0 ,1 ,0 ,0 ,0 ,0,10773 , 0 
18241.359,20,55 ,5 ,789 ,0 ,0 ,1 ,0 ,0 ,0 ,0 ,1 ,0 ,0 ,0 ,0,8990 , 0 
18241.36,16,55 ,2 ,520 ,0 ,0 ,1 ,0 ,0 ,0 ,0 ,1 ,0 ,4 ,0 ,4,23340 , 0 
18241.444,10,55 ,14 ,527 ,0 ,0 ,1 ,0 ,0 ,0 ,0 ,1 ,0 ,1 ,0 ,1,9715 , 0 
18241.481,12,55 ,18 ,847 ,0 ,0 ,1 ,0 ,0 ,0 ,0 ,1 ,0 ,1 ,0 ,1,9973 , 0 
18241.596,9,55 ,5 ,800 ,0 ,0 ,2 ,0 ,0 ,0 ,0 ,2 ,0 ,0 ,0 ,0,18841 , 0 
18241.602,5,55 ,19 ,512 ,0 ,0 ,1 ,0 ,1 ,0 ,0 ,2 ,0 ,2 ,1 ,3,16255 , 0 
18241.606,19,55 ,1 ,256 ,0 ,0 ,1 ,0 ,1 ,0 ,0 ,2 ,0 ,1 ,1 ,2,10317 , 0 
18241.696,17,55 ,6 ,819 ,0 ,0 ,1 ,2 ,0 ,0 ,0 ,3 ,0 ,2 ,0 ,2,13657 , 0 
18241.771,13,55 ,1 ,256 ,0 ,0 ,2 ,0 ,0 ,0 ,0 ,2 ,0 ,0 ,0 ,0,8982 , 0 
18241.786,3,55 ,1 ,256 ,0 ,0 ,2 ,0 ,0 ,0 ,0 ,2 ,0 ,1 ,0 ,1,6135 , 0 
18360.96,8,55 ,1 ,256 ,0 ,0 ,1 ,0 ,0 ,0 ,0 ,1 ,0 ,1 ,0 ,1,7216 , 0 
18361.078,11,55 ,5 ,786 ,0 ,0 ,1 ,0 ,0 ,0 ,0 ,1 ,0 ,1 ,0 ,1,12958 , 0 
18361.123,2,55 ,1 ,256 ,0 ,0 ,1 ,0 ,0 ,0 ,0 ,1 ,0 ,1 ,0 ,1,13126 , 0 
18361.138,6,55 ,2 ,520 ,0 ,0 ,2 ,0 ,0 ,0 ,0 ,2 ,0 ,1 ,0 ,1,17066 , 0 
18361.214,18,55 ,19 ,512 ,0 ,0 ,1 ,0 ,0 ,0 ,0 ,1 ,0 ,2 ,0 ,2,10347 , 0 
18361.235,4,55 ,19 ,512 ,0 ,0 ,1 ,0 ,0 ,0 ,0 ,1 ,0 ,1 ,0 ,1,8964 , 0 
18361.289,7,55 ,17 ,1083 ,0 ,0 ,2 ,0 ,0 ,0 ,0 ,2 ,0 ,0 ,0 ,0,16350 , 0 
18361.337,14,55 ,1 ,256 ,0 ,0 ,1 ,0 ,0 ,0 ,0 ,1 ,0 ,1 ,0 ,1,8895 , 0 
18361.35,15,55 ,9 ,1094 ,0 ,0 ,1 ,1 ,0 ,0 ,0 ,2 ,0 ,3 ,0 ,3,12486 , 0 
18361.36,20,55 ,5 ,789 ,0 ,0 ,2 ,0 ,0 ,0 ,0 ,2 ,0 ,0 ,0 ,0,10320 , 0 
18361.36,16,55 ,2 ,520 ,0 ,0 ,0 ,0 ,0 ,0 ,0 ,0 ,0 ,2 ,0 ,2,21999 , 0 
18361.444,10,55 ,14 ,527 ,0 ,0 ,1 ,0 ,0 ,0 ,0 ,1 ,0 ,1 ,0 ,1,9329 , 0 
18361.482,12,55 ,18 ,847 ,0 ,0 ,1 ,0 ,0 ,0 ,0 ,1 ,0 ,4 ,0 ,4,10644 , 0 
18361.596,9,55 ,5 ,800 ,0 ,0 ,1 ,0 ,1 ,0 ,0 ,2 ,0 ,3 ,1 ,4,19047 , 0 
18361.602,5,55 ,19 ,512 ,0 ,0 ,1 ,0 ,1 ,0 ,0 ,2 ,0 ,3 ,1 ,4,16968 , 0 
18361.606,19,55 ,1 ,256 ,0 ,0 ,2 ,0 ,1 ,0 ,0 ,3 ,0 ,1 ,1 ,2,10943 , 0 
18361.696,17,55 ,6 ,819 ,0 ,0 ,1 ,0 ,0 ,0 ,0 ,1 ,0 ,1 ,0 ,1,14114 , 0 
18361.771,13,55 ,1 ,256 ,0 ,0 ,1 ,0 ,0 ,0 ,0 ,1 ,0 ,2 ,0 ,2,9279 , 0 
18361.786,3,55 ,1 ,256 ,0 ,0 ,1 ,0 ,0 ,0 ,0 ,1 ,0 ,1 ,0 ,1,6604 , 0 
18480.96,8,58 ,1 ,256 ,0 ,0 ,4 ,2 ,0 ,2 ,0 ,8 ,0 ,6 ,0 ,6,7571 , 0 
18481.078,11,63 ,5 ,824 ,0 ,0 ,5 ,2 ,2 ,4 ,1 ,14 ,0 ,14 ,5 ,19,12119 , 0 
18481.124,2,58 ,1 ,256 ,0 ,0 ,5 ,3 ,1 ,3 ,4 ,16 ,0 ,6 ,6 ,12,14051 , 0 
18481.138,6,57 ,17 ,1604 ,0 ,0 ,4 ,1 ,3 ,1 ,3 ,12 ,0 ,4 ,6 ,10,19287 , 0 
18481.221,18,58 ,5 ,824 ,0 ,0 ,6 ,4 ,1 ,5 ,1 ,17 ,0 ,7 ,2 ,9,9810 , 0 
18481.236,4,58 ,19 ,512 ,0 ,0 ,5 ,3 ,0 ,3 ,0 ,11 ,0 ,4 ,0 ,4,8751 , 0 
18481.29,7,64 ,17 ,65535 ,0 ,0 ,5 ,0 ,1 ,1 ,0 ,7 ,0 ,4 ,10 ,14,16791 , 1 
18481.34,14,58 ,1 ,256 ,0 ,0 ,5 ,4 ,1 ,5 ,1 ,16 ,0 ,8 ,2 ,10,8431 , 0 
18481.35,15,63 ,7 ,1339 ,0 ,0 ,6 ,2 ,1 ,6 ,1 ,16 ,0 ,6 ,3 ,9,11101 , 0 
18481.36,20,58 ,5 ,768 ,0 ,0 ,5 ,4 ,0 ,3 ,0 ,12 ,0 ,6 ,1 ,7,9292 , 0 
18481.361,16,57 ,17 ,65535 ,0 ,0 ,6 ,2 ,0 ,3 ,0 ,11 ,0 ,6 ,1 ,7,23623 , 0 
18481.443,10,57 ,0 ,0 ,0 ,0 ,3 ,3 ,0 ,2 ,0 ,8 ,0 ,5 ,0 ,5,10016 , 0 
18481.482,12,58 ,18 ,821 ,0 ,0 ,6 ,4 ,0 ,7 ,0 ,17 ,0 ,8 ,0 ,8,10358 , 0 
18481.596,9,63 ,5 ,65535 ,0 ,0 ,4 ,1 ,1 ,3 ,2 ,11 ,0 ,9 ,6 ,15,19236 , 0 
18481.603,5,58 ,19 ,512 ,0 ,0 ,6 ,3 ,1 ,3 ,3 ,16 ,0 ,11 ,8 ,19,16608 , 0 
18481.607,19,58 ,1 ,256 ,0 ,0 ,4 ,2 ,4 ,4 ,6 ,20 ,0 ,7 ,11 ,18,10576 , 0 
18481.697,17,57 ,16 ,65535 ,0 ,0 ,5 ,1 ,0 ,4 ,0 ,10 ,0 ,4 ,10 ,14,13865 , 0 
18481.786,3,58 ,1 ,256 ,0 ,0 ,2 ,1 ,0 ,1 ,0 ,4 ,0 ,2 ,0 ,2,6240 , 0 
18481.916,13,58 ,5 ,768 ,0 ,0 ,5 ,3 ,0 ,5 ,0 ,13 ,0 ,6 ,0 ,6,9330 , 0 
18600.961,8,100 ,1 ,256 ,0 ,0 ,19 ,8 ,8 ,11 ,6 ,52 ,0 ,46 ,15 ,61,7600 , 0 
18601.078,11,100 ,0 ,0 ,0 ,0 ,21 ,1 ,0 ,0 ,0 ,22 ,0 ,66 ,0 ,66,13206 , 0 
18601.124,2,100 ,1 ,256 ,0 ,0 ,17 ,5 ,1 ,10 ,1 ,34 ,0 ,80 ,3 ,83,13487 , 0 
18601.138,6,100 ,2 ,512 ,0 ,0 ,17 ,2 ,1 ,4 ,0 ,24 ,0 ,49 ,3 ,52,17354 , 0 
18601.232,18,100 ,19 ,512 ,0 ,0 ,20 ,6 ,1 ,11 ,1 ,39 ,0 ,52 ,3 ,55,10832 , 0 
18601.236,4,100 ,19 ,512 ,0 ,0 ,17 ,9 ,0 ,9 ,0 ,35 ,0 ,41 ,3 ,44,9437 , 0 
18601.29,7,106 ,17 ,65535 ,0 ,0 ,21 ,0 ,0 ,0 ,0 ,21 ,0 ,46 ,0 ,46,16574 , 1 
18601.345,14,100 ,1 ,256 ,0 ,0 ,17 ,9 ,12 ,12 ,7 ,57 ,0 ,59 ,27 ,86,9342 , 0 
18601.35,15,99 ,7 ,1339 ,0 ,0 ,19 ,0 ,0 ,0 ,0 ,19 ,0 ,51 ,0 ,51,12686 , 0 
18601.36,20,100 ,0 ,0 ,0 ,0 ,18 ,4 ,0 ,5 ,0 ,27 ,0 ,46 ,0 ,46,10671 , 0 
18601.361,16,105 ,17 ,65535 ,0 ,0 ,18 ,0 ,0 ,0 ,0 ,18 ,0 ,47 ,0 ,47,22220 , 0 
18601.444,10,100 ,14 ,512 ,0 ,0 ,17 ,10 ,1 ,10 ,1 ,39 ,0 ,27 ,2 ,29,9782 , 0 
18601.482,12,99 ,18 ,768 ,0 ,0 ,20 ,3 ,0 ,5 ,0 ,28 ,0 ,56 ,2 ,58,10998 , 0 
18601.596,9,105 ,5 ,865 ,0 ,0 ,21 ,0 ,0 ,1 ,0 ,22 ,0 ,63 ,0 ,63,19289 , 0 
18601.603,5,100 ,19 ,512 ,0 ,0 ,20 ,2 ,4 ,8 ,1 ,35 ,0 ,85 ,19 ,104,17509 , 0 
18601.608,19,100 ,1 ,256 ,0 ,0 ,20 ,5 ,9 ,12 ,2 ,48 ,0 ,80 ,26 ,106,11411 , 0 
18601.697,17,105 ,6 ,1024 ,0 ,0 ,18 ,0 ,0 ,2 ,0 ,20 ,0 ,40 ,1 ,41,14359 , 0 
18601.772,13,100 ,1 ,256 ,0 ,0 ,19 ,7 ,4 ,10 ,1 ,41 ,0 ,58 ,9 ,67,9676 , 0 
18601.787,3,100 ,1 ,256 ,0 ,0 ,19 ,11 ,6 ,13 ,2 ,51 ,0 ,35 ,9 ,44,6946 , 0 
18720.96,8,0 ,1 ,256 ,0 ,0 ,15 ,10 ,3 ,12 ,3 ,43 ,0 ,40 ,8 ,48,7994 , 0 
18721.078,11,0 ,20 ,1552 ,0 ,0 ,19 ,2 ,3 ,4 ,0 ,28 ,0 ,54 ,3 ,57,12564 , 0 
18721.124,2,0 ,0 ,65535 ,0 ,0 ,18 ,6 ,2 ,10 ,0 ,36 ,0 ,50 ,8 ,58,14732 , 0 
18721.138,6,2 ,2 ,793 ,0 ,0 ,18 ,5 ,0 ,6 ,0 ,29 ,0 ,38 ,0 ,38,19843 , 0 
18721.214,18,0 ,5 ,1682 ,0 ,0 ,18 ,4 ,0 ,6 ,1 ,29 ,0 ,35 ,1 ,36,10250 , 0 
18721.236,4,127 ,8 ,512 ,0 ,0 ,15 ,6 ,0 ,9 ,0 ,30 ,0 ,26 ,0 ,26,9195 , 0 
18721.289,7,9 ,9 ,2048 ,0 ,0 ,19 ,2 ,0 ,1 ,0 ,22 ,0 ,33 ,0 ,33,17281 , 1 
18721.338,14,0 ,1 ,256 ,0 ,0 ,16 ,8 ,12 ,10 ,7 ,53 ,0 ,42 ,26 ,68,9012 , 0 
18721.35,15,0 ,11 ,1808 ,0 ,0 ,21 ,4 ,0 ,4 ,0 ,29 ,0 ,39 ,0 ,39,11706 , 0 
18721.36,20,0 ,5 ,1536 ,0 ,0 ,19 ,3 ,4 ,3 ,0 ,29 ,0 ,31 ,5 ,36,9929 , 0 
18721.361,16,2 ,9 ,2048 ,0 ,0 ,20 ,2 ,0 ,4 ,0 ,26 ,0 ,31 ,0 ,31,24098 , 0 
18721.444,10,131 ,14 ,537 ,0 ,0 ,14 ,4 ,0 ,6 ,0 ,24 ,0 ,21 ,1 ,22,10332 , 0 
18721.482,12,0 ,20 ,1552 ,0 ,0 ,18 ,2 ,0 ,2 ,0 ,22 ,0 ,43 ,3 ,46,10870 , 0 
18721.596,9,0 ,11 ,1808 ,0 ,0 ,21 ,3 ,1 ,2 ,0 ,27 ,0 ,50 ,3 ,53,19740 , 0 
18721.603,5,0 ,13 ,768 ,0 ,0 ,21 ,3 ,6 ,6 ,1 ,37 ,0 ,63 ,13 ,76,17213 , 0 
18721.607,19,0 ,13 ,768 ,0 ,0 ,18 ,8 ,4 ,13 ,7 ,50 ,0 ,50 ,18 ,68,11171 , 0 
18721.772,13,0 ,14 ,537 ,0 ,0 ,16 ,6 ,3 ,11 ,1 ,37 ,0 ,45 ,12 ,57,9970 , 0 
18721.787,3,0 ,1 ,256 ,0 ,0 ,18 ,10 ,1 ,10 ,1 ,40 ,0 ,29 ,4 ,33,6801 , 0 
18721.797,17,8 ,7 ,4264 ,0 ,0 ,16 ,1 ,0 ,1 ,0 ,18 ,0 ,34 ,0 ,34,14194 , 0 
18840.96,8,11 ,1 ,256 ,0 ,0 ,7 ,3 ,6 ,4 ,3 ,23 ,0 ,15 ,10 ,25,7841 , 0 
18841.08,11,11 ,20 ,2175 ,0 ,0 ,15 ,5 ,7 ,8 ,4 ,39 ,0 ,21 ,13 ,34,13947 , 0 
18841.124,2,11 ,1 ,256 ,0 ,0 ,13 ,6 ,16 ,6 ,5 ,46 ,0 ,16 ,29 ,45,14274 , 0 
18841.139,6,11 ,10 ,1104 ,0 ,0 ,15 ,5 ,16 ,8 ,6 ,50 ,0 ,14 ,25 ,39,18305 , 0 
18841.214,18,11 ,19 ,531 ,0 ,0 ,9 ,4 ,6 ,3 ,3 ,25 ,0 ,13 ,9 ,22,11375 , 0 
18841.236,4,11 ,8 ,757 ,0 ,0 ,9 ,4 ,1 ,2 ,1 ,17 ,0 ,12 ,3 ,15,9785 , 0 
18841.29,7,11 ,17 ,1638 ,0 ,0 ,13 ,3 ,10 ,3 ,4 ,33 ,0 ,18 ,17 ,35,17188 , 0 
18841.338,14,11 ,1 ,256 ,0 ,0 ,10 ,5 ,17 ,8 ,8 ,48 ,0 ,20 ,35 ,55,9929 , 0 
18841.35,15,11 ,11 ,2431 ,0 ,0 ,15 ,9 ,2 ,7 ,2 ,35 ,0 ,20 ,4 ,24,13307 , 0 
18841.36,20,11 ,5 ,1067 ,0 ,0 ,9 ,5 ,4 ,5 ,1 ,24 ,0 ,14 ,5 ,19,11233 , 0 
18841.361,16,11 ,2 ,520 ,0 ,0 ,15 ,5 ,12 ,3 ,4 ,39 ,0 ,19 ,20 ,39,22974 , 0 
18841.444,10,11 ,14 ,543 ,0 ,0 ,8 ,5 ,9 ,6 ,2 ,30 ,0 ,14 ,13 ,27,10407 , 0 
18841.482,12,11 ,18 ,1326 ,0 ,0 ,10 ,5 ,4 ,3 ,3 ,25 ,0 ,15 ,10 ,25,11558 , 0 
18841.596,9,11 ,16 ,2078 ,0 ,0 ,15 ,9 ,7 ,8 ,2 ,41 ,0 ,27 ,12 ,39,20122 , 0 
18841.603,5,11 ,19 ,537 ,0 ,0 ,12 ,5 ,12 ,8 ,6 ,43 ,0 ,27 ,31 ,58,18469 , 0 
18841.607,19,11 ,1 ,256 ,0 ,0 ,10 ,4 ,14 ,6 ,4 ,38 ,0 ,28 ,24 ,52,11863 , 0 
18841.697,17,11 ,6 ,1360 ,0 ,0 ,12 ,6 ,14 ,8 ,3 ,43 ,0 ,15 ,17 ,32,15126 , 0 
18841.772,13,11 ,1 ,256 ,0 ,0 ,13 ,6 ,4 ,11 ,4 ,38 ,0 ,14 ,8 ,22,10434 , 0 
18841.787,3,11 ,1 ,256 ,0 ,0 ,8 ,8 ,1 ,4 ,1 ,22 ,0 ,12 ,3 ,15,7232 , 0 
18960.96,8,11 ,1 ,256 ,0 ,0 ,2 ,2 ,1 ,0 ,0 ,5 ,0 ,4 ,1 ,5,8080 , 0 
18961.078,11,11 ,9 ,1399 ,0 ,0 ,6 ,6 ,1 ,3 ,1 ,17 ,0 ,14 ,2 ,16,12743 , 0 
18961.124,2,11 ,1 ,256 ,0 ,0 ,3 ,1 ,18 ,1 ,2 ,25 ,0 ,12 ,21 ,33,14852 , 0 
18961.138,6,11 ,10 ,942 ,0 ,0 ,4 ,2 ,0 ,2 ,1 ,9 ,0 ,13 ,1 ,14,19971 , 0 
18961.214,18,11 ,19 ,525 ,0 ,0 ,2 ,1 ,0 ,3 ,1 ,7 ,0 ,8 ,4 ,12,10377 , 0 
18961.235,4,11 ,8 ,690 ,0 ,0 ,2 ,1 ,0 ,0 ,0 ,3 ,0 ,4 ,0 ,4,9280 , 0 
18961.289,7,11 ,16 ,947 ,0 ,0 ,6 ,2 ,6 ,2 ,1 ,17 ,0 ,21 ,8 ,29,17465 , 0 
18961.337,14,11 ,1 ,256 ,0 ,0 ,2 ,2 ,3 ,2 ,1 ,10 ,0 ,7 ,5 ,12,9133 , 0 
18961.35,15,11 ,7 ,1215 ,0 ,0 ,7 ,3 ,0 ,2 ,0 ,12 ,0 ,13 ,0 ,13,11866 , 0 
18961.36,20,11 ,5 ,898 ,0 ,0 ,3 ,2 ,1 ,2 ,2 ,10 ,0 ,11 ,3 ,14,10064 , 0 
18961.361,16,11 ,2 ,512 ,0 ,0 ,5 ,1 ,17 ,1 ,2 ,26 ,0 ,16 ,22 ,38,24426 , 0 
18961.444,10,11 ,14 ,526 ,0 ,0 ,3 ,1 ,2 ,1 ,1 ,8 ,0 ,3 ,5 ,8,10480 , 0 
18961.482,12,11 ,5 ,898 ,0 ,0 ,5 ,1 ,0 ,4 ,0 ,10 ,0 ,9 ,0 ,9,11055 , 0 
18961.596,9,11 ,16 ,947 ,0 ,0 ,8 ,4 ,6 ,3 ,0 ,21 ,0 ,19 ,8 ,27,20033 , 0 
18961.603,5,11 ,19 ,525 ,0 ,0 ,2 ,0 ,4 ,2 ,2 ,10 ,0 ,22 ,8 ,30,17418 , 0 
18961.607,19,11 ,1 ,256 ,0 ,0 ,2 ,1 ,5 ,3 ,3 ,14 ,0 ,8 ,13 ,21,11322 , 0 
18961.697,17,11 ,16 ,825 ,0 ,0 ,8 ,3 ,0 ,2 ,1 ,14 ,0 ,12 ,1 ,13,14328 , 0 
18961.771,13,11 ,1 ,256 ,0 ,0 ,3 ,1 ,0 ,0 ,0 ,4 ,0 ,9 ,0 ,9,10074 , 0 
18961.786,3,11 ,1 ,256 ,0 ,0 ,3 ,1 ,0 ,0 ,0 ,4 ,0 ,4 ,0 ,4,6890 , 0 
19080.96,8,11 ,1 ,256 ,0 ,0 ,2 ,0 ,1 ,0 ,0 ,3 ,0 ,3 ,1 ,4,7915 , 0 
19081.078,11,11 ,5 ,847 ,0 ,0 ,5 ,3 ,0 ,1 ,0 ,9 ,0 ,10 ,0 ,10,14054 , 0 
19081.123,2,11 ,1 ,256 ,0 ,0 ,2 ,0 ,5 ,1 ,1 ,9 ,0 ,6 ,7 ,13,14375 , 0 
19081.138,6,11 ,10 ,965 ,0 ,0 ,2 ,2 ,0 ,0 ,0 ,4 ,0 ,6 ,0 ,6,18392 , 0 
19081.214,18,11 ,19 ,513 ,0 ,0 ,1 ,1 ,0 ,1 ,0 ,3 ,0 ,5 ,0 ,5,11449 , 0 
19081.235,4,11 ,8 ,628 ,0 ,0 ,2 ,1 ,0 ,0 ,0 ,3 ,0 ,4 ,0 ,4,9868 , 0 
19081.289,7,11 ,16 ,816 ,0 ,0 ,0 ,1 ,0 ,0 ,0 ,1 ,0 ,4 ,0 ,4,17254 , 0 
19081.337,14,11 ,1 ,256 ,0 ,0 ,2 ,0 ,3 ,0 ,0 ,5 ,0 ,4 ,3 ,7,10001 , 0 
19081.35,15,11 ,7 ,1215 ,0 ,0 ,2 ,0 ,0 ,0 ,0 ,2 ,0 ,5 ,0 ,5,13374 , 0 
19081.36,20,11 ,5 ,847 ,0 ,0 ,2 ,1 ,0 ,0 ,0 ,3 ,0 ,8 ,0 ,8,11299 , 0 
19081.36,16,11 ,2 ,512 ,0 ,0 ,2 ,1 ,4 ,1 ,1 ,9 ,0 ,3 ,6 ,9,23119 , 0 
19081.444,10,11 ,14 ,514 ,0 ,0 ,2 ,1 ,2 ,0 ,0 ,5 ,0 ,1 ,2 ,3,10506 , 0 
19081.482,12,11 ,5 ,847 ,0 ,0 ,4 ,1 ,0 ,0 ,0 ,5 ,0 ,7 ,0 ,7,11644 , 0 
19081.596,9,11 ,16 ,816 ,0 ,0 ,1 ,1 ,1 ,1 ,1 ,5 ,0 ,7 ,2 ,9,20219 , 0 
19081.603,5,11 ,19 ,513 ,0 ,0 ,2 ,1 ,4 ,0 ,0 ,7 ,0 ,15 ,4 ,19,18599 , 0 
19081.606,19,11 ,1 ,256 ,0 ,0 ,2 ,0 ,6 ,0 ,0 ,8 ,0 ,8 ,7 ,15,11977 , 0 
19081.696,17,11 ,16 ,816 ,0 ,0 ,1 ,1 ,0 ,0 ,0 ,2 ,0 ,1 ,0 ,1,15186 , 0 
19081.771,13,11 ,1 ,256 ,0 ,0 ,2 ,0 ,0 ,0 ,0 ,2 ,0 ,3 ,0 ,3,10512 , 0 
19081.786,3,11 ,1 ,256 ,0 ,0 ,2 ,0 ,0 ,0 ,0 ,2 ,0 ,3 ,0 ,3,7299 , 0 
19200.96,8,11 ,1 ,256 ,0 ,0 ,1 ,0 ,1 ,0 ,0 ,2 ,0 ,1 ,1 ,2,8168 , 0 
19201.078,11,11 ,9 ,300 ,0 ,0 ,6 ,10 ,11 ,2 ,1 ,30 ,0 ,34 ,12 ,46,13259 , 0 
19201.124,2,11 ,1 ,256 ,0 ,0 ,4 ,0 ,16 ,0 ,9 ,29 ,0 ,18 ,28 ,46,15090 , 0 
19201.138,6,11 ,10 ,927 ,0 ,0 ,7 ,5 ,0 ,2 ,0 ,14 ,0 ,15 ,0 ,15,20198 , 0 
19201.214,18,11 ,19 ,580 ,0 ,0 ,3 ,1 ,0 ,0 ,0 ,4 ,0 ,17 ,0 ,17,10520 , 0 
19201.235,4,11 ,8 ,616 ,0 ,0 ,0 ,1 ,0 ,0 ,0 ,1 ,0 ,3 ,0 ,3,9347 , 0 
19201.29,7,11 ,9 ,300 ,0 ,0 ,12 ,10 ,8 ,6 ,4 ,40 ,0 ,28 ,23 ,51,17913 , 0 
19201.337,14,11 ,1 ,256 ,0 ,0 ,0 ,0 ,2 ,1 ,1 ,4 ,0 ,2 ,4 ,6,9225 , 0 
19201.351,15,11 ,9 ,65535 ,0 ,0 ,15 ,11 ,0 ,11 ,0 ,37 ,0 ,22 ,10 ,32,12328 , 0 
19201.36,20,11 ,11 ,778 ,0 ,0 ,7 ,5 ,0 ,1 ,0 ,13 ,0 ,19 ,0 ,19,10345 , 0 
19201.361,16,11 ,9 ,300 ,0 ,0 ,12 ,9 ,12 ,9 ,5 ,47 ,0 ,27 ,34 ,61,25016 , 0 
19201.444,10,11 ,14 ,514 ,0 ,0 ,2 ,0 ,2 ,1 ,1 ,6 ,0 ,6 ,3 ,9,10605 , 0 
19201.482,12,11 ,5 ,583 ,0 ,0 ,8 ,9 ,0 ,2 ,0 ,19 ,0 ,18 ,0 ,18,11442 , 0 
19201.597,9,11 ,15 ,65535 ,0 ,0 ,16 ,5 ,30 ,19 ,4 ,74 ,0 ,36 ,86 ,122,20843 , 1 
19201.603,5,11 ,9 ,300 ,0 ,0 ,12 ,6 ,4 ,12 ,3 ,37 ,0 ,29 ,21 ,50,17947 , 0 
19201.607,19,11 ,1 ,256 ,0 ,0 ,2 ,0 ,1 ,4 ,4 ,11 ,0 ,12 ,5 ,17,11493 , 0 
19201.697,17,11 ,16 ,585 ,0 ,0 ,8 ,6 ,2 ,2 ,1 ,19 ,0 ,21 ,3 ,24,14592 , 0 
19201.771,13,11 ,1 ,256 ,0 ,0 ,1 ,0 ,0 ,0 ,0 ,1 ,0 ,8 ,0 ,8,10207 , 0 
19201.786,3,11 ,1 ,256 ,0 ,0 ,1 ,0 ,0 ,0 ,0 ,1 ,0 ,0 ,0 ,0,6943 , 0 
19320.96,8,11 ,1 ,256 ,0 ,0 ,2 ,0 ,0 ,0 ,0 ,2 ,0 ,2 ,0 ,2,8015 , 0 
19321.078,11,11 ,9 ,300 ,0 ,0 ,7 ,12 ,6 ,2 ,1 ,28 ,0 ,30 ,8 ,38,14432 , 0 
19321.124,2,11 ,1 ,256 ,0 ,0 ,7 ,0 ,17 ,4 ,8 ,36 ,0 ,20 ,26 ,46,14628 , 0 
19321.138,6,11 ,10 ,910 ,0 ,0 ,9 ,1 ,0 ,0 ,0 ,10 ,0 ,28 ,0 ,28,18582 , 0 
19321.214,18,11 ,19 ,580 ,0 ,0 ,0 ,0 ,0 ,0 ,0 ,0 ,0 ,5 ,0 ,5,11544 , 0 
19321.235,4,11 ,8 ,616 ,0 ,0 ,3 ,0 ,0 ,0 ,0 ,3 ,0 ,0 ,0 ,0,9978 , 0 
19321.338,14,11 ,0 ,65535 ,0 ,0 ,2 ,0 ,1 ,1 ,0 ,4 ,0 ,8 ,1 ,9,10121 , 0 
19321.342,7,11 ,9 ,65535 ,0 ,0 ,17 ,12 ,25 ,10 ,4 ,68 ,0 ,44 ,46 ,90,17961 , 0 
19321.35,15,11 ,9 ,300 ,0 ,0 ,14 ,11 ,0 ,9 ,0 ,34 ,0 ,31 ,12 ,43,13747 , 0 
19321.36,20,11 ,11 ,843 ,0 ,0 ,4 ,5 ,0 ,0 ,0 ,9 ,0 ,8 ,0 ,8,11442 , 0 
19321.361,16,11 ,2 ,512 ,0 ,0 ,18 ,12 ,37 ,16 ,6 ,89 ,0 ,43 ,66 ,109,23967 , 0 
19321.444,10,11 ,14 ,514 ,0 ,0 ,2 ,0 ,1 ,0 ,0 ,3 ,0 ,8 ,1 ,9,10592 , 0 
19321.482,12,11 ,5 ,582 ,0 ,0 ,3 ,2 ,0 ,0 ,0 ,5 ,0 ,11 ,0 ,11,11777 , 0 
19321.603,5,11 ,9 ,300 ,0 ,0 ,3 ,10 ,2 ,0 ,0 ,15 ,0 ,26 ,3 ,29,18926 , 0 
19321.606,19,11 ,1 ,256 ,0 ,0 ,1 ,0 ,0 ,0 ,0 ,1 ,0 ,8 ,0 ,8,12074 , 0 
19321.661,9,11 ,7 ,65535 ,0 ,0 ,19 ,11 ,41 ,23 ,5 ,99 ,0 ,39 ,107 ,146,21124 , 1 
19321.697,17,11 ,16 ,786 ,0 ,0 ,10 ,10 ,0 ,3 ,0 ,23 ,0 ,36 ,0 ,36,15533 , 0 
19321.771,13,11 ,1 ,256 ,0 ,0 ,2 ,0 ,0 ,0 ,0 ,2 ,0 ,6 ,0 ,6,10602 , 0 
19321.786,3,11 ,1 ,256 ,0 ,0 ,1 ,0 ,0 ,0 ,0 ,1 ,0 ,2 ,0 ,2,7381 , 0 
19440.96,8,11 ,1 ,256 ,0 ,0 ,1 ,0 ,1 ,0 ,0 ,2 ,0 ,2 ,1 ,3,8240 , 0 
19441.084,11,11 ,9 ,300 ,0 ,0 ,2 ,15 ,1 ,1 ,0 ,19 ,0 ,32 ,1 ,33,13620 , 0 
19441.124,2,11 ,1 ,256 ,0 ,0 ,2 ,0 ,8 ,0 ,4 ,14 ,0 ,20 ,16 ,36,15276 , 0 
19441.138,6,11 ,10 ,910 ,0 ,0 ,4 ,0 ,0 ,0 ,0 ,4 ,0 ,23 ,0 ,23,20358 , 0 
19441.214,18,11 ,19 ,580 ,0 ,0 ,2 ,0 ,0 ,0 ,0 ,2 ,0 ,1 ,0 ,1,10624 , 0 
19441.235,4,11 ,8 ,610 ,0 ,0 ,1 ,1 ,0 ,0 ,0 ,2 ,0 ,3 ,0 ,3,9432 , 0 
19441.29,7,11 ,9 ,300 ,0 ,0 ,18 ,18 ,16 ,21 ,7 ,80 ,0 ,48 ,46 ,94,18581 , 0 
19441.337,14,11 ,3 ,536 ,0 ,0 ,5 ,1 ,3 ,0 ,0 ,9 ,0 ,2 ,3 ,5,9351 , 0 
19441.351,15,11 ,9 ,300 ,0 ,0 ,17 ,15 ,6 ,14 ,0 ,52 ,0 ,36 ,30 ,66,12848 , 0 
19441.36,20,11 ,11 ,681 ,0 ,0 ,2 ,1 ,0 ,0 ,0 ,3 ,0 ,4 ,0 ,4,10438 , 0 
19441.444,10,11 ,14 ,792 ,0 ,0 ,0 ,3 ,0 ,0 ,0 ,3 ,0 ,4 ,0 ,4,10673 , 0 
19441.482,12,11 ,5 ,802 ,0 ,0 ,2 ,1 ,0 ,0 ,0 ,3 ,0 ,3 ,0 ,3,11536 , 0 
19441.499,16,11 ,9 ,65535 ,0 ,0 ,18 ,13 ,17 ,16 ,3 ,67 ,0 ,38 ,42 ,80,25642 , 0 
19441.603,5,11 ,9 ,300 ,0 ,0 ,2 ,16 ,1 ,0 ,0 ,19 ,0 ,25 ,1 ,26,18213 , 0 
19441.606,19,11 ,1 ,256 ,0 ,0 ,2 ,0 ,0 ,0 ,0 ,2 ,0 ,1 ,0 ,1,11627 , 0 
19441.612,9,11 ,15 ,576 ,0 ,0 ,21 ,8 ,27 ,29 ,3 ,88 ,0 ,40 ,123 ,163,21709 , 1 
19441.697,17,11 ,16 ,639 ,0 ,0 ,7 ,15 ,0 ,2 ,0 ,24 ,0 ,34 ,0 ,34,14941 , 0 
19441.771,13,11 ,1 ,256 ,0 ,0 ,1 ,0 ,0 ,0 ,0 ,1 ,0 ,7 ,0 ,7,10336 , 0 
19441.786,3,11 ,1 ,256 ,0 ,0 ,1 ,0 ,4 ,0 ,0 ,5 ,0 ,3 ,4 ,7,7016 , 0 
19560.96,8,11 ,1 ,256 ,0 ,0 ,0 ,0 ,0 ,0 ,0 ,0 ,0 ,6 ,0 ,6,8075 , 0 
19561.078,11,11 ,5 ,804 ,0 ,0 ,7 ,5 ,6 ,4 ,1 ,23 ,0 ,27 ,9 ,36,14733 , 0 
19561.124,2,11 ,1 ,256 ,0 ,0 ,6 ,0 ,28 ,0 ,2 ,36 ,0 ,17 ,33 ,50,14844 , 0 
19561.138,6,11 ,10 ,1170 ,0 ,0 ,2 ,1 ,0 ,0 ,0 ,3 ,0 ,11 ,0 ,11,18692 , 0 
19561.214,18,11 ,19 ,546 ,0 ,0 ,6 ,3 ,0 ,0 ,0 ,9 ,0 ,16 ,0 ,16,11714 , 0 
19561.236,4,11 ,8 ,610 ,0 ,0 ,2 ,0 ,0 ,0 ,0 ,2 ,0 ,8 ,0 ,8,10053 , 0 
19561.289,7,11 ,16 ,957 ,0 ,0 ,7 ,4 ,2 ,4 ,2 ,19 ,0 ,18 ,4 ,22,18215 , 0 
19561.337,14,11 ,3 ,536 ,0 ,0 ,2 ,0 ,2 ,0 ,0 ,4 ,0 ,6 ,2 ,8,10236 , 0 
19561.35,15,11 ,11 ,1077 ,0 ,0 ,10 ,3 ,0 ,3 ,0 ,16 ,0 ,13 ,4 ,17,13974 , 0 
19561.36,20,11 ,11 ,1077 ,0 ,0 ,7 ,4 ,0 ,2 ,0 ,13 ,0 ,14 ,2 ,16,11661 , 0 
19561.361,16,11 ,2 ,512 ,0 ,0 ,5 ,4 ,6 ,2 ,2 ,19 ,0 ,15 ,14 ,29,24356 , 0 
19561.444,10,11 ,14 ,792 ,0 ,0 ,1 ,1 ,1 ,0 ,0 ,3 ,0 ,2 ,1 ,3,10691 , 0 
19561.482,12,11 ,5 ,827 ,0 ,0 ,6 ,3 ,0 ,2 ,0 ,11 ,0 ,19 ,0 ,19,11961 , 0 
19561.596,9,11 ,5 ,804 ,0 ,0 ,10 ,4 ,1 ,6 ,1 ,22 ,0 ,21 ,9 ,30,21404 , 0 
19561.603,5,11 ,2 ,512 ,0 ,0 ,6 ,4 ,15 ,1 ,1 ,27 ,0 ,34 ,22 ,56,19356 , 0 
19561.607,19,11 ,1 ,256 ,0 ,0 ,6 ,0 ,3 ,0 ,0 ,9 ,0 ,17 ,3 ,20,12218 , 0 
19561.696,17,11 ,16 ,957 ,0 ,0 ,4 ,3 ,0 ,0 ,0 ,7 ,0 ,8 ,0 ,8,15670 , 0 
19561.771,13,11 ,1 ,256 ,0 ,0 ,5 ,0 ,0 ,0 ,0 ,5 ,0 ,14 ,0 ,14,10734 , 0 
19561.786,3,11 ,1 ,256 ,0 ,0 ,1 ,0 ,2 ,0 ,0 ,3 ,0 ,1 ,2 ,3,7444 , 0 
19680.96,8,11 ,1 ,256 ,0 ,0 ,2 ,0 ,0 ,0 ,0 ,2 ,0 ,2 ,0 ,2,8310 , 0 
19681.078,11,11 ,5 ,785 ,0 ,0 ,3 ,1 ,4 ,0 ,0 ,8 ,0 ,7 ,4 ,11,13724 , 0 
19681.124,2,11 ,1 ,256 ,0 ,0 ,1 ,0 ,9 ,0 ,0 ,10 ,0 ,4 ,10 ,14,15386 , 0 
19681.138,6,11 ,10 ,1178 ,0 ,0 ,1 ,1 ,0 ,0 ,0 ,2 ,0 ,4 ,0 ,4,20440 , 0 
19681.214,18,11 ,19 ,546 ,0 ,0 ,1 ,0 ,0 ,0 ,0 ,1 ,0 ,2 ,0 ,2,10694 , 0 
19681.235,4,11 ,8 ,610 ,0 ,0 ,2 ,0 ,0 ,0 ,0 ,2 ,0 ,1 ,0 ,1,9525 , 0 
19681.289,7,11 ,16 ,867 ,0 ,0 ,3 ,1 ,0 ,0 ,0 ,4 ,0 ,5 ,0 ,5,18659 , 0 
19681.337,14,11 ,3 ,518 ,0 ,0 ,1 ,1 ,2 ,0 ,0 ,4 ,0 ,5 ,2 ,7,9435 , 0 
19681.35,15,11 ,11 ,1048 ,0 ,0 ,2 ,2 ,0 ,0 ,0 ,4 ,0 ,6 ,0 ,6,12935 , 0 
19681.36,20,11 ,11 ,1048 ,0 ,0 ,2 ,2 ,0 ,0 ,0 ,4 ,0 ,6 ,0 ,6,10522 , 0 
19681.36,16,11 ,2 ,512 ,0 ,0 ,2 ,0 ,2 ,0 ,0 ,4 ,0 ,5 ,2 ,7,25737 , 0 
19681.444,10,11 ,14 ,843 ,0 ,0 ,1 ,1 ,1 ,0 ,0 ,3 ,0 ,1 ,1 ,2,10737 , 0 
19681.481,12,11 ,5 ,793 ,0 ,0 ,3 ,2 ,0 ,0 ,0 ,5 ,0 ,6 ,0 ,6,11623 , 0 
19681.596,9,11 ,5 ,793 ,0 ,0 ,2 ,1 ,0 ,0 ,0 ,3 ,0 ,10 ,0 ,10,21806 , 0 
19681.603,5,11 ,2 ,512 ,0 ,0 ,3 ,0 ,8 ,1 ,0 ,12 ,0 ,6 ,8 ,14,18409 , 0 
19681.606,19,11 ,1 ,256 ,0 ,0 ,1 ,0 ,0 ,0 ,0 ,1 ,0 ,6 ,0 ,6,11719 , 0 
19681.696,17,11 ,16 ,867 ,0 ,0 ,2 ,1 ,0 ,0 ,0 ,3 ,0 ,3 ,0 ,3,15020 , 0 
19681.771,13,11 ,1 ,256 ,0 ,0 ,3 ,0 ,0 ,0 ,0 ,3 ,0 ,3 ,0 ,3,10415 , 0 
19681.786,3,11 ,1 ,256 ,0 ,0 ,2 ,0 ,3 ,0 ,0 ,5 ,0 ,2 ,3 ,5,7086 , 0 
19800.96,8,11 ,1 ,256 ,0 ,0 ,2 ,0 ,0 ,0 ,0 ,2 ,0 ,3 ,0 ,3,8152 , 0 
19801.078,11,11 ,5 ,785 ,0 ,0 ,1 ,0 ,0 ,0 ,0 ,1 ,0 ,1 ,0 ,1,14804 , 0 
19801.123,2,11 ,1 ,256 ,0 ,0 ,2 ,0 ,7 ,0 ,0 ,9 ,0 ,7 ,7 ,14,14940 , 0 
19801.138,6,11 ,2 ,512 ,0 ,0 ,4 ,1 ,0 ,1 ,0 ,6 ,0 ,8 ,0 ,8,18798 , 0 
19801.214,18,11 ,19 ,536 ,0 ,0 ,2 ,1 ,0 ,0 ,0 ,3 ,0 ,1 ,0 ,1,11803 , 0 
19801.236,4,11 ,8 ,591 ,0 ,0 ,1 ,0 ,0 ,0 ,0 ,1 ,0 ,5 ,0 ,5,10138 , 0 
19801.289,7,11 ,16 ,825 ,0 ,0 ,2 ,1 ,0 ,0 ,0 ,3 ,0 ,3 ,0 ,3,18308 , 0 
19801.337,14,11 ,3 ,518 ,0 ,0 ,0 ,0 ,0 ,0 ,1 ,1 ,0 ,3 ,1 ,4,10315 , 0 
19801.35,15,11 ,11 ,1048 ,0 ,0 ,2 ,0 ,0 ,0 ,0 ,2 ,0 ,2 ,0 ,2,14044 , 0 
19801.36,20,11 ,11 ,1048 ,0 ,0 ,3 ,0 ,0 ,0 ,0 ,3 ,0 ,1 ,0 ,1,11748 , 0 
19801.36,16,11 ,2 ,512 ,0 ,0 ,2 ,1 ,2 ,0 ,0 ,5 ,0 ,6 ,2 ,8,24465 , 0 
19801.444,10,11 ,14 ,843 ,0 ,0 ,3 ,0 ,0 ,0 ,1 ,4 ,0 ,3 ,1 ,4,10772 , 0 
19801.482,12,11 ,5 ,793 ,0 ,0 ,1 ,0 ,0 ,0 ,0 ,1 ,0 ,5 ,0 ,5,12030 , 0 
19801.596,9,11 ,5 ,793 ,0 ,0 ,2 ,1 ,0 ,0 ,0 ,3 ,0 ,2 ,0 ,2,21488 , 0 
19801.602,5,11 ,2 ,512 ,0 ,0 ,1 ,1 ,1 ,0 ,0 ,3 ,0 ,7 ,1 ,8,19452 , 0 
19801.606,19,11 ,1 ,256 ,0 ,0 ,2 ,0 ,1 ,0 ,0 ,3 ,0 ,5 ,1 ,6,12317 , 0 
19801.696,17,11 ,16 ,825 ,0 ,0 ,1 ,1 ,0 ,0 ,0 ,2 ,0 ,5 ,0 ,5,15745 , 0 
19801.771,13,11 ,1 ,256 ,0 ,0 ,2 ,0 ,0 ,0 ,0 ,2 ,0 ,3 ,0 ,3,10814 , 0 
19801.786,3,11 ,1 ,256 ,0 ,0 ,1 ,0 ,0 ,0 ,1 ,2 ,0 ,1 ,1 ,2,7515 , 0 
19920.96,8,11 ,1 ,256 ,0 ,0 ,0 ,0 ,0 ,0 ,0 ,0 ,0 ,0 ,0 ,0,8373 , 0 
19921.078,11,11 ,5 ,957 ,0 ,0 ,2 ,1 ,1 ,0 ,0 ,4 ,0 ,3 ,1 ,4,13880 , 0 
19921.139,6,11 ,2 ,512 ,0 ,120 ,2 ,16 ,0 ,0 ,0 ,138 ,0 ,78 ,0 ,78,21351 , 1 
19921.142,2,11 ,1 ,256 ,0 ,0 ,25 ,0 ,77 ,0 ,0 ,102 ,106 ,19 ,77 ,202,15749 , 0 
19921.214,18,11 ,19 ,536 ,0 ,0 ,1 ,0 ,0 ,0 ,0 ,1 ,0 ,2 ,0 ,2,10812 , 0 
19921.235,4,11 ,8 ,591 ,0 ,0 ,0 ,0 ,0 ,0 ,0 ,0 ,0 ,0 ,0 ,0,9579 , 0 
19921.29,7,11 ,16 ,770 ,0 ,0 ,0 ,14 ,0 ,0 ,0 ,14 ,0 ,41 ,0 ,41,18891 , 0 
19921.337,14,11 ,3 ,515 ,0 ,0 ,0 ,0 ,0 ,1 ,0 ,1 ,0 ,38 ,1 ,39,9529 , 0 
19921.35,15,11 ,11 ,1044 ,0 ,0 ,1 ,1 ,0 ,0 ,0 ,2 ,0 ,2 ,0 ,2,13067 , 0 
19921.36,20,11 ,11 ,1048 ,0 ,0 ,2 ,0 ,0 ,0 ,0 ,2 ,0 ,1 ,0 ,1,10597 , 0 
19921.362,16,11 ,2 ,512 ,0 ,0 ,24 ,14 ,28 ,0 ,0 ,66 ,103 ,31 ,28 ,162,26337 , 0 
19921.444,10,11 ,14 ,843 ,0 ,0 ,25 ,0 ,0 ,1 ,0 ,26 ,106 ,1 ,0 ,107,10988 , 0 
19921.482,12,11 ,5 ,957 ,0 ,0 ,1 ,1 ,0 ,0 ,0 ,2 ,0 ,1 ,0 ,1,11735 , 0 
19921.601,9,11 ,5 ,793 ,0 ,0 ,3 ,0 ,0 ,0 ,0 ,3 ,0 ,23 ,0 ,23,21957 , 0 
19921.603,5,11 ,2 ,512 ,0 ,0 ,2 ,16 ,3 ,0 ,0 ,21 ,0 ,23 ,3 ,26,18732 , 0 
19921.607,19,11 ,1 ,256 ,0 ,0 ,1 ,0 ,0 ,0 ,0 ,1 ,0 ,24 ,0 ,24,11807 , 0 
19921.697,17,11 ,16 ,794 ,0 ,0 ,25 ,14 ,0 ,0 ,0 ,39 ,105 ,22 ,0 ,127,15402 , 0 
19921.771,13,11 ,1 ,256 ,0 ,0 ,1 ,0 ,0 ,0 ,0 ,1 ,0 ,22 ,0 ,22,10547 , 0 
19921.786,3,11 ,1 ,256 ,0 ,0 ,1 ,0 ,0 ,1 ,0 ,2 ,0 ,0 ,1 ,1,7158 , 0 
20040.96,8,11 ,1 ,256 ,0 ,0 ,1 ,0 ,0 ,0 ,0 ,1 ,0 ,1 ,0 ,1,8306 , 0 
20041.078,11,11 ,5 ,880 ,0 ,0 ,2 ,4 ,2 ,0 ,2 ,10 ,0 ,18 ,4 ,22,14958 , 0 
20041.124,2,11 ,1 ,256 ,0 ,0 ,24 ,0 ,62 ,1 ,4 ,91 ,82 ,25 ,66 ,173,15320 , 0 
20041.214,18,11 ,19 ,536 ,0 ,0 ,2 ,0 ,0 ,0 ,0 ,2 ,0 ,8 ,0 ,8,11890 , 0 
20041.236,4,11 ,8 ,591 ,0 ,0 ,1 ,0 ,0 ,0 ,0 ,1 ,0 ,1 ,0 ,1,10211 , 0 
20041.275,6,11 ,2 ,512 ,0 ,120 ,1 ,14 ,0 ,0 ,0 ,135 ,0 ,72 ,0 ,72,19761 , 1 
20041.29,7,11 ,16 ,847 ,0 ,0 ,7 ,18 ,0 ,2 ,0 ,27 ,0 ,48 ,0 ,48,18721 , 0 
20041.338,14,11 ,3 ,515 ,0 ,0 ,1 ,0 ,0 ,0 ,0 ,1 ,0 ,31 ,0 ,31,10428 , 0 
20041.35,15,11 ,11 ,1145 ,0 ,0 ,6 ,2 ,0 ,2 ,0 ,10 ,0 ,9 ,0 ,9,14231 , 0 
20041.36,20,11 ,5 ,880 ,0 ,0 ,4 ,2 ,0 ,1 ,0 ,7 ,0 ,10 ,0 ,10,11932 , 0 
20041.444,10,11 ,14 ,843 ,0 ,0 ,24 ,0 ,0 ,0 ,0 ,24 ,95 ,0 ,0 ,95,11016 , 0 
20041.482,12,11 ,5 ,880 ,0 ,0 ,3 ,3 ,0 ,0 ,0 ,6 ,0 ,9 ,0 ,9,12188 , 0 
20041.495,16,11 ,2 ,512 ,0 ,0 ,24 ,11 ,39 ,0 ,3 ,77 ,79 ,34 ,42 ,155,25356 , 0 
20041.596,9,11 ,5 ,880 ,0 ,0 ,7 ,6 ,1 ,2 ,1 ,17 ,0 ,35 ,2 ,37,21872 , 0 
20041.603,5,11 ,13 ,512 ,0 ,0 ,8 ,4 ,12 ,2 ,3 ,29 ,0 ,23 ,16 ,39,19905 , 0 
20041.606,19,11 ,1 ,256 ,0 ,0 ,1 ,0 ,5 ,1 ,1 ,8 ,0 ,22 ,7 ,29,12566 , 0 
20041.697,17,11 ,16 ,847 ,0 ,0 ,23 ,19 ,1 ,0 ,1 ,44 ,87 ,28 ,2 ,117,16160 , 0 
20041.772,13,11 ,1 ,256 ,0 ,0 ,1 ,0 ,9 ,0 ,1 ,11 ,0 ,26 ,11 ,37,11016 , 0 
20041.786,3,11 ,1 ,256 ,0 ,0 ,1 ,0 ,0 ,0 ,0 ,1 ,0 ,0 ,0 ,0,7617 , 0 
20160.96,8,11 ,1 ,256 ,0 ,0 ,1 ,0 ,0 ,0 ,0 ,1 ,0 ,0 ,0 ,0,8436 , 0 
20161.078,11,11 ,5 ,825 ,0 ,0 ,1 ,1 ,1 ,1 ,0 ,4 ,0 ,6 ,1 ,7,13979 , 0 
20161.124,2,11 ,1 ,256 ,0 ,0 ,26 ,0 ,66 ,1 ,0 ,93 ,108 ,21 ,67 ,196,16140 , 0 
20161.214,18,11 ,19 ,536 ,0 ,0 ,1 ,0 ,0 ,0 ,0 ,1 ,0 ,1 ,0 ,1,10881 , 0 
20161.235,4,11 ,8 ,591 ,0 ,0 ,1 ,0 ,0 ,0 ,0 ,1 ,0 ,1 ,0 ,1,9675 , 0 
20161.275,6,11 ,2 ,517 ,0 ,120 ,1 ,18 ,0 ,0 ,0 ,139 ,0 ,80 ,0 ,80,22290 , 1 
20161.29,7,11 ,16 ,812 ,0 ,0 ,3 ,17 ,0 ,0 ,0 ,20 ,0 ,41 ,0 ,41,19228 , 0 
20161.337,14,11 ,3 ,515 ,0 ,0 ,0 ,0 ,0 ,0 ,0 ,0 ,0 ,40 ,0 ,40,9618 , 0 
20161.35,15,11 ,11 ,1154 ,0 ,0 ,2 ,1 ,0 ,0 ,0 ,3 ,0 ,5 ,0 ,5,13160 , 0 
20161.36,20,11 ,5 ,825 ,0 ,0 ,4 ,1 ,0 ,0 ,0 ,5 ,0 ,1 ,0 ,1,10689 , 0 
20161.361,16,11 ,2 ,517 ,0 ,0 ,25 ,16 ,32 ,1 ,0 ,74 ,106 ,41 ,33 ,180,27017 , 0 
20161.444,10,11 ,14 ,843 ,0 ,0 ,24 ,0 ,0 ,0 ,0 ,24 ,107 ,1 ,0 ,108,11246 , 0 
20161.482,12,11 ,5 ,880 ,0 ,0 ,0 ,0 ,0 ,0 ,0 ,0 ,0 ,3 ,0 ,3,11808 , 0 
20161.596,9,11 ,5 ,825 ,0 ,0 ,1 ,1 ,0 ,1 ,0 ,3 ,0 ,28 ,0 ,28,22084 , 0 
20161.603,5,11 ,13 ,512 ,0 ,0 ,2 ,0 ,4 ,0 ,0 ,6 ,0 ,22 ,6 ,28,18874 , 0 
20161.606,19,11 ,1 ,256 ,0 ,0 ,1 ,0 ,0 ,0 ,0 ,1 ,0 ,23 ,0 ,23,11913 , 0 
20161.697,17,11 ,16 ,812 ,0 ,0 ,25 ,16 ,0 ,1 ,0 ,42 ,109 ,22 ,0 ,131,15789 , 0 
20161.771,13,11 ,1 ,256 ,0 ,0 ,1 ,0 ,4 ,0 ,0 ,5 ,0 ,22 ,4 ,26,10649 , 0 
20161.786,3,11 ,1 ,256 ,0 ,0 ,1 ,0 ,0 ,0 ,0 ,1 ,0 ,1 ,0 ,1,7214 , 0 
20280.96,8,11 ,1 ,256 ,0 ,0 ,1 ,0 ,0 ,0 ,0 ,1 ,0 ,1 ,0 ,1,8373 , 0 
20281.078,11,11 ,5 ,848 ,0 ,0 ,1 ,1 ,0 ,0 ,0 ,2 ,0 ,7 ,0 ,7,15045 , 0 
20281.124,2,11 ,1 ,256 ,0 ,0 ,4 ,0 ,15 ,0 ,0 ,19 ,1 ,5 ,15 ,21,15430 , 0 
20281.138,6,11 ,2 ,512 ,0 ,0 ,1 ,4 ,0 ,0 ,0 ,5 ,0 ,17 ,0 ,17,19843 , 0 
20281.214,18,11 ,19 ,536 ,0 ,0 ,1 ,0 ,0 ,0 ,0 ,1 ,0 ,3 ,0 ,3,11976 , 0 
20281.236,4,11 ,8 ,591 ,0 ,0 ,1 ,0 ,0 ,0 ,0 ,1 ,0 ,0 ,0 ,0,10278 , 0 
20281.289,7,11 ,16 ,775 ,0 ,0 ,2 ,4 ,0 ,0 ,0 ,6 ,0 ,12 ,0 ,12,18828 , 0 
20281.341,14,11 ,3 ,515 ,0 ,0 ,0 ,0 ,0 ,0 ,0 ,0 ,0 ,10 ,0 ,10,10488 , 0 
20281.35,15,11 ,11 ,1154 ,0 ,0 ,2 ,0 ,0 ,0 ,0 ,2 ,0 ,2 ,0 ,2,14296 , 0 
20281.36,20,11 ,5 ,848 ,0 ,0 ,2 ,1 ,0 ,0 ,0 ,3 ,0 ,1 ,0 ,1,12022 , 0 
20281.364,16,11 ,2 ,512 ,0 ,0 ,6 ,3 ,8 ,0 ,0 ,17 ,0 ,11 ,8 ,19,25549 , 0 
20281.444,10,11 ,14 ,843 ,0 ,0 ,6 ,0 ,0 ,0 ,0 ,6 ,0 ,0 ,0 ,0,11098 , 0 
20281.482,12,11 ,5 ,848 ,0 ,0 ,1 ,1 ,0 ,0 ,0 ,2 ,0 ,2 ,0 ,2,12263 , 0 
20281.596,9,11 ,5 ,848 ,0 ,0 ,2 ,1 ,0 ,0 ,0 ,3 ,0 ,11 ,0 ,11,21979 , 0 
20281.603,5,11 ,13 ,512 ,0 ,0 ,2 ,0 ,4 ,0 ,0 ,6 ,0 ,8 ,4 ,12,20039 , 0 
20281.606,19,11 ,1 ,256 ,0 ,0 ,0 ,0 ,0 ,0 ,0 ,0 ,0 ,7 ,0 ,7,12630 , 0 
20281.696,17,11 ,16 ,775 ,0 ,0 ,6 ,4 ,0 ,0 ,0 ,10 ,0 ,5 ,0 ,5,16289 , 0 
20281.771,13,11 ,1 ,256 ,0 ,0 ,1 ,0 ,4 ,0 ,0 ,5 ,0 ,5 ,4 ,9,11092 , 0 
20281.786,3,11 ,1 ,256 ,0 ,0 ,1 ,0 ,0 ,0 ,0 ,1 ,0 ,0 ,0 ,0,7678 , 0 
20400.96,8,11 ,1 ,256 ,0 ,0 ,1 ,0 ,1 ,0 ,0 ,2 ,0 ,1 ,1 ,2,8493 , 0 
20401.078,11,11 ,5 ,800 ,0 ,0 ,1 ,1 ,1 ,0 ,0 ,3 ,0 ,2 ,1 ,3,14054 , 0 
20401.123,2,11 ,1 ,256 ,0 ,0 ,2 ,0 ,6 ,0 ,0 ,8 ,0 ,3 ,6 ,9,16232 , 0 
20401.138,6,11 ,2 ,512 ,0 ,0 ,1 ,2 ,0 ,0 ,0 ,3 ,0 ,7 ,0 ,7,22363 , 0 
20401.214,18,11 ,19 ,536 ,0 ,0 ,1 ,0 ,0 ,0 ,0 ,1 ,0 ,1 ,0 ,1,10945 , 0 
20401.235,4,11 ,8 ,562 ,0 ,0 ,1 ,1 ,0 ,0 ,0 ,2 ,0 ,1 ,0 ,1,9731 , 0 
20401.289,7,11 ,16 ,805 ,0 ,0 ,1 ,1 ,0 ,0 ,0 ,2 ,0 ,4 ,0 ,4,19308 , 0 
20401.337,14,11 ,3 ,512 ,0 ,0 ,0 ,0 ,0 ,0 ,0 ,0 ,0 ,4 ,0 ,4,9689 , 0 
20401.35,15,11 ,11 ,1150 ,0 ,0 ,1 ,1 ,0 ,0 ,0 ,2 ,0 ,2 ,0 ,2,13238 , 0 
20401.36,20,11 ,5 ,804 ,0 ,0 ,0 ,1 ,0 ,0 ,0 ,1 ,0 ,4 ,0 ,4,10766 , 0 
20401.36,16,11 ,2 ,512 ,0 ,0 ,2 ,2 ,2 ,0 ,0 ,6 ,0 ,2 ,2 ,4,27115 , 0 
20401.444,10,11 ,14 ,843 ,0 ,0 ,2 ,0 ,0 ,0 ,0 ,2 ,0 ,0 ,0 ,0,11306 , 0 
20401.482,12,11 ,5 ,804 ,0 ,0 ,1 ,1 ,0 ,0 ,0 ,2 ,0 ,2 ,0 ,2,11892 , 0 
20401.596,9,11 ,5 ,804 ,0 ,0 ,2 ,1 ,0 ,0 ,0 ,3 ,0 ,3 ,0 ,3,22183 , 0 
20401.602,5,11 ,13 ,512 ,0 ,0 ,3 ,0 ,5 ,0 ,0 ,8 ,0 ,3 ,5 ,8,18998 , 0 
20401.606,19,11 ,1 ,256 ,0 ,0 ,2 ,0 ,0 ,0 ,0 ,2 ,0 ,4 ,0 ,4,12001 , 0 
20401.696,17,11 ,16 ,805 ,0 ,0 ,2 ,1 ,0 ,0 ,0 ,3 ,0 ,4 ,0 ,4,15886 , 0 
20401.771,13,11 ,1 ,256 ,0 ,0 ,1 ,0 ,5 ,0 ,0 ,6 ,0 ,2 ,5 ,7,10721 , 0 
20401.786,3,11 ,1 ,256 ,0 ,0 ,2 ,0 ,0 ,0 ,0 ,2 ,0 ,0 ,0 ,0,7276 , 0 
20520.96,8,11 ,1 ,256 ,0 ,0 ,1 ,0 ,0 ,0 ,0 ,1 ,0 ,1 ,0 ,1,8444 , 0 
20521.078,11,11 ,5 ,800 ,0 ,0 ,1 ,0 ,1 ,0 ,0 ,2 ,0 ,5 ,1 ,6,15124 , 0 
20521.123,2,11 ,1 ,256 ,0 ,0 ,2 ,0 ,1 ,0 ,0 ,3 ,0 ,2 ,1 ,3,15519 , 0 
20521.138,6,11 ,2 ,512 ,0 ,0 ,2 ,1 ,0 ,0 ,0 ,3 ,0 ,2 ,0 ,2,19934 , 0 
20521.214,18,11 ,19 ,536 ,0 ,0 ,2 ,0 ,0 ,0 ,0 ,2 ,0 ,3 ,0 ,3,12051 , 0 
20521.236,4,11 ,8 ,562 ,0 ,0 ,1 ,0 ,0 ,0 ,0 ,1 ,0 ,1 ,0 ,1,10363 , 0 
20521.289,7,11 ,16 ,805 ,0 ,0 ,3 ,0 ,0 ,0 ,0 ,3 ,0 ,4 ,0 ,4,18903 , 0 
20521.337,14,11 ,3 ,512 ,0 ,0 ,0 ,0 ,0 ,0 ,0 ,0 ,0 ,1 ,0 ,1,10556 , 0 
20521.35,15,11 ,11 ,1092 ,0 ,0 ,2 ,1 ,0 ,0 ,0 ,3 ,0 ,4 ,0 ,4,14379 , 0 
20521.36,20,11 ,5 ,804 ,0 ,0 ,2 ,0 ,0 ,0 ,0 ,2 ,0 ,1 ,0 ,1,12081 , 0 
20521.36,16,11 ,2 ,512 ,0 ,0 ,0 ,0 ,0 ,0 ,0 ,0 ,0 ,4 ,0 ,4,25622 , 0 
20521.444,10,11 ,14 ,843 ,0 ,0 ,1 ,0 ,0 ,0 ,0 ,1 ,0 ,1 ,0 ,1,11167 , 0 
20521.482,12,11 ,5 ,804 ,0 ,0 ,2 ,0 ,0 ,0 ,0 ,2 ,0 ,3 ,0 ,3,12347 , 0 
20521.596,9,11 ,5 ,804 ,0 ,0 ,2 ,0 ,0 ,0 ,0 ,2 ,0 ,2 ,0 ,2,22047 , 0 
20521.602,5,11 ,13 ,512 ,0 ,0 ,1 ,0 ,1 ,0 ,0 ,2 ,0 ,4 ,1 ,5,20137 , 0 
20521.606,19,11 ,1 ,256 ,0 ,0 ,1 ,0 ,0 ,0 ,0 ,1 ,0 ,1 ,0 ,1,12730 , 0 
20521.696,17,11 ,16 ,805 ,0 ,0 ,1 ,0 ,0 ,0 ,0 ,1 ,0 ,2 ,0 ,2,16351 , 0 
20521.771,13,11 ,1 ,256 ,0 ,0 ,1 ,0 ,1 ,0 ,0 ,2 ,0 ,0 ,1 ,1,11160 , 0 
20521.786,3,11 ,1 ,256 ,0 ,0 ,1 ,0 ,0 ,0 ,0 ,1 ,0 ,1 ,0 ,1,7728 , 0 
20640.96,8,11 ,1 ,256 ,0 ,0 ,1 ,0 ,0 ,0 ,0 ,1 ,0 ,1 ,0 ,1,8568 , 0 
20641.078,11,11 ,5 ,800 ,0 ,0 ,1 ,0 ,0 ,0 ,0 ,1 ,0 ,3 ,0 ,3,14126 , 0 
20641.124,2,11 ,1 ,256 ,0 ,0 ,7 ,0 ,12 ,0 ,2 ,21 ,0 ,4 ,14 ,18,16368 , 0 
20641.138,6,11 ,2 ,512 ,0 ,0 ,2 ,4 ,3 ,0 ,0 ,9 ,0 ,11 ,3 ,14,22499 , 0 
20641.214,18,11 ,19 ,536 ,0 ,0 ,1 ,0 ,0 ,0 ,0 ,1 ,0 ,1 ,0 ,1,11045 , 0 
20641.235,4,11 ,8 ,548 ,0 ,0 ,2 ,0 ,0 ,0 ,0 ,2 ,0 ,2 ,0 ,2,9825 , 0 
20641.289,7,11 ,17 ,1112 ,0 ,0 ,2 ,2 ,0 ,1 ,0 ,5 ,0 ,5 ,0 ,5,19397 , 0 
20641.337,14,11 ,3 ,512 ,0 ,0 ,0 ,0 ,0 ,0 ,0 ,0 ,0 ,8 ,0 ,8,9749 , 0 
20641.35,15,11 ,11 ,1092 ,0 ,0 ,1 ,0 ,0 ,0 ,0 ,1 ,0 ,3 ,0 ,3,13299 , 0 
20641.36,20,11 ,5 ,804 ,0 ,0 ,2 ,0 ,0 ,0 ,0 ,2 ,0 ,1 ,0 ,1,10840 , 0 
20641.36,16,11 ,2 ,512 ,0 ,0 ,2 ,5 ,0 ,0 ,2 ,9 ,0 ,11 ,2 ,13,27273 , 1 
20641.444,10,11 ,14 ,843 ,0 ,0 ,2 ,0 ,0 ,0 ,0 ,2 ,0 ,1 ,0 ,1,11364 , 0 
20641.482,12,11 ,5 ,804 ,0 ,0 ,1 ,0 ,0 ,0 ,0 ,1 ,0 ,2 ,0 ,2,11978 , 0 
20641.596,9,11 ,5 ,804 ,0 ,0 ,3 ,0 ,0 ,0 ,0 ,3 ,0 ,3 ,0 ,3,22273 , 0 
20641.602,5,11 ,13 ,512 ,0 ,0 ,1 ,0 ,0 ,0 ,0 ,1 ,0 ,9 ,0 ,9,19117 , 0 
20641.606,19,11 ,1 ,256 ,0 ,0 ,1 ,0 ,0 ,0 ,0 ,1 ,0 ,8 ,0 ,8,12121 , 0 
20641.696,17,11 ,6 ,811 ,0 ,0 ,3 ,1 ,2 ,1 ,0 ,7 ,0 ,3 ,2 ,5,16020 , 0 
20641.771,13,11 ,1 ,256 ,0 ,0 ,1 ,0 ,0 ,0 ,0 ,1 ,0 ,7 ,0 ,7,10826 , 0 
20641.786,3,11 ,1 ,256 ,0 ,0 ,0 ,0 ,0 ,0 ,0 ,0 ,0 ,0 ,0 ,0,7327 , 0 
20760.96,8,11 ,1 ,256 ,0 ,0 ,1 ,0 ,0 ,0 ,0 ,1 ,0 ,2 ,0 ,2,8515 , 0 
20761.078,11,11 ,5 ,800 ,0 ,0 ,2 ,0 ,0 ,0 ,0 ,2 ,0 ,3 ,0 ,3,15196 , 0 
20761.124,2,11 ,1 ,256 ,0 ,0 ,3 ,0 ,14 ,0 ,0 ,17 ,0 ,3 ,16 ,19,15625 , 0 
20761.138,6,11 ,2 ,512 ,0 ,0 ,4 ,3 ,8 ,0 ,0 ,15 ,0 ,9 ,8 ,17,20113 , 0 
20761.214,18,11 ,19 ,536 ,0 ,0 ,1 ,0 ,0 ,0 ,0 ,1 ,0 ,0 ,0 ,0,12107 , 0 
20761.236,4,11 ,8 ,548 ,0 ,0 ,1 ,0 ,0 ,0 ,0 ,1 ,0 ,1 ,0 ,1,10418 , 0 
20761.289,7,11 ,17 ,1050 ,0 ,0 ,4 ,6 ,0 ,0 ,0 ,10 ,0 ,9 ,0 ,9,19016 , 0 
20761.337,14,11 ,3 ,512 ,0 ,0 ,0 ,0 ,0 ,0 ,0 ,0 ,0 ,5 ,0 ,5,10636 , 0 
20761.35,15,11 ,11 ,1092 ,0 ,0 ,0 ,0 ,0 ,0 ,0 ,0 ,0 ,7 ,0 ,7,14432 , 0 
20761.36,20,11 ,5 ,804 ,0 ,0 ,0 ,0 ,0 ,0 ,0 ,0 ,0 ,1 ,0 ,1,12138 , 0 
20761.36,16,11 ,2 ,512 ,0 ,0 ,1 ,3 ,0 ,2 ,0 ,6 ,0 ,16 ,0 ,16,25729 , 1 
20761.444,10,11 ,14 ,843 ,0 ,0 ,1 ,0 ,0 ,0 ,0 ,1 ,0 ,4 ,0 ,4,11224 , 0 
20761.481,12,11 ,5 ,804 ,0 ,0 ,0 ,0 ,0 ,0 ,0 ,0 ,0 ,0 ,0 ,0,12399 , 0 
20761.596,9,11 ,5 ,804 ,0 ,0 ,4 ,0 ,0 ,0 ,0 ,4 ,0 ,5 ,0 ,5,22148 , 0 
20761.602,5,11 ,13 ,512 ,0 ,0 ,1 ,0 ,0 ,0 ,0 ,1 ,0 ,6 ,0 ,6,20199 , 0 
20761.606,19,11 ,1 ,256 ,0 ,0 ,0 ,0 ,0 ,0 ,0 ,0 ,0 ,7 ,0 ,7,12802 , 0 
20761.696,17,11 ,6 ,777 ,0 ,0 ,6 ,2 ,6 ,0 ,0 ,14 ,0 ,6 ,6 ,12,16483 , 0 
20761.771,13,11 ,1 ,256 ,0 ,0 ,1 ,0 ,0 ,0 ,0 ,1 ,0 ,3 ,0 ,3,11252 , 0 
20761.786,3,11 ,1 ,256 ,0 ,0 ,2 ,0 ,0 ,0 ,0 ,2 ,0 ,1 ,0 ,1,7803 , 0 
20880.96,8,11 ,1 ,256 ,0 ,0 ,1 ,0 ,0 ,0 ,0 ,1 ,0 ,1 ,0 ,1,8629 , 0 
20881.078,11,11 ,5 ,800 ,0 ,0 ,1 ,0 ,0 ,0 ,0 ,1 ,0 ,3 ,0 ,3,14197 , 0 
20881.123,2,11 ,1 ,256 ,0 ,0 ,2 ,0 ,4 ,0 ,0 ,6 ,0 ,1 ,4 ,5,16447 , 0 
20881.138,6,11 ,2 ,512 ,0 ,0 ,2 ,1 ,2 ,0 ,0 ,5 ,0 ,3 ,2 ,5,22583 , 0 
20881.214,18,11 ,19 ,536 ,0 ,0 ,1 ,0 ,0 ,0 ,0 ,1 ,0 ,1 ,0 ,1,11108 , 0 
20881.235,4,11 ,8 ,548 ,0 ,0 ,1 ,0 ,0 ,0 ,0 ,1 ,0 ,0 ,0 ,0,9883 , 0 
20881.289,7,11 ,17 ,1118 ,0 ,0 ,5 ,1 ,0 ,0 ,0 ,6 ,0 ,6 ,0 ,6,19506 , 0 
20881.337,14,11 ,3 ,512 ,0 ,0 ,0 ,1 ,0 ,0 ,0 ,1 ,0 ,2 ,0 ,2,9811 , 0 
20881.35,15,11 ,11 ,1092 ,0 ,0 ,2 ,0 ,0 ,0 ,0 ,2 ,0 ,5 ,0 ,5,13385 , 0 
20881.36,20,11 ,5 ,804 ,0 ,0 ,1 ,0 ,0 ,0 ,0 ,1 ,0 ,0 ,0 ,0,10895 , 0 
20881.36,16,11 ,2 ,512 ,0 ,0 ,1 ,1 ,0 ,0 ,0 ,2 ,0 ,12 ,0 ,12,27364 , 1 
20881.444,10,11 ,14 ,843 ,0 ,0 ,0 ,0 ,0 ,0 ,0 ,0 ,0 ,1 ,0 ,1,11415 , 0 
20881.482,12,11 ,5 ,804 ,0 ,0 ,2 ,0 ,0 ,0 ,0 ,2 ,0 ,2 ,0 ,2,12044 , 0 
20881.596,9,11 ,5 ,804 ,0 ,0 ,2 ,0 ,0 ,0 ,0 ,2 ,0 ,6 ,0 ,6,22343 , 0 
20881.602,5,11 ,13 ,512 ,0 ,0 ,1 ,0 ,0 ,0 ,0 ,1 ,0 ,5 ,0 ,5,19218 , 0 
20881.606,19,11 ,1 ,256 ,0 ,0 ,2 ,0 ,0 ,0 ,0 ,2 ,0 ,2 ,0 ,2,12205 , 0 
20881.696,17,11 ,6 ,849 ,0 ,0 ,3 ,1 ,1 ,0 ,0 ,5 ,0 ,5 ,1 ,6,16118 , 0 
20881.771,13,11 ,1 ,256 ,0 ,0 ,0 ,0 ,0 ,0 ,0 ,0 ,0 ,2 ,0 ,2,10886 , 0 
20881.786,3,11 ,1 ,256 ,0 ,0 ,2 ,0 ,1 ,0 ,0 ,3 ,0 ,0 ,1 ,1,7378 , 0 
21000.96,8,11 ,1 ,256 ,0 ,0 ,1 ,0 ,0 ,0 ,0 ,1 ,0 ,1 ,0 ,1,8576 , 0 
21001.078,11,11 ,5 ,800 ,0 ,0 ,1 ,0 ,0 ,0 ,0 ,1 ,0 ,3 ,0 ,3,15258 , 0 
21001.123,2,11 ,1 ,256 ,0 ,0 ,2 ,0 ,2 ,0 ,0 ,4 ,0 ,0 ,2 ,2,15718 , 0 
21001.138,6,11 ,2 ,512 ,0 ,0 ,1 ,0 ,2 ,0 ,0 ,3 ,0 ,1 ,2 ,3,20198 , 0 
21001.214,18,11 ,19 ,536 ,0 ,0 ,1 ,0 ,0 ,0 ,0 ,1 ,0 ,1 ,0 ,1,12172 , 0 
21001.236,4,11 ,8 ,548 ,0 ,0 ,2 ,0 ,0 ,0 ,0 ,2 ,0 ,0 ,0 ,0,10486 , 0 
21001.289,7,11 ,17 ,1090 ,0 ,0 ,2 ,1 ,0 ,0 ,0 ,3 ,0 ,1 ,0 ,1,19086 , 0 
21001.337,14,11 ,3 ,512 ,0 ,0 ,0 ,0 ,0 ,0 ,0 ,0 ,0 ,1 ,0 ,1,10706 , 0 
21001.35,15,11 ,11 ,1092 ,0 ,0 ,1 ,0 ,0 ,0 ,0 ,1 ,0 ,2 ,0 ,2,14496 , 0 
21001.36,20,11 ,5 ,804 ,0 ,0 ,2 ,0 ,0 ,0 ,0 ,2 ,0 ,1 ,0 ,1,12216 , 0 
21001.36,16,11 ,2 ,512 ,0 ,0 ,1 ,0 ,0 ,0 ,0 ,1 ,0 ,1 ,0 ,1,25810 , 0 
21001.444,10,11 ,14 ,843 ,0 ,0 ,1 ,0 ,0 ,0 ,0 ,1 ,0 ,0 ,0 ,0,11292 , 0 
21001.482,12,11 ,5 ,804 ,0 ,0 ,1 ,0 ,0 ,0 ,0 ,1 ,0 ,1 ,0 ,1,12494 , 0 
21001.596,9,11 ,5 ,804 ,0 ,0 ,1 ,1 ,0 ,0 ,0 ,2 ,0 ,5 ,0 ,5,22258 , 0 
21001.602,5,11 ,13 ,512 ,0 ,0 ,1 ,0 ,1 ,0 ,0 ,2 ,0 ,2 ,1 ,3,20310 , 0 
21001.606,19,11 ,1 ,256 ,0 ,0 ,1 ,0 ,0 ,0 ,0 ,1 ,0 ,3 ,0 ,3,12885 , 0 
21001.696,17,11 ,6 ,825 ,0 ,0 ,1 ,1 ,1 ,0 ,0 ,3 ,0 ,2 ,1 ,3,16559 , 0 
21001.771,13,11 ,1 ,256 ,0 ,0 ,1 ,0 ,1 ,0 ,0 ,2 ,0 ,1 ,1 ,2,11326 , 0 
21001.786,3,11 ,1 ,256 ,0 ,0 ,1 ,0 ,0 ,0 ,0 ,1 ,0 ,1 ,0 ,1,7865 , 0 
21120.96,8,11 ,1 ,256 ,0 ,0 ,2 ,0 ,1 ,0 ,0 ,3 ,0 ,0 ,1 ,1,8706 , 0 
21121.078,11,11 ,5 ,800 ,0 ,0 ,1 ,0 ,0 ,0 ,0 ,1 ,0 ,1 ,0 ,1,14260 , 0 
21121.123,2,11 ,1 ,256 ,0 ,0 ,2 ,0 ,4 ,0 ,1 ,7 ,0 ,3 ,6 ,9,16555 , 0 
21121.138,6,11 ,2 ,512 ,0 ,0 ,2 ,1 ,0 ,1 ,1 ,5 ,0 ,3 ,2 ,5,22691 , 0 
21121.214,18,11 ,19 ,536 ,0 ,0 ,2 ,0 ,0 ,0 ,0 ,2 ,0 ,2 ,0 ,2,11195 , 0 
21121.235,4,11 ,8 ,540 ,0 ,0 ,0 ,1 ,0 ,0 ,0 ,1 ,0 ,3 ,0 ,3,9961 , 0 
21121.289,7,11 ,16 ,785 ,0 ,0 ,5 ,2 ,0 ,1 ,0 ,8 ,0 ,5 ,0 ,5,19610 , 0 
21121.337,14,11 ,3 ,512 ,0 ,0 ,0 ,0 ,0 ,0 ,0 ,0 ,0 ,2 ,0 ,2,9878 , 0 
21121.35,15,11 ,11 ,1092 ,0 ,0 ,1 ,0 ,0 ,0 ,0 ,1 ,0 ,4 ,0 ,4,13443 , 0 
21121.36,20,11 ,5 ,804 ,0 ,0 ,1 ,0 ,0 ,0 ,0 ,1 ,0 ,1 ,0 ,1,10948 , 0 
21121.36,16,11 ,2 ,512 ,0 ,0 ,2 ,1 ,2 ,0 ,0 ,5 ,0 ,9 ,2 ,11,27487 , 0 
21121.444,10,11 ,14 ,843 ,0 ,0 ,1 ,0 ,0 ,0 ,0 ,1 ,0 ,1 ,0 ,1,11477 , 0 
21121.482,12,11 ,5 ,804 ,0 ,0 ,1 ,0 ,0 ,0 ,0 ,1 ,0 ,2 ,0 ,2,12114 , 0 
21121.596,9,11 ,5 ,804 ,0 ,0 ,2 ,0 ,0 ,0 ,0 ,2 ,0 ,6 ,0 ,6,22418 , 0 
21121.602,5,11 ,13 ,512 ,0 ,0 ,2 ,0 ,0 ,0 ,0 ,2 ,0 ,5 ,0 ,5,19313 , 0 
21121.606,19,11 ,1 ,256 ,0 ,0 ,1 ,0 ,0 ,0 ,0 ,1 ,0 ,4 ,0 ,4,12310 , 0 
21121.696,17,11 ,6 ,808 ,0 ,0 ,2 ,0 ,0 ,1 ,1 ,4 ,0 ,6 ,1 ,7,16198 , 0 
21121.771,13,11 ,1 ,256 ,0 ,0 ,1 ,0 ,0 ,0 ,0 ,1 ,0 ,1 ,0 ,1,10963 , 0 
21121.786,3,11 ,1 ,256 ,0 ,0 ,1 ,0 ,0 ,0 ,0 ,1 ,0 ,0 ,0 ,0,7432 , 0 
21240.96,8,11 ,1 ,256 ,0 ,0 ,1 ,0 ,0 ,0 ,0 ,1 ,0 ,2 ,0 ,2,8644 , 0 
21241.078,11,11 ,5 ,800 ,0 ,0 ,2 ,0 ,0 ,0 ,0 ,2 ,0 ,1 ,0 ,1,15338 , 0 
21241.123,2,11 ,1 ,256 ,0 ,0 ,1 ,0 ,0 ,0 ,0 ,1 ,0 ,0 ,0 ,0,15782 , 0 
21241.138,6,11 ,2 ,512 ,0 ,0 ,1 ,0 ,0 ,0 ,0 ,1 ,0 ,2 ,0 ,2,20253 , 0 
21241.214,18,11 ,19 ,536 ,0 ,0 ,1 ,0 ,0 ,0 ,0 ,1 ,0 ,0 ,0 ,0,12232 , 0 
21241.236,4,11 ,8 ,540 ,0 ,0 ,1 ,0 ,0 ,0 ,0 ,1 ,0 ,0 ,0 ,0,10545 , 0 
21241.289,7,11 ,16 ,785 ,0 ,0 ,1 ,0 ,0 ,0 ,0 ,1 ,0 ,1 ,0 ,1,19159 , 0 
21241.337,14,11 ,3 ,512 ,0 ,0 ,0 ,0 ,0 ,0 ,0 ,0 ,0 ,4 ,0 ,4,10771 , 0 
21241.35,15,11 ,11 ,1092 ,0 ,0 ,1 ,0 ,0 ,0 ,0 ,1 ,0 ,1 ,0 ,1,14569 , 0 
21241.36,20,11 ,5 ,804 ,0 ,0 ,1 ,0 ,0 ,0 ,0 ,1 ,0 ,2 ,0 ,2,12271 , 0 
21241.36,16,11 ,2 ,512 ,0 ,0 ,1 ,0 ,0 ,0 ,0 ,1 ,0 ,1 ,0 ,1,25884 , 0 
21241.444,10,11 ,14 ,843 ,0 ,0 ,3 ,0 ,0 ,0 ,0 ,3 ,0 ,1 ,0 ,1,11360 , 0 
21241.482,12,11 ,5 ,804 ,0 ,0 ,1 ,0 ,0 ,0 ,0 ,1 ,0 ,1 ,0 ,1,12567 , 0 
21241.596,9,11 ,5 ,804 ,0 ,0 ,1 ,0 ,0 ,0 ,0 ,1 ,0 ,2 ,0 ,2,22327 , 0 
21241.602,5,11 ,13 ,512 ,0 ,0 ,1 ,0 ,0 ,0 ,0 ,1 ,0 ,2 ,0 ,2,20376 , 0 
21241.606,19,11 ,1 ,256 ,0 ,0 ,1 ,0 ,0 ,0 ,0 ,1 ,0 ,2 ,0 ,2,12956 , 0 
21241.696,17,11 ,6 ,808 ,0 ,0 ,1 ,0 ,0 ,0 ,0 ,1 ,0 ,2 ,0 ,2,16623 , 0 
21241.771,13,11 ,1 ,256 ,0 ,0 ,1 ,0 ,0 ,0 ,0 ,1 ,0 ,1 ,0 ,1,11399 , 0 
21241.786,3,11 ,1 ,256 ,0 ,0 ,2 ,0 ,0 ,0 ,0 ,2 ,0 ,0 ,0 ,0,7944 , 0 
21360.96,8,11 ,1 ,256 ,0 ,0 ,0 ,0 ,0 ,0 ,0 ,0 ,0 ,1 ,0 ,1,8765 , 0 
21361.078,11,11 ,5 ,800 ,0 ,0 ,2 ,0 ,0 ,0 ,0 ,2 ,0 ,2 ,0 ,2,14336 , 0 
21361.123,2,11 ,1 ,256 ,0 ,0 ,1 ,0 ,0 ,0 ,0 ,1 ,0 ,1 ,0 ,1,16643 , 0 
21361.138,6,11 ,2 ,512 ,0 ,0 ,1 ,0 ,0 ,0 ,0 ,1 ,0 ,1 ,0 ,1,22749 , 0 
21361.214,18,11 ,19 ,536 ,0 ,0 ,1 ,0 ,0 ,0 ,0 ,1 ,0 ,4 ,0 ,4,11253 , 0 
21361.236,4,11 ,8 ,540 ,0 ,0 ,1 ,0 ,0 ,0 ,0 ,1 ,0 ,0 ,0 ,0,10013 , 0 
21361.289,7,11 ,16 ,785 ,0 ,0 ,3 ,0 ,0 ,0 ,0 ,3 ,0 ,0 ,0 ,0,19690 , 0 
21361.337,14,11 ,3 ,512 ,0 ,0 ,0 ,0 ,0 ,0 ,0 ,0 ,0 ,1 ,0 ,1,9950 , 0 
21361.35,15,11 ,11 ,1071 ,0 ,0 ,1 ,0 ,0 ,0 ,0 ,1 ,0 ,3 ,0 ,3,13516 , 0 
21361.36,20,11 ,5 ,804 ,0 ,0 ,0 ,0 ,0 ,0 ,0 ,0 ,0 ,2 ,0 ,2,11019 , 0 
21361.36,16,11 ,2 ,512 ,0 ,0 ,1 ,0 ,0 ,0 ,0 ,1 ,0 ,2 ,0 ,2,27557 , 1 
21361.444,10,11 ,14 ,843 ,0 ,0 ,0 ,0 ,0 ,0 ,0 ,0 ,0 ,0 ,0 ,0,11527 , 0 
21361.482,12,11 ,5 ,804 ,0 ,0 ,2 ,0 ,0 ,0 ,0 ,2 ,0 ,2 ,0 ,2,12175 , 0 
21361.596,9,11 ,5 ,804 ,0 ,0 ,0 ,0 ,0 ,0 ,0 ,0 ,0 ,3 ,0 ,3,22486 , 0 
21361.602,5,11 ,13 ,512 ,0 ,0 ,1 ,0 ,0 ,0 ,0 ,1 ,0 ,3 ,0 ,3,19416 , 0 
21361.606,19,11 ,1 ,256 ,0 ,0 ,1 ,0 ,0 ,0 ,0 ,1 ,0 ,1 ,0 ,1,12382 , 0 
21361.696,17,11 ,6 ,808 ,0 ,0 ,1 ,0 ,0 ,0 ,0 ,1 ,0 ,2 ,0 ,2,16274 , 0 
21361.771,13,11 ,1 ,256 ,0 ,0 ,1 ,0 ,0 ,0 ,0 ,1 ,0 ,0 ,0 ,0,11023 , 0 
21361.786,3,11 ,1 ,256 ,0 ,0 ,1 ,0 ,0 ,0 ,0 ,1 ,0 ,0 ,0 ,0,7492 , 0 
21480.96,8,11 ,1 ,256 ,0 ,0 ,2 ,0 ,0 ,0 ,0 ,2 ,0 ,1 ,0 ,1,8711 , 0 
21481.078,11,11 ,5 ,800 ,0 ,0 ,1 ,0 ,1 ,0 ,0 ,2 ,0 ,2 ,1 ,3,15431 , 0 
21481.123,2,11 ,1 ,256 ,0 ,0 ,1 ,0 ,2 ,0 ,1 ,4 ,0 ,2 ,3 ,5,15949 , 0 
21481.138,6,11 ,2 ,512 ,0 ,0 ,2 ,0 ,2 ,0 ,0 ,4 ,0 ,1 ,2 ,3,20365 , 0 
21481.214,18,11 ,19 ,536 ,0 ,0 ,1 ,0 ,0 ,0 ,0 ,1 ,0 ,0 ,0 ,0,12298 , 0 
21481.236,4,11 ,8 ,529 ,0 ,0 ,1 ,0 ,0 ,0 ,0 ,1 ,0 ,3 ,0 ,3,10638 , 0 
21481.289,7,11 ,17 ,1068 ,0 ,0 ,4 ,1 ,0 ,1 ,0 ,6 ,0 ,3 ,0 ,3,19269 , 0 
21481.337,14,11 ,3 ,512 ,0 ,0 ,0 ,0 ,0 ,0 ,0 ,0 ,0 ,1 ,0 ,1,10837 , 0 
21481.35,15,11 ,11 ,1069 ,0 ,0 ,1 ,1 ,0 ,0 ,0 ,2 ,0 ,6 ,0 ,6,14677 , 0 
21481.36,20,11 ,5 ,804 ,0 ,0 ,1 ,0 ,0 ,0 ,0 ,1 ,0 ,0 ,0 ,0,12338 , 0 
21481.36,16,11 ,2 ,512 ,0 ,0 ,1 ,0 ,0 ,0 ,1 ,2 ,0 ,7 ,1 ,8,25980 , 1 
21481.444,10,11 ,14 ,843 ,0 ,0 ,1 ,0 ,0 ,0 ,0 ,1 ,0 ,1 ,0 ,1,11426 , 0 
21481.482,12,11 ,5 ,804 ,0 ,0 ,1 ,0 ,0 ,0 ,0 ,1 ,0 ,1 ,0 ,1,12648 , 0 
21481.596,9,11 ,5 ,804 ,0 ,0 ,2 ,0 ,0 ,0 ,0 ,2 ,0 ,4 ,0 ,4,22411 , 0 
21481.602,5,11 ,13 ,512 ,0 ,0 ,1 ,0 ,1 ,0 ,0 ,2 ,0 ,2 ,1 ,3,20484 , 0 
21481.606,19,11 ,1 ,256 ,0 ,0 ,1 ,0 ,0 ,0 ,0 ,1 ,0 ,2 ,0 ,2,13065 , 0 
21481.696,17,11 ,6 ,785 ,0 ,0 ,1 ,1 ,1 ,0 ,0 ,3 ,0 ,4 ,1 ,5,16696 , 0 
21481.771,13,11 ,1 ,256 ,0 ,0 ,1 ,0 ,1 ,0 ,0 ,2 ,0 ,0 ,1 ,1,11480 , 0 
21481.786,3,11 ,1 ,256 ,0 ,0 ,2 ,0 ,0 ,0 ,0 ,2 ,0 ,1 ,0 ,1,7999 , 0 
21600.96,8,11 ,1 ,256 ,0 ,0 ,1 ,0 ,0 ,0 ,0 ,1 ,0 ,3 ,0 ,3,8836 , 0 
21601.078,11,11 ,5 ,800 ,0 ,0 ,2 ,0 ,0 ,0 ,0 ,2 ,0 ,1 ,0 ,1,14407 , 0 
21601.123,2,11 ,1 ,256 ,0 ,0 ,2 ,0 ,4 ,0 ,0 ,6 ,0 ,0 ,5 ,5,16736 , 0 
21601.138,6,11 ,2 ,512 ,0 ,0 ,1 ,1 ,2 ,0 ,0 ,4 ,0 ,3 ,2 ,5,22826 , 0 
21601.214,18,11 ,19 ,536 ,0 ,0 ,0 ,0 ,0 ,0 ,0 ,0 ,0 ,1 ,0 ,1,11306 , 0 
21601.236,4,11 ,8 ,527 ,0 ,0 ,2 ,0 ,0 ,0 ,0 ,2 ,0 ,1 ,0 ,1,10078 , 0 
21601.289,7,11 ,17 ,1064 ,0 ,0 ,3 ,1 ,0 ,0 ,0 ,4 ,0 ,2 ,0 ,2,19765 , 0 
21601.337,14,11 ,3 ,512 ,0 ,0 ,0 ,1 ,0 ,0 ,0 ,1 ,0 ,3 ,0 ,3,10026 , 0 
21601.35,15,11 ,11 ,1069 ,0 ,0 ,1 ,0 ,0 ,0 ,0 ,1 ,0 ,3 ,0 ,3,13578 , 0 
21601.36,20,11 ,5 ,785 ,0 ,0 ,1 ,0 ,0 ,0 ,0 ,1 ,0 ,1 ,0 ,1,11077 , 0 
21601.36,16,11 ,2 ,512 ,0 ,0 ,2 ,1 ,0 ,1 ,0 ,4 ,0 ,4 ,0 ,4,27658 , 1 
21601.444,10,11 ,14 ,843 ,0 ,0 ,1 ,0 ,0 ,0 ,0 ,1 ,0 ,0 ,0 ,0,11579 , 0 
21601.482,12,11 ,5 ,804 ,0 ,0 ,1 ,0 ,0 ,0 ,0 ,1 ,0 ,1 ,0 ,1,12250 , 0 
21601.596,9,11 ,5 ,785 ,0 ,0 ,2 ,0 ,0 ,0 ,0 ,2 ,0 ,5 ,0 ,5,22585 , 0 
21601.602,5,11 ,13 ,512 ,0 ,0 ,2 ,0 ,0 ,0 ,0 ,2 ,0 ,2 ,0 ,2,19506 , 0 
21601.606,19,11 ,1 ,256 ,0 ,0 ,1 ,0 ,0 ,0 ,0 ,1 ,0 ,3 ,0 ,3,12455 , 0 
21601.696,17,11 ,6 ,783 ,0 ,0 ,1 ,1 ,1 ,0 ,0 ,3 ,0 ,4 ,1 ,5,16366 , 0 
21601.771,13,11 ,1 ,256 ,0 ,0 ,1 ,0 ,0 ,0 ,0 ,1 ,0 ,2 ,0 ,2,11112 , 0 
21601.786,3,11 ,1 ,256 ,0 ,0 ,2 ,0 ,1 ,0 ,0 ,3 ,0 ,1 ,1 ,2,7569 , 0 
21720.96,8,11 ,1 ,256 ,0 ,0 ,1 ,0 ,0 ,0 ,0 ,1 ,0 ,1 ,0 ,1,8779 , 0 
21721.078,11,11 ,5 ,800 ,0 ,0 ,1 ,0 ,0 ,0 ,0 ,1 ,0 ,0 ,0 ,0,15496 , 0 
21721.123,2,11 ,1 ,256 ,0 ,0 ,1 ,0 ,0 ,0 ,0 ,1 ,0 ,2 ,0 ,2,16042 , 0 
21721.138,6,11 ,2 ,512 ,0 ,0 ,1 ,0 ,0 ,0 ,0 ,1 ,0 ,1 ,0 ,1,20426 , 0 
21721.214,18,11 ,19 ,536 ,0 ,0 ,2 ,0 ,0 ,0 ,0 ,2 ,0 ,2 ,0 ,2,12374 , 0 
21721.236,4,11 ,8 ,527 ,0 ,0 ,1 ,0 ,0 ,0 ,0 ,1 ,0 ,0 ,0 ,0,10694 , 0 
21721.289,7,11 ,17 ,1056 ,0 ,0 ,2 ,0 ,0 ,0 ,0 ,2 ,0 ,2 ,0 ,2,19371 , 0 
21721.337,14,11 ,3 ,512 ,0 ,0 ,0 ,0 ,0 ,0 ,0 ,0 ,0 ,2 ,0 ,2,10909 , 0 
21721.35,15,11 ,11 ,1069 ,0 ,0 ,1 ,0 ,0 ,0 ,0 ,1 ,0 ,2 ,0 ,2,14744 , 0 
21721.36,20,11 ,5 ,785 ,0 ,0 ,1 ,1 ,0 ,0 ,0 ,2 ,0 ,1 ,0 ,1,12436 , 0 
21721.36,16,11 ,2 ,512 ,0 ,0 ,0 ,0 ,0 ,0 ,0 ,0 ,0 ,4 ,0 ,4,26069 , 0 
21721.444,10,11 ,14 ,843 ,0 ,0 ,1 ,0 ,0 ,0 ,0 ,1 ,0 ,1 ,0 ,1,11482 , 0 
21721.481,12,11 ,5 ,804 ,0 ,0 ,1 ,0 ,0 ,0 ,0 ,1 ,0 ,1 ,0 ,1,12725 , 0 
21721.596,9,11 ,5 ,785 ,0 ,0 ,1 ,0 ,0 ,0 ,0 ,1 ,0 ,1 ,0 ,1,22482 , 0 
21721.602,5,11 ,13 ,512 ,0 ,0 ,0 ,0 ,1 ,0 ,0 ,1 ,0 ,1 ,1 ,2,20591 , 0 
21721.606,19,11 ,1 ,256 ,0 ,0 ,2 ,0 ,0 ,0 ,0 ,2 ,0 ,2 ,0 ,2,13153 , 0 
21721.696,17,11 ,6 ,783 ,0 ,0 ,2 ,0 ,0 ,0 ,0 ,2 ,0 ,1 ,0 ,1,16786 , 0 
21721.771,13,11 ,1 ,256 ,0 ,0 ,1 ,0 ,1 ,0 ,0 ,2 ,0 ,0 ,1 ,1,11541 , 0 
21721.786,3,11 ,1 ,256 ,0 ,0 ,0 ,0 ,0 ,0 ,0 ,0 ,0 ,0 ,0 ,0,8055 , 0 
21840.96,8,11 ,1 ,256 ,0 ,0 ,1 ,1 ,1 ,0 ,0 ,3 ,0 ,1 ,1 ,2,8901 , 0 
21841.078,11,11 ,5 ,800 ,0 ,0 ,1 ,0 ,0 ,0 ,0 ,1 ,0 ,4 ,0 ,4,14478 , 0 
21841.123,2,11 ,1 ,256 ,0 ,0 ,1 ,1 ,1 ,0 ,1 ,4 ,0 ,7 ,3 ,10,16828 , 0 
21841.138,6,11 ,2 ,512 ,0 ,0 ,1 ,0 ,0 ,1 ,1 ,3 ,0 ,3 ,2 ,5,22906 , 0 
21841.214,18,11 ,19 ,536 ,0 ,0 ,0 ,0 ,0 ,0 ,0 ,0 ,0 ,0 ,0 ,0,11364 , 0 
21841.236,4,11 ,8 ,525 ,0 ,0 ,0 ,1 ,0 ,0 ,0 ,1 ,0 ,2 ,0 ,2,10160 , 0 
21841.289,7,11 ,16 ,805 ,0 ,0 ,5 ,1 ,0 ,1 ,0 ,7 ,0 ,1 ,0 ,1,19860 , 0 
21841.337,14,11 ,1 ,256 ,0 ,0 ,5 ,1 ,4 ,1 ,0 ,11 ,0 ,1 ,4 ,5,10126 , 0 
21841.35,15,11 ,11 ,1069 ,0 ,0 ,3 ,0 ,0 ,0 ,0 ,3 ,0 ,4 ,0 ,4,13663 , 0 
21841.36,20,11 ,5 ,785 ,0 ,0 ,2 ,0 ,0 ,0 ,0 ,2 ,0 ,1 ,0 ,1,11159 , 0 
21841.36,16,11 ,2 ,512 ,0 ,0 ,2 ,0 ,1 ,0 ,0 ,3 ,0 ,4 ,1 ,5,27741 , 0 
21841.444,10,11 ,14 ,342 ,0 ,0 ,1 ,4 ,0 ,0 ,0 ,5 ,0 ,4 ,0 ,4,11667 , 0 
21841.481,12,11 ,5 ,804 ,0 ,0 ,2 ,0 ,0 ,0 ,0 ,2 ,0 ,0 ,0 ,0,12345 , 0 
21841.596,9,11 ,5 ,785 ,0 ,0 ,1 ,0 ,0 ,0 ,0 ,1 ,0 ,9 ,0 ,9,22674 , 0 
21841.602,5,11 ,13 ,512 ,0 ,0 ,2 ,0 ,0 ,0 ,0 ,2 ,0 ,3 ,0 ,3,19612 , 0 
21841.606,19,11 ,1 ,256 ,0 ,0 ,1 ,1 ,0 ,0 ,0 ,2 ,0 ,2 ,0 ,2,12552 , 0 
21841.696,17,11 ,6 ,783 ,0 ,0 ,1 ,0 ,0 ,1 ,1 ,3 ,0 ,5 ,1 ,6,16432 , 0 
21841.771,13,11 ,1 ,256 ,0 ,0 ,1 ,1 ,0 ,0 ,0 ,2 ,0 ,7 ,0 ,7,11205 , 0 
21841.786,3,11 ,1 ,256 ,0 ,0 ,1 ,1 ,0 ,1 ,1 ,4 ,0 ,5 ,1 ,6,7625 , 0 
21960.96,8,11 ,1 ,256 ,0 ,0 ,2 ,0 ,0 ,0 ,0 ,2 ,0 ,2 ,0 ,2,8850 , 0 
21961.078,11,11 ,5 ,800 ,0 ,0 ,1 ,0 ,0 ,0 ,0 ,1 ,0 ,2 ,0 ,2,15558 , 0 
21961.123,2,11 ,1 ,256 ,0 ,0 ,1 ,0 ,2 ,0 ,0 ,3 ,0 ,3 ,2 ,5,16144 , 0 
21961.138,6,11 ,2 ,512 ,0 ,0 ,1 ,0 ,0 ,0 ,0 ,1 ,0 ,1 ,0 ,1,20526 , 0 
21961.214,18,11 ,19 ,536 ,0 ,0 ,1 ,0 ,0 ,0 ,0 ,1 ,0 ,3 ,0 ,3,12450 , 0 
21961.236,4,11 ,8 ,525 ,0 ,0 ,2 ,0 ,0 ,0 ,0 ,2 ,0 ,1 ,0 ,1,10784 , 0 
21961.289,7,11 ,16 ,801 ,0 ,0 ,3 ,1 ,0 ,0 ,0 ,4 ,0 ,2 ,0 ,2,19451 , 0 
21961.337,14,11 ,1 ,256 ,0 ,0 ,2 ,0 ,1 ,0 ,0 ,3 ,0 ,2 ,1 ,3,10977 , 0 
21961.35,15,11 ,11 ,1069 ,0 ,0 ,0 ,0 ,0 ,0 ,0 ,0 ,0 ,2 ,0 ,2,14796 , 0 
21961.36,20,11 ,5 ,785 ,0 ,0 ,1 ,0 ,0 ,0 ,0 ,1 ,0 ,0 ,0 ,0,12503 , 0 
21961.36,16,11 ,2 ,512 ,0 ,0 ,1 ,1 ,1 ,0 ,0 ,3 ,0 ,3 ,1 ,4,26188 , 0 
21961.444,10,11 ,14 ,359 ,0 ,0 ,2 ,1 ,0 ,0 ,0 ,3 ,0 ,1 ,0 ,1,11562 , 0 
21961.482,12,11 ,5 ,804 ,0 ,0 ,1 ,0 ,0 ,0 ,0 ,1 ,0 ,1 ,0 ,1,12805 , 0 
21961.596,9,11 ,5 ,785 ,0 ,0 ,2 ,0 ,0 ,0 ,0 ,2 ,0 ,3 ,0 ,3,22577 , 0 
21961.602,5,11 ,13 ,512 ,0 ,0 ,1 ,0 ,0 ,0 ,0 ,1 ,0 ,1 ,0 ,1,20735 , 0 
21961.606,19,11 ,1 ,256 ,0 ,0 ,1 ,0 ,0 ,0 ,0 ,1 ,0 ,3 ,0 ,3,13229 , 0 
21961.696,17,11 ,6 ,783 ,0 ,0 ,1 ,0 ,0 ,0 ,0 ,1 ,0 ,1 ,0 ,1,16858 , 0 
21961.771,13,11 ,1 ,256 ,0 ,0 ,1 ,0 ,0 ,0 ,0 ,1 ,0 ,1 ,0 ,1,11617 , 0 
21961.786,3,11 ,1 ,256 ,0 ,0 ,2 ,0 ,0 ,0 ,0 ,2 ,0 ,2 ,0 ,2,8116 , 0 
22080.96,8,34 ,1 ,256 ,0 ,0 ,10 ,6 ,2 ,6 ,1 ,25 ,0 ,20 ,3 ,23,9261 , 0 
22081.084,11,34 ,5 ,768 ,0 ,0 ,13 ,3 ,0 ,7 ,1 ,24 ,0 ,33 ,1 ,34,14912 , 0 
22081.124,2,34 ,1 ,256 ,0 ,0 ,14 ,6 ,1 ,10 ,3 ,34 ,0 ,32 ,13 ,45,17295 , 0 
22081.138,6,35 ,2 ,512 ,0 ,0 ,12 ,2 ,1 ,4 ,1 ,20 ,0 ,27 ,2 ,29,23201 , 0 
22081.214,18,28 ,0 ,0 ,0 ,0 ,10 ,4 ,3 ,8 ,2 ,27 ,0 ,19 ,8 ,27,11958 , 0 
22081.236,4,34 ,8 ,512 ,0 ,0 ,10 ,7 ,0 ,7 ,0 ,24 ,0 ,13 ,1 ,14,10534 , 0 
22081.29,7,38 ,17 ,65535 ,0 ,0 ,14 ,1 ,3 ,2 ,1 ,21 ,0 ,27 ,17 ,44,20172 , 1 
22081.338,14,34 ,1 ,256 ,0 ,0 ,12 ,9 ,7 ,8 ,6 ,42 ,0 ,22 ,17 ,39,10634 , 0 
22081.35,15,37 ,7 ,1306 ,0 ,0 ,15 ,2 ,0 ,3 ,0 ,20 ,0 ,29 ,2 ,31,13955 , 0 
22081.36,20,34 ,20 ,0 ,0 ,0 ,11 ,3 ,1 ,4 ,0 ,19 ,0 ,14 ,2 ,16,11514 , 0 
22081.361,16,33 ,7 ,1306 ,0 ,0 ,11 ,2 ,1 ,3 ,1 ,18 ,0 ,29 ,9 ,38,28022 , 0 
22081.444,10,35 ,14 ,512 ,0 ,0 ,11 ,6 ,0 ,9 ,0 ,26 ,0 ,16 ,0 ,16,12075 , 0 
22081.482,12,33 ,0 ,0 ,0 ,0 ,8 ,4 ,0 ,5 ,0 ,17 ,0 ,17 ,1 ,18,12616 , 0 
22081.596,9,37 ,7 ,1306 ,0 ,0 ,14 ,2 ,1 ,4 ,2 ,23 ,0 ,34 ,13 ,47,23071 , 0 
22081.603,5,34 ,13 ,512 ,0 ,0 ,13 ,6 ,6 ,9 ,7 ,41 ,0 ,36 ,23 ,59,20262 , 0 
22081.607,19,34 ,1 ,256 ,0 ,0 ,9 ,5 ,15 ,5 ,10 ,44 ,0 ,27 ,32 ,59,12997 , 0 
22081.697,17,37 ,16 ,2074 ,0 ,0 ,13 ,2 ,0 ,4 ,0 ,19 ,0 ,23 ,5 ,28,16800 , 0 
22081.772,13,34 ,1 ,256 ,0 ,0 ,12 ,6 ,4 ,10 ,5 ,37 ,0 ,25 ,13 ,38,11647 , 0 
22081.787,3,34 ,1 ,256 ,0 ,0 ,10 ,8 ,4 ,6 ,2 ,30 ,0 ,17 ,8 ,25,7914 , 0 
22200.96,8,74 ,1 ,256 ,0 ,0 ,17 ,8 ,5 ,8 ,2 ,40 ,0 ,49 ,9 ,58,9167 , 0 
22201.078,11,74 ,20 ,1532 ,0 ,0 ,21 ,2 ,0 ,5 ,0 ,28 ,0 ,68 ,1 ,69,15961 , 0 
22201.124,2,74 ,1 ,256 ,0 ,0 ,18 ,4 ,6 ,9 ,3 ,40 ,0 ,63 ,15 ,78,16508 , 0 
22201.138,6,74 ,2 ,512 ,0 ,0 ,19 ,4 ,2 ,5 ,2 ,32 ,0 ,46 ,6 ,52,20964 , 0 
22201.214,18,74 ,19 ,512 ,0 ,0 ,19 ,7 ,3 ,6 ,3 ,38 ,0 ,43 ,6 ,49,13019 , 0 
22201.236,4,74 ,8 ,512 ,0 ,0 ,16 ,7 ,0 ,8 ,0 ,31 ,0 ,36 ,0 ,36,11156 , 0 
22201.29,7,80 ,17 ,65535 ,0 ,0 ,21 ,0 ,0 ,0 ,0 ,21 ,0 ,43 ,0 ,43,19673 , 1 
22201.338,14,74 ,1 ,256 ,0 ,0 ,16 ,5 ,3 ,11 ,1 ,36 ,0 ,50 ,10 ,60,11305 , 0 
22201.35,15,73 ,11 ,3349 ,0 ,0 ,19 ,0 ,0 ,2 ,0 ,21 ,0 ,43 ,2 ,45,15033 , 0 
22201.36,20,74 ,0 ,0 ,0 ,0 ,18 ,4 ,0 ,4 ,0 ,26 ,0 ,43 ,1 ,44,12882 , 0 
22201.361,16,74 ,2 ,512 ,0 ,0 ,19 ,4 ,1 ,5 ,0 ,29 ,0 ,48 ,4 ,52,26599 , 0 
22201.444,10,74 ,14 ,512 ,0 ,0 ,18 ,6 ,0 ,8 ,0 ,32 ,0 ,25 ,0 ,25,11880 , 0 
22201.482,12,73 ,5 ,1020 ,0 ,0 ,20 ,5 ,1 ,5 ,1 ,32 ,0 ,53 ,3 ,56,13197 , 0 
22201.601,9,79 ,16 ,1024 ,0 ,0 ,22 ,1 ,0 ,3 ,0 ,26 ,0 ,62 ,1 ,63,22906 , 0 
22201.607,19,74 ,1 ,256 ,0 ,0 ,18 ,7 ,12 ,13 ,6 ,56 ,0 ,71 ,28 ,99,13720 , 0 
22201.609,5,74 ,13 ,742 ,0 ,0 ,21 ,4 ,4 ,8 ,1 ,38 ,0 ,80 ,18 ,98,21308 , 0 
22201.697,17,77 ,16 ,2882 ,0 ,0 ,19 ,1 ,0 ,1 ,0 ,21 ,0 ,40 ,0 ,40,17108 , 0 
22201.772,13,74 ,1 ,256 ,0 ,0 ,17 ,8 ,4 ,11 ,3 ,43 ,0 ,45 ,8 ,53,11938 , 0 
22201.787,3,74 ,1 ,256 ,0 ,0 ,15 ,9 ,0 ,8 ,0 ,32 ,0 ,30 ,0 ,30,8393 , 0 
22320.96,8,117 ,1 ,256 ,0 ,0 ,15 ,6 ,1 ,11 ,2 ,35 ,0 ,45 ,3 ,48,9549 , 0 
22321.078,11,119 ,5 ,1046 ,0 ,0 ,21 ,0 ,0 ,2 ,0 ,23 ,0 ,71 ,4 ,75,15215 , 0 
22321.124,2,117 ,1 ,256 ,0 ,0 ,19 ,5 ,7 ,7 ,4 ,42 ,0 ,78 ,16 ,94,17733 , 0 
22321.138,6,117 ,2 ,512 ,0 ,0 ,20 ,4 ,0 ,6 ,0 ,30 ,0 ,46 ,1 ,47,23630 , 0 
22321.214,18,119 ,19 ,602 ,0 ,0 ,18 ,5 ,1 ,7 ,1 ,32 ,0 ,47 ,3 ,50,12426 , 0 
22321.236,4,119 ,19 ,602 ,0 ,0 ,17 ,6 ,0 ,6 ,0 ,29 ,0 ,30 ,2 ,32,10854 , 0 
22321.29,7,120 ,17 ,65535 ,0 ,0 ,20 ,0 ,0 ,0 ,0 ,20 ,0 ,44 ,0 ,44,20380 , 1 
22321.338,14,104 ,0 ,0 ,0 ,0 ,15 ,5 ,4 ,10 ,5 ,39 ,0 ,50 ,13 ,63,10933 , 0 
22321.351,15,117 ,11 ,3349 ,0 ,0 ,19 ,0 ,0 ,0 ,0 ,19 ,0 ,46 ,0 ,46,14162 , 0 
22321.36,20,119 ,5 ,897 ,0 ,0 ,19 ,5 ,0 ,4 ,0 ,28 ,0 ,41 ,0 ,41,11933 , 0 
22321.361,16,117 ,2 ,512 ,0 ,0 ,19 ,1 ,1 ,1 ,0 ,22 ,0 ,47 ,2 ,49,28321 , 0 
22321.444,10,117 ,14 ,2242 ,0 ,0 ,15 ,5 ,0 ,7 ,0 ,27 ,0 ,26 ,2 ,28,12370 , 0 
22321.482,12,117 ,18 ,1182 ,0 ,0 ,17 ,3 ,0 ,5 ,0 ,25 ,0 ,45 ,0 ,45,12967 , 0 
22321.596,9,119 ,5 ,1046 ,0 ,0 ,21 ,0 ,0 ,2 ,0 ,23 ,0 ,58 ,0 ,58,23333 , 0 
22321.603,5,119 ,2 ,512 ,0 ,0 ,21 ,5 ,3 ,7 ,1 ,37 ,0 ,83 ,15 ,98,20818 , 0 
22321.613,19,119 ,1 ,256 ,0 ,0 ,21 ,6 ,13 ,12 ,7 ,59 ,0 ,80 ,30 ,110,13449 , 0 
22321.698,17,119 ,16 ,2882 ,0 ,0 ,19 ,0 ,0 ,0 ,0 ,19 ,0 ,46 ,0 ,46,17009 , 0 
22321.772,13,117 ,0 ,0 ,0 ,0 ,17 ,5 ,2 ,13 ,1 ,38 ,0 ,47 ,5 ,52,12008 , 0 
22321.787,3,104 ,1 ,256 ,0 ,0 ,13 ,8 ,2 ,9 ,1 ,33 ,0 ,29 ,3 ,32,8168 , 0 
22440.96,8,122 ,1 ,256 ,0 ,0 ,7 ,4 ,1 ,2 ,1 ,15 ,0 ,17 ,2 ,19,9318 , 0 
22441.078,11,122 ,9 ,1448 ,0 ,0 ,11 ,3 ,0 ,3 ,0 ,17 ,0 ,26 ,0 ,26,16304 , 0 
22441.124,2,122 ,1 ,256 ,0 ,0 ,8 ,1 ,13 ,3 ,2 ,27 ,0 ,31 ,16 ,47,16751 , 0 
22441.139,6,122 ,2 ,520 ,0 ,0 ,11 ,4 ,11 ,1 ,3 ,30 ,0 ,24 ,14 ,38,21394 , 0 
22441.214,18,122 ,19 ,526 ,0 ,0 ,8 ,2 ,5 ,0 ,1 ,16 ,0 ,14 ,6 ,20,13323 , 0 
22441.236,4,122 ,19 ,526 ,0 ,0 ,6 ,3 ,0 ,1 ,0 ,10 ,0 ,12 ,0 ,12,11323 , 0 
22441.29,7,122 ,17 ,1587 ,0 ,0 ,13 ,7 ,0 ,3 ,0 ,23 ,0 ,24 ,0 ,24,20088 , 0 
22441.338,14,122 ,1 ,256 ,0 ,0 ,8 ,3 ,4 ,3 ,1 ,19 ,0 ,19 ,7 ,26,11579 , 0 
22441.35,15,122 ,9 ,1448 ,0 ,0 ,9 ,2 ,2 ,2 ,1 ,16 ,0 ,21 ,3 ,24,15302 , 0 
22441.36,20,122 ,12 ,1558 ,0 ,0 ,7 ,3 ,0 ,1 ,0 ,11 ,0 ,19 ,0 ,19,13089 , 0 
22441.361,16,122 ,2 ,520 ,0 ,0 ,12 ,5 ,6 ,3 ,1 ,27 ,0 ,23 ,7 ,30,26942 , 0 
22441.444,10,122 ,14 ,512 ,0 ,0 ,7 ,3 ,2 ,2 ,1 ,15 ,0 ,13 ,4 ,17,12117 , 0 
22441.482,12,122 ,18 ,1040 ,0 ,0 ,8 ,2 ,3 ,0 ,1 ,14 ,0 ,20 ,4 ,24,13517 , 0 
22441.596,9,122 ,5 ,768 ,0 ,0 ,8 ,4 ,7 ,2 ,2 ,23 ,0 ,30 ,11 ,41,23456 , 0 
22441.603,5,122 ,13 ,512 ,0 ,0 ,11 ,3 ,9 ,5 ,2 ,30 ,0 ,29 ,14 ,43,21772 , 0 
22441.607,19,122 ,1 ,256 ,0 ,0 ,6 ,3 ,16 ,5 ,4 ,34 ,0 ,27 ,21 ,48,13996 , 0 
22441.697,17,122 ,16 ,1331 ,0 ,0 ,11 ,4 ,3 ,1 ,0 ,19 ,0 ,19 ,3 ,22,17441 , 0 
22441.772,13,122 ,1 ,256 ,0 ,0 ,8 ,2 ,4 ,3 ,1 ,18 ,0 ,15 ,6 ,21,12221 , 0 
22441.787,3,122 ,1 ,256 ,0 ,0 ,8 ,5 ,0 ,3 ,0 ,16 ,0 ,15 ,0 ,15,8560 , 0 
22560.96,8,122 ,1 ,256 ,0 ,0 ,3 ,1 ,0 ,0 ,0 ,4 ,0 ,6 ,0 ,6,9670 , 0 
22561.078,11,122 ,9 ,1164 ,0 ,0 ,5 ,7 ,0 ,0 ,0 ,12 ,0 ,10 ,0 ,10,15378 , 0 
22561.124,2,122 ,1 ,256 ,0 ,0 ,1 ,1 ,12 ,0 ,1 ,15 ,0 ,10 ,13 ,23,17841 , 0 
22561.138,6,122 ,2 ,520 ,0 ,0 ,3 ,1 ,10 ,0 ,0 ,14 ,0 ,8 ,10 ,18,23815 , 0 
22561.214,18,122 ,19 ,519 ,0 ,0 ,2 ,2 ,0 ,2 ,1 ,7 ,0 ,9 ,1 ,10,12546 , 0 
22561.236,4,122 ,19 ,519 ,0 ,0 ,4 ,2 ,0 ,0 ,0 ,6 ,0 ,6 ,0 ,6,10975 , 0 
22561.29,7,122 ,16 ,1162 ,0 ,0 ,5 ,4 ,0 ,1 ,0 ,10 ,0 ,13 ,0 ,13,20502 , 0 
22561.337,14,122 ,1 ,256 ,0 ,0 ,2 ,1 ,1 ,0 ,0 ,4 ,0 ,3 ,1 ,4,11024 , 0 
22561.35,15,122 ,9 ,1164 ,0 ,0 ,2 ,4 ,0 ,0 ,0 ,6 ,0 ,14 ,0 ,14,14295 , 0 
22561.36,20,122 ,12 ,1087 ,0 ,0 ,2 ,3 ,0 ,0 ,0 ,5 ,0 ,8 ,0 ,8,12053 , 0 
22561.361,16,122 ,6 ,884 ,0 ,0 ,7 ,3 ,9 ,1 ,0 ,20 ,0 ,11 ,13 ,24,28548 , 0 
22561.444,10,122 ,14 ,512 ,0 ,0 ,3 ,1 ,0 ,0 ,0 ,4 ,0 ,2 ,0 ,2,12459 , 0 
22561.482,12,122 ,5 ,806 ,0 ,0 ,5 ,3 ,3 ,2 ,0 ,13 ,0 ,6 ,3 ,9,13165 , 0 
22561.596,9,122 ,5 ,800 ,0 ,0 ,7 ,4 ,11 ,2 ,0 ,24 ,0 ,15 ,11 ,26,23627 , 0 
22561.603,5,122 ,13 ,512 ,0 ,0 ,2 ,2 ,17 ,0 ,1 ,22 ,0 ,14 ,19 ,33,21055 , 0 
22561.607,19,122 ,1 ,256 ,0 ,0 ,3 ,1 ,4 ,2 ,1 ,11 ,0 ,9 ,7 ,16,13627 , 0 
22561.697,17,122 ,16 ,1162 ,0 ,0 ,2 ,3 ,0 ,1 ,1 ,7 ,0 ,11 ,1 ,12,17167 , 0 
22561.772,13,122 ,1 ,256 ,0 ,0 ,2 ,1 ,19 ,1 ,1 ,24 ,0 ,7 ,20 ,27,12130 , 0 
22561.786,3,122 ,1 ,256 ,0 ,0 ,1 ,1 ,0 ,0 ,0 ,2 ,0 ,3 ,0 ,3,8249 , 0 
22680.96,8,122 ,1 ,256 ,0 ,0 ,2 ,1 ,0 ,0 ,0 ,3 ,0 ,2 ,0 ,2,9379 , 0 
22681.078,11,122 ,9 ,1083 ,0 ,0 ,2 ,2 ,0 ,0 ,0 ,4 ,0 ,7 ,0 ,7,16385 , 0 
22681.123,2,122 ,1 ,256 ,0 ,0 ,1 ,1 ,5 ,0 ,0 ,7 ,0 ,3 ,5 ,8,16820 , 0 
22681.138,6,122 ,2 ,512 ,0 ,0 ,1 ,1 ,4 ,0 ,0 ,6 ,0 ,3 ,4 ,7,21495 , 0 
22681.214,18,122 ,19 ,519 ,0 ,0 ,1 ,0 ,0 ,0 ,0 ,1 ,0 ,2 ,0 ,2,13380 , 0 
22681.236,4,122 ,19 ,515 ,0 ,0 ,0 ,1 ,0 ,0 ,0 ,1 ,0 ,1 ,0 ,1,11384 , 0 
22681.289,7,122 ,16 ,1107 ,0 ,0 ,2 ,2 ,0 ,0 ,0 ,4 ,0 ,7 ,0 ,7,20165 , 0 
22681.337,14,122 ,1 ,256 ,0 ,0 ,1 ,1 ,1 ,0 ,0 ,3 ,0 ,6 ,1 ,7,11647 , 0 
22681.35,15,122 ,9 ,1083 ,0 ,0 ,2 ,2 ,0 ,0 ,0 ,4 ,0 ,6 ,0 ,6,15386 , 0 
22681.36,20,122 ,12 ,1060 ,0 ,0 ,2 ,2 ,0 ,0 ,0 ,4 ,0 ,3 ,0 ,3,13159 , 0 
22681.36,16,122 ,6 ,838 ,0 ,0 ,1 ,1 ,3 ,0 ,0 ,5 ,0 ,6 ,3 ,9,27020 , 0 
22681.444,10,122 ,14 ,512 ,0 ,0 ,1 ,1 ,0 ,0 ,0 ,2 ,0 ,2 ,0 ,2,12179 , 0 
22681.482,12,122 ,5 ,787 ,0 ,0 ,3 ,1 ,2 ,0 ,0 ,6 ,0 ,4 ,2 ,6,13609 , 0 
22681.596,9,122 ,5 ,787 ,0 ,0 ,3 ,1 ,4 ,0 ,0 ,8 ,0 ,4 ,4 ,8,23578 , 0 
22681.603,5,122 ,13 ,512 ,0 ,0 ,1 ,1 ,8 ,0 ,0 ,10 ,0 ,9 ,8 ,17,21875 , 0 
22681.606,19,122 ,1 ,256 ,0 ,0 ,1 ,1 ,1 ,0 ,0 ,3 ,0 ,5 ,1 ,6,14065 , 0 
22681.697,17,122 ,16 ,1162 ,0 ,0 ,2 ,1 ,0 ,0 ,0 ,3 ,0 ,2 ,0 ,2,17510 , 0 
22681.771,13,122 ,1 ,256 ,0 ,0 ,2 ,1 ,9 ,0 ,0 ,12 ,0 ,3 ,9 ,12,12303 , 0 
22681.786,3,122 ,1 ,256 ,0 ,0 ,2 ,1 ,0 ,0 ,0 ,3 ,0 ,2 ,0 ,2,8625 , 0 
22800.96,8,122 ,1 ,256 ,0 ,0 ,2 ,1 ,0 ,0 ,0 ,3 ,0 ,4 ,0 ,4,9733 , 0 
22801.078,11,122 ,9 ,1083 ,0 ,0 ,1 ,0 ,0 ,0 ,0 ,1 ,0 ,4 ,0 ,4,15447 , 0 
22801.123,2,122 ,1 ,256 ,0 ,0 ,1 ,1 ,1 ,0 ,1 ,4 ,0 ,3 ,2 ,5,17939 , 0 
22801.138,6,122 ,2 ,512 ,0 ,0 ,1 ,0 ,1 ,0 ,1 ,3 ,0 ,3 ,2 ,5,23923 , 0 
22801.214,18,122 ,19 ,519 ,0 ,0 ,2 ,0 ,0 ,0 ,0 ,2 ,0 ,3 ,0 ,3,12651 , 0 
22801.236,4,122 ,19 ,515 ,0 ,0 ,2 ,0 ,0 ,0 ,0 ,2 ,0 ,4 ,0 ,4,11050 , 0 
22801.289,7,122 ,16 ,1103 ,0 ,0 ,1 ,0 ,0 ,0 ,0 ,1 ,0 ,2 ,0 ,2,20600 , 0 
22801.337,14,122 ,1 ,256 ,0 ,0 ,0 ,1 ,0 ,0 ,0 ,1 ,0 ,4 ,0 ,4,11096 , 0 
22801.35,15,122 ,9 ,1083 ,0 ,0 ,2 ,0 ,0 ,0 ,0 ,2 ,0 ,0 ,0 ,0,14356 , 0 
22801.36,20,122 ,12 ,1058 ,0 ,0 ,2 ,0 ,0 ,0 ,0 ,2 ,0 ,3 ,0 ,3,12142 , 0 
22801.361,16,122 ,9 ,300 ,0 ,0 ,2 ,0 ,1 ,1 ,0 ,4 ,0 ,1 ,1 ,2,28685 , 0 
22801.444,10,122 ,14 ,512 ,0 ,0 ,2 ,0 ,0 ,0 ,0 ,2 ,0 ,1 ,0 ,1,12541 , 0 
22801.482,12,122 ,5 ,787 ,0 ,0 ,1 ,0 ,0 ,0 ,0 ,1 ,0 ,2 ,0 ,2,13264 , 0 
22801.596,9,122 ,5 ,787 ,0 ,0 ,1 ,0 ,0 ,0 ,0 ,1 ,0 ,2 ,0 ,2,23709 , 1 
22801.603,5,122 ,13 ,512 ,0 ,0 ,2 ,1 ,0 ,0 ,0 ,3 ,0 ,5 ,0 ,5,21188 , 0 
22801.606,19,122 ,1 ,256 ,0 ,0 ,1 ,1 ,0 ,0 ,0 ,2 ,0 ,4 ,0 ,4,13727 , 0 
22801.697,17,122 ,16 ,1103 ,0 ,0 ,1 ,1 ,0 ,0 ,0 ,2 ,0 ,1 ,0 ,1,17259 , 0 
22801.771,13,122 ,1 ,256 ,0 ,0 ,1 ,1 ,1 ,0 ,0 ,3 ,0 ,1 ,1 ,2,12196 , 0 
22801.786,3,122 ,1 ,256 ,0 ,0 ,1 ,1 ,0 ,0 ,0 ,2 ,0 ,2 ,0 ,2,8309 , 0 
22920.96,8,122 ,1 ,256 ,0 ,0 ,1 ,0 ,0 ,0 ,0 ,1 ,0 ,3 ,0 ,3,9455 , 0 
22921.078,11,122 ,9 ,1083 ,0 ,0 ,3 ,0 ,0 ,0 ,0 ,3 ,0 ,5 ,0 ,5,16483 , 0 
22921.124,2,122 ,1 ,256 ,0 ,0 ,2 ,0 ,1 ,1 ,0 ,4 ,0 ,10 ,2 ,12,16940 , 0 
22921.138,6,122 ,2 ,512 ,0 ,0 ,2 ,1 ,0 ,1 ,0 ,4 ,0 ,7 ,0 ,7,21588 , 0 
22921.214,18,122 ,19 ,519 ,0 ,0 ,1 ,0 ,0 ,0 ,0 ,1 ,0 ,2 ,0 ,2,13438 , 0 
22921.236,4,122 ,19 ,513 ,0 ,0 ,1 ,1 ,0 ,0 ,0 ,2 ,0 ,1 ,0 ,1,11454 , 0 
22921.289,7,122 ,16 ,662 ,0 ,0 ,2 ,5 ,0 ,0 ,0 ,7 ,0 ,8 ,0 ,8,20291 , 0 
22921.337,14,122 ,1 ,256 ,0 ,0 ,3 ,0 ,1 ,0 ,0 ,4 ,0 ,4 ,1 ,5,11772 , 0 
22921.35,15,122 ,9 ,300 ,0 ,0 ,2 ,1 ,0 ,0 ,0 ,3 ,0 ,4 ,0 ,4,15476 , 0 
22921.36,20,122 ,12 ,1058 ,0 ,0 ,2 ,0 ,0 ,0 ,0 ,2 ,0 ,2 ,0 ,2,13241 , 0 
22921.361,16,122 ,9 ,300 ,0 ,0 ,6 ,1 ,9 ,0 ,0 ,16 ,0 ,4 ,9 ,13,27208 , 0 
22921.444,10,122 ,14 ,512 ,0 ,0 ,0 ,1 ,0 ,0 ,0 ,1 ,0 ,2 ,0 ,2,12237 , 0 
22921.482,12,122 ,5 ,787 ,0 ,0 ,2 ,0 ,0 ,0 ,0 ,2 ,0 ,4 ,0 ,4,13738 , 0 
22921.596,9,122 ,5 ,773 ,0 ,0 ,1 ,1 ,8 ,0 ,0 ,10 ,0 ,7 ,11 ,18,23794 , 1 
22921.603,5,122 ,13 ,512 ,0 ,0 ,2 ,0 ,9 ,0 ,0 ,11 ,0 ,5 ,9 ,14,22014 , 0 
22921.606,19,122 ,1 ,256 ,0 ,0 ,2 ,0 ,1 ,0 ,0 ,3 ,0 ,3 ,1 ,4,14155 , 0 
22921.696,17,122 ,16 ,662 ,0 ,0 ,2 ,4 ,0 ,0 ,0 ,6 ,0 ,7 ,0 ,7,17607 , 0 
22921.771,13,122 ,1 ,256 ,0 ,0 ,2 ,0 ,9 ,0 ,0 ,11 ,0 ,5 ,9 ,14,12412 , 0 
22921.786,3,122 ,1 ,256 ,0 ,0 ,2 ,0 ,0 ,0 ,0 ,2 ,0 ,3 ,0 ,3,8717 , 0 
23040.96,8,122 ,1 ,256 ,0 ,0 ,1 ,0 ,0 ,0 ,0 ,1 ,0 ,11 ,0 ,11,9818 , 0 
23041.078,11,122 ,9 ,300 ,0 ,0 ,13 ,13 ,9 ,9 ,0 ,44 ,0 ,44 ,20 ,64,15979 , 0 
23041.124,2,122 ,1 ,256 ,0 ,0 ,9 ,0 ,6 ,0 ,0 ,15 ,0 ,27 ,6 ,33,18104 , 0 
23041.138,6,122 ,2 ,512 ,0 ,0 ,1 ,6 ,0 ,0 ,0 ,7 ,0 ,9 ,0 ,9,24034 , 0 
23041.214,18,122 ,5 ,794 ,0 ,0 ,14 ,10 ,0 ,5 ,0 ,29 ,0 ,33 ,0 ,33,13061 , 0 
23041.236,4,122 ,19 ,520 ,0 ,0 ,7 ,7 ,1 ,0 ,1 ,16 ,0 ,14 ,2 ,16,11242 , 0 
23041.289,7,122 ,16 ,662 ,0 ,0 ,2 ,0 ,0 ,0 ,0 ,2 ,0 ,14 ,0 ,14,20706 , 0 
23041.338,14,122 ,1 ,256 ,0 ,0 ,1 ,0 ,1 ,0 ,0 ,2 ,0 ,12 ,1 ,13,11171 , 0 
23041.35,15,122 ,9 ,300 ,0 ,0 ,1 ,11 ,2 ,0 ,1 ,15 ,0 ,25 ,6 ,31,14669 , 0 
23041.36,20,122 ,12 ,952 ,0 ,0 ,11 ,9 ,0 ,3 ,0 ,23 ,0 ,36 ,0 ,36,12459 , 0 
23041.361,16,122 ,9 ,300 ,0 ,0 ,1 ,11 ,1 ,0 ,0 ,13 ,0 ,16 ,1 ,17,28921 , 0 
23041.444,10,122 ,14 ,512 ,0 ,0 ,1 ,1 ,0 ,0 ,0 ,2 ,0 ,2 ,0 ,2,12612 , 0 
23041.482,12,122 ,11 ,619 ,0 ,0 ,13 ,11 ,8 ,3 ,0 ,35 ,0 ,41 ,12 ,53,13675 , 0 
23041.597,9,122 ,5 ,794 ,0 ,0 ,19 ,10 ,24 ,14 ,2 ,69 ,0 ,27 ,68 ,95,24522 , 1 
23041.607,19,122 ,1 ,256 ,0 ,0 ,8 ,0 ,9 ,0 ,2 ,19 ,0 ,35 ,11 ,46,13920 , 0 
23041.608,5,122 ,9 ,300 ,0 ,0 ,18 ,13 ,33 ,20 ,3 ,87 ,0 ,57 ,61 ,118,21792 , 0 
23041.696,17,122 ,16 ,712 ,0 ,0 ,0 ,1 ,0 ,0 ,0 ,1 ,0 ,1 ,0 ,1,17348 , 0 
23041.772,13,122 ,1 ,256 ,0 ,0 ,9 ,0 ,35 ,0 ,10 ,54 ,0 ,25 ,48 ,73,12437 , 0 
23041.786,3,122 ,1 ,256 ,0 ,0 ,1 ,0 ,0 ,0 ,0 ,1 ,0 ,0 ,0 ,0,8362 , 0 
23160.96,8,122 ,1 ,256 ,0 ,0 ,1 ,0 ,0 ,0 ,0 ,1 ,0 ,8 ,0 ,8,9518 , 0 
23161.078,11,122 ,12 ,1226 ,0 ,0 ,8 ,6 ,1 ,2 ,0 ,17 ,0 ,24 ,2 ,26,16688 , 0 
23161.124,2,122 ,1 ,256 ,0 ,0 ,3 ,0 ,10 ,1 ,2 ,16 ,0 ,14 ,13 ,27,17113 , 0 
23161.138,6,122 ,2 ,512 ,0 ,0 ,1 ,3 ,7 ,1 ,2 ,14 ,0 ,9 ,11 ,20,21864 , 0 
23161.214,18,122 ,5 ,862 ,0 ,0 ,4 ,5 ,0 ,0 ,0 ,9 ,0 ,16 ,0 ,16,13599 , 0 
23161.236,4,122 ,19 ,517 ,0 ,0 ,4 ,2 ,0 ,1 ,0 ,7 ,0 ,6 ,0 ,6,11612 , 0 
23161.29,7,122 ,16 ,1277 ,0 ,0 ,5 ,2 ,3 ,1 ,1 ,12 ,0 ,14 ,7 ,21,20484 , 0 
23161.337,14,122 ,1 ,256 ,0 ,0 ,1 ,0 ,0 ,0 ,0 ,1 ,0 ,5 ,0 ,5,11873 , 0 
23161.35,15,122 ,9 ,1201 ,0 ,0 ,5 ,3 ,0 ,3 ,0 ,11 ,0 ,14 ,1 ,15,15655 , 0 
23161.36,20,122 ,12 ,1226 ,0 ,0 ,5 ,3 ,0 ,0 ,0 ,8 ,0 ,15 ,0 ,15,13373 , 0 
23161.361,16,122 ,6 ,814 ,0 ,0 ,6 ,2 ,7 ,2 ,2 ,19 ,0 ,15 ,11 ,26,27504 , 0 
23161.444,10,122 ,14 ,512 ,0 ,0 ,2 ,0 ,0 ,0 ,0 ,2 ,0 ,0 ,0 ,0,12318 , 0 
23161.482,12,122 ,5 ,862 ,0 ,0 ,6 ,5 ,9 ,1 ,0 ,21 ,0 ,14 ,9 ,23,14027 , 0 
23161.603,5,122 ,13 ,512 ,0 ,0 ,7 ,4 ,21 ,1 ,1 ,34 ,0 ,24 ,28 ,52,22396 , 0 
23161.607,19,122 ,1 ,256 ,0 ,0 ,4 ,0 ,2 ,1 ,0 ,7 ,0 ,14 ,3 ,17,14314 , 0 
23161.615,9,122 ,5 ,862 ,0 ,0 ,7 ,5 ,3 ,6 ,0 ,21 ,0 ,20 ,10 ,30,24091 , 0 
23161.696,17,122 ,6 ,866 ,0 ,0 ,2 ,3 ,0 ,2 ,0 ,7 ,0 ,8 ,0 ,8,17724 , 0 
23161.772,13,122 ,1 ,256 ,0 ,0 ,3 ,0 ,24 ,0 ,1 ,28 ,0 ,9 ,25 ,34,12559 , 0 
23161.786,3,122 ,1 ,256 ,0 ,0 ,2 ,0 ,0 ,0 ,0 ,2 ,0 ,0 ,0 ,0,8779 , 0 
23280.96,8,122 ,1 ,256 ,0 ,0 ,1 ,0 ,0 ,0 ,0 ,1 ,0 ,2 ,0 ,2,9883 , 0 
23281.096,11,122 ,9 ,1154 ,0 ,0 ,3 ,2 ,0 ,1 ,0 ,6 ,0 ,13 ,0 ,13,16107 , 0 
23281.123,2,122 ,1 ,256 ,0 ,0 ,3 ,0 ,4 ,0 ,0 ,7 ,0 ,5 ,4 ,9,18202 , 0 
23281.138,6,122 ,2 ,512 ,0 ,0 ,1 ,1 ,3 ,0 ,0 ,5 ,0 ,5 ,4 ,9,24143 , 0 
23281.214,18,122 ,5 ,798 ,0 ,0 ,2 ,1 ,0 ,0 ,0 ,3 ,0 ,3 ,0 ,3,13138 , 0 
23281.236,4,122 ,19 ,514 ,0 ,0 ,1 ,1 ,0 ,0 ,0 ,2 ,0 ,3 ,0 ,3,11331 , 0 
23281.29,7,122 ,16 ,1240 ,0 ,0 ,1 ,1 ,0 ,0 ,0 ,2 ,0 ,10 ,0 ,10,20783 , 0 
23281.337,14,122 ,1 ,256 ,0 ,0 ,1 ,0 ,0 ,0 ,0 ,1 ,0 ,3 ,0 ,3,11248 , 0 
23281.35,15,122 ,9 ,1239 ,0 ,0 ,6 ,2 ,0 ,0 ,0 ,8 ,0 ,4 ,0 ,4,14776 , 0 
23281.36,20,122 ,12 ,1110 ,0 ,0 ,3 ,1 ,0 ,0 ,0 ,4 ,0 ,4 ,0 ,4,12542 , 0 
23281.36,16,122 ,6 ,849 ,0 ,0 ,1 ,1 ,1 ,1 ,0 ,4 ,0 ,8 ,1 ,9,28996 , 0 
23281.444,10,122 ,14 ,512 ,0 ,0 ,0 ,0 ,0 ,0 ,0 ,0 ,0 ,0 ,0 ,0,12663 , 0 
23281.482,12,122 ,5 ,798 ,0 ,0 ,3 ,1 ,2 ,0 ,1 ,7 ,0 ,4 ,3 ,7,13774 , 0 
23281.596,9,122 ,5 ,798 ,0 ,0 ,3 ,1 ,2 ,0 ,0 ,6 ,0 ,7 ,2 ,9,24641 , 0 
23281.603,5,122 ,13 ,512 ,0 ,0 ,2 ,1 ,8 ,0 ,1 ,12 ,0 ,9 ,9 ,18,21945 , 0 
23281.606,19,122 ,1 ,256 ,0 ,0 ,2 ,0 ,1 ,0 ,0 ,3 ,0 ,4 ,1 ,5,14022 , 0 
23281.696,17,122 ,6 ,866 ,0 ,0 ,5 ,1 ,0 ,0 ,0 ,6 ,0 ,1 ,0 ,1,17439 , 0 
23281.772,13,122 ,1 ,256 ,0 ,0 ,2 ,0 ,9 ,0 ,1 ,12 ,0 ,4 ,10 ,14,12551 , 0 
23281.786,3,122 ,1 ,256 ,0 ,0 ,1 ,0 ,0 ,0 ,0 ,1 ,0 ,0 ,0 ,0,8426 , 0 
23400.96,8,122 ,1 ,256 ,0 ,0 ,2 ,0 ,0 ,0 ,0 ,2 ,0 ,1 ,0 ,1,9601 , 0 
23401.078,11,122 ,9 ,1144 ,0 ,0 ,5 ,0 ,0 ,0 ,0 ,5 ,0 ,4 ,0 ,4,16786 , 0 
23401.123,2,122 ,1 ,256 ,0 ,0 ,1 ,0 ,1 ,0 ,0 ,2 ,0 ,1 ,1 ,2,17183 , 0 
23401.138,6,122 ,2 ,512 ,0 ,0 ,1 ,1 ,0 ,0 ,0 ,2 ,0 ,5 ,0 ,5,21950 , 0 
23401.214,18,122 ,5 ,798 ,0 ,0 ,1 ,0 ,0 ,0 ,0 ,1 ,0 ,1 ,0 ,1,13658 , 0 
23401.236,4,122 ,19 ,514 ,0 ,0 ,1 ,0 ,0 ,0 ,0 ,1 ,0 ,1 ,0 ,1,11671 , 0 
23401.289,7,122 ,16 ,1226 ,0 ,0 ,2 ,0 ,0 ,0 ,0 ,2 ,0 ,7 ,0 ,7,20573 , 0 
23401.337,14,122 ,1 ,256 ,0 ,0 ,1 ,0 ,0 ,0 ,0 ,1 ,0 ,2 ,0 ,2,11932 , 0 
23401.35,15,122 ,9 ,1144 ,0 ,0 ,2 ,1 ,0 ,0 ,0 ,3 ,0 ,7 ,0 ,7,15743 , 0 
23401.36,20,122 ,12 ,1110 ,0 ,0 ,2 ,0 ,0 ,0 ,0 ,2 ,0 ,4 ,0 ,4,13433 , 0 
23401.36,16,122 ,6 ,849 ,0 ,0 ,1 ,0 ,0 ,0 ,0 ,1 ,0 ,5 ,0 ,5,27593 , 0 
23401.444,10,122 ,14 ,512 ,0 ,0 ,2 ,0 ,0 ,0 ,0 ,2 ,0 ,2 ,0 ,2,12379 , 0 
23401.482,12,122 ,5 ,798 ,0 ,0 ,0 ,0 ,0 ,1 ,0 ,1 ,0 ,5 ,0 ,5,14087 , 0 
23401.596,9,122 ,5 ,798 ,0 ,0 ,2 ,0 ,1 ,0 ,0 ,3 ,0 ,8 ,1 ,9,24193 , 0 
23401.602,5,122 ,13 ,512 ,0 ,0 ,0 ,0 ,1 ,0 ,0 ,1 ,0 ,6 ,2 ,8,22470 , 0 
23401.606,19,122 ,1 ,256 ,0 ,0 ,1 ,0 ,0 ,0 ,0 ,1 ,0 ,3 ,0 ,3,14391 , 0 
23401.696,17,122 ,6 ,866 ,0 ,0 ,3 ,0 ,0 ,0 ,0 ,3 ,0 ,2 ,0 ,2,17804 , 0 
23401.771,13,122 ,1 ,256 ,0 ,0 ,1 ,0 ,1 ,0 ,0 ,2 ,0 ,0 ,1 ,1,12622 , 0 
23401.786,3,122 ,1 ,256 ,0 ,0 ,1 ,0 ,0 ,0 ,0 ,1 ,0 ,2 ,0 ,2,8842 , 0 
23520.96,8,122 ,1 ,256 ,0 ,0 ,1 ,0 ,0 ,0 ,0 ,1 ,0 ,3 ,0 ,3,9939 , 0 
23521.078,11,122 ,9 ,1144 ,0 ,0 ,2 ,0 ,0 ,0 ,0 ,2 ,0 ,2 ,0 ,2,16185 , 0 
23521.125,2,122 ,1 ,256 ,0 ,0 ,25 ,0 ,34 ,0 ,0 ,59 ,110 ,22 ,34 ,166,18563 , 0 
23521.214,18,122 ,5 ,778 ,0 ,0 ,0 ,1 ,0 ,0 ,0 ,1 ,0 ,4 ,0 ,4,13211 , 0 
23521.236,4,122 ,19 ,513 ,0 ,0 ,2 ,1 ,0 ,0 ,0 ,3 ,0 ,1 ,0 ,1,11420 , 0 
23521.276,6,122 ,2 ,515 ,0 ,120 ,0 ,18 ,16 ,0 ,0 ,154 ,0 ,82 ,16 ,98,25145 , 1 
23521.29,7,122 ,16 ,1120 ,0 ,0 ,1 ,17 ,0 ,0 ,0 ,18 ,0 ,42 ,0 ,42,21030 , 0 
23521.338,14,122 ,1 ,256 ,0 ,0 ,1 ,0 ,0 ,0 ,0 ,1 ,0 ,32 ,0 ,32,11375 , 0 
23521.35,15,122 ,9 ,1135 ,0 ,0 ,2 ,1 ,0 ,0 ,0 ,3 ,0 ,2 ,0 ,2,14865 , 0 
23521.36,20,122 ,12 ,1110 ,0 ,0 ,1 ,0 ,0 ,0 ,0 ,1 ,0 ,2 ,0 ,2,12634 , 0 
23521.361,16,122 ,6 ,849 ,0 ,0 ,25 ,0 ,16 ,0 ,0 ,41 ,110 ,33 ,16 ,159,29320 , 0 
23521.445,10,122 ,14 ,512 ,0 ,0 ,25 ,0 ,0 ,0 ,0 ,25 ,113 ,0 ,0 ,113,12958 , 0 
23521.482,12,122 ,5 ,798 ,0 ,0 ,1 ,0 ,0 ,0 ,0 ,1 ,0 ,0 ,0 ,0,13885 , 0 
23521.596,9,122 ,5 ,798 ,0 ,0 ,2 ,0 ,1 ,0 ,0 ,3 ,0 ,22 ,1 ,23,24754 , 0 
23521.603,5,122 ,13 ,512 ,0 ,0 ,2 ,1 ,2 ,0 ,0 ,5 ,0 ,20 ,2 ,22,22087 , 0 
23521.607,19,122 ,1 ,256 ,0 ,0 ,1 ,0 ,1 ,0 ,0 ,2 ,0 ,20 ,1 ,21,14114 , 0 
23521.697,17,122 ,6 ,866 ,0 ,0 ,24 ,0 ,0 ,0 ,0 ,24 ,112 ,23 ,0 ,135,17727 , 0 
23521.771,13,122 ,1 ,256 ,0 ,0 ,2 ,0 ,3 ,0 ,0 ,5 ,0 ,23 ,3 ,26,12657 , 0 
23521.786,3,122 ,1 ,256 ,0 ,0 ,1 ,0 ,0 ,0 ,0 ,1 ,0 ,0 ,0 ,0,8482 , 0 
23640.96,8,122 ,1 ,256 ,0 ,0 ,1 ,0 ,0 ,0 ,0 ,1 ,0 ,1 ,0 ,1,9667 , 0 
23641.078,11,122 ,9 ,1144 ,0 ,0 ,1 ,0 ,0 ,0 ,0 ,1 ,0 ,3 ,0 ,3,16888 , 0 
23641.124,2,122 ,1 ,256 ,0 ,0 ,25 ,0 ,33 ,0 ,0 ,58 ,107 ,25 ,33 ,165,17538 , 0 
23641.214,18,122 ,5 ,778 ,0 ,0 ,2 ,0 ,0 ,0 ,0 ,2 ,0 ,2 ,0 ,2,13738 , 0 
23641.236,4,122 ,19 ,513 ,0 ,0 ,2 ,0 ,0 ,0 ,0 ,2 ,0 ,2 ,0 ,2,11768 , 0 
23641.28,6,122 ,2 ,513 ,0 ,120 ,2 ,17 ,16 ,0 ,0 ,155 ,0 ,91 ,16 ,107,22955 , 1 
23641.29,7,122 ,16 ,1046 ,0 ,0 ,1 ,16 ,0 ,0 ,0 ,17 ,0 ,46 ,0 ,46,20826 , 0 
23641.338,14,122 ,1 ,256 ,0 ,0 ,0 ,0 ,0 ,0 ,0 ,0 ,0 ,44 ,0 ,44,12027 , 0 
23641.35,15,122 ,9 ,1118 ,0 ,0 ,1 ,0 ,0 ,0 ,0 ,1 ,0 ,1 ,0 ,1,15811 , 0 
23641.36,20,122 ,12 ,1094 ,0 ,0 ,1 ,1 ,0 ,0 ,0 ,2 ,0 ,1 ,0 ,1,13499 , 0 
23641.361,16,122 ,6 ,790 ,0 ,0 ,25 ,0 ,16 ,0 ,0 ,41 ,106 ,40 ,16 ,162,27922 , 0 
23641.445,10,122 ,14 ,512 ,0 ,0 ,26 ,0 ,0 ,0 ,0 ,26 ,111 ,1 ,0 ,112,12641 , 0 
23641.482,12,122 ,5 ,798 ,0 ,0 ,2 ,0 ,1 ,0 ,0 ,3 ,0 ,2 ,1 ,3,14177 , 0 
23641.596,9,122 ,5 ,798 ,0 ,0 ,1 ,0 ,0 ,0 ,0 ,1 ,0 ,22 ,0 ,22,24280 , 0 
23641.603,5,122 ,13 ,512 ,0 ,0 ,1 ,0 ,1 ,0 ,0 ,2 ,0 ,27 ,1 ,28,22623 , 0 
23641.607,19,122 ,1 ,256 ,0 ,0 ,2 ,0 ,0 ,0 ,0 ,2 ,0 ,28 ,0 ,28,14498 , 0 
23641.697,17,122 ,6 ,866 ,0 ,0 ,26 ,0 ,0 ,0 ,0 ,26 ,109 ,24 ,0 ,133,18094 , 0 
23641.771,13,122 ,1 ,256 ,0 ,0 ,1 ,0 ,1 ,0 ,0 ,2 ,0 ,24 ,1 ,25,12767 , 0 
23641.786,3,122 ,1 ,256 ,0 ,0 ,2 ,0 ,0 ,0 ,0 ,2 ,0 ,0 ,0 ,0,8914 , 0 
23760.96,8,122 ,1 ,256 ,0 ,0 ,2 ,0 ,0 ,0 ,0 ,2 ,0 ,0 ,0 ,0,10046 , 0 
23761.078,11,122 ,12 ,1115 ,0 ,0 ,5 ,1 ,0 ,1 ,0 ,7 ,0 ,1 ,0 ,1,16361 , 0 
23761.124,2,122 ,1 ,256 ,0 ,0 ,25 ,0 ,30 ,0 ,0 ,55 ,106 ,20 ,30 ,156,18881 , 0 
23761.162,6,122 ,2 ,512 ,0 ,120 ,1 ,13 ,18 ,0 ,0 ,152 ,0 ,82 ,18 ,100,26192 , 1 
23761.214,18,122 ,5 ,778 ,0 ,0 ,1 ,0 ,0 ,0 ,0 ,1 ,0 ,1 ,0 ,1,13286 , 0 
23761.236,4,122 ,19 ,513 ,0 ,0 ,1 ,0 ,0 ,0 ,0 ,1 ,0 ,0 ,0 ,0,11488 , 0 
23761.29,7,122 ,16 ,1047 ,0 ,0 ,1 ,18 ,0 ,0 ,0 ,19 ,0 ,44 ,0 ,44,21339 , 0 
23761.338,14,122 ,1 ,256 ,0 ,0 ,2 ,0 ,0 ,0 ,0 ,2 ,0 ,41 ,0 ,41,11490 , 0 
23761.35,15,122 ,9 ,1118 ,0 ,0 ,2 ,1 ,0 ,0 ,0 ,3 ,0 ,4 ,0 ,4,14990 , 0 
23761.36,20,122 ,12 ,1115 ,0 ,0 ,2 ,1 ,0 ,0 ,0 ,3 ,0 ,5 ,0 ,5,12716 , 0 
23761.362,16,122 ,6 ,790 ,0 ,0 ,25 ,0 ,18 ,0 ,0 ,43 ,106 ,38 ,18 ,162,29683 , 0 
23761.445,10,122 ,14 ,512 ,0 ,0 ,25 ,0 ,0 ,0 ,0 ,25 ,107 ,0 ,0 ,107,13254 , 0 
23761.482,12,122 ,5 ,798 ,0 ,0 ,1 ,0 ,2 ,0 ,0 ,3 ,0 ,5 ,2 ,7,14012 , 0 
23761.603,5,122 ,13 ,512 ,0 ,0 ,1 ,0 ,3 ,0 ,1 ,5 ,0 ,24 ,5 ,29,22248 , 0 
23761.607,19,122 ,1 ,256 ,0 ,0 ,0 ,0 ,0 ,0 ,0 ,0 ,0 ,22 ,0 ,22,14219 , 0 
23761.61,9,122 ,5 ,798 ,0 ,0 ,1 ,0 ,1 ,1 ,1 ,4 ,0 ,28 ,2 ,30,24919 , 0 
23761.697,17,122 ,6 ,862 ,0 ,0 ,26 ,0 ,0 ,0 ,0 ,26 ,111 ,23 ,0 ,134,18015 , 0 
23761.771,13,122 ,1 ,256 ,0 ,0 ,1 ,0 ,3 ,0 ,1 ,5 ,0 ,19 ,4 ,23,12758 , 0 
23761.786,3,122 ,1 ,256 ,0 ,0 ,0 ,0 ,0 ,0 ,0 ,0 ,0 ,1 ,0 ,1,8535 , 0 
23880.96,8,122 ,1 ,256 ,0 ,0 ,1 ,0 ,0 ,0 ,0 ,1 ,0 ,3 ,0 ,3,9728 , 0 
23881.078,11,122 ,12 ,1115 ,0 ,0 ,2 ,0 ,0 ,0 ,0 ,2 ,0 ,0 ,0 ,0,16955 , 0 
23881.124,2,122 ,1 ,256 ,0 ,0 ,5 ,0 ,10 ,0 ,0 ,15 ,1 ,5 ,10 ,16,17639 , 0 
23881.138,6,122 ,2 ,512 ,0 ,0 ,1 ,4 ,5 ,0 ,0 ,10 ,0 ,14 ,5 ,19,23116 , 0 
23881.214,18,122 ,5 ,778 ,0 ,0 ,1 ,0 ,0 ,0 ,0 ,1 ,0 ,2 ,0 ,2,13804 , 0 
23881.236,4,122 ,19 ,513 ,0 ,0 ,2 ,0 ,0 ,0 ,0 ,2 ,0 ,1 ,0 ,1,11831 , 0 
23881.289,7,122 ,16 ,1046 ,0 ,0 ,1 ,5 ,0 ,0 ,0 ,6 ,0 ,9 ,0 ,9,20921 , 0 
23881.337,14,122 ,1 ,256 ,0 ,0 ,1 ,0 ,0 ,0 ,0 ,1 ,0 ,8 ,0 ,8,12092 , 0 
23881.35,15,122 ,9 ,1118 ,0 ,0 ,1 ,0 ,0 ,0 ,0 ,1 ,0 ,1 ,0 ,1,15866 , 0 
23881.36,20,122 ,12 ,1115 ,0 ,0 ,1 ,0 ,0 ,0 ,0 ,1 ,0 ,3 ,0 ,3,13568 , 0 
23881.361,16,122 ,6 ,798 ,0 ,0 ,5 ,0 ,5 ,0 ,0 ,10 ,0 ,9 ,5 ,14,28056 , 0 
23881.444,10,122 ,14 ,512 ,0 ,0 ,5 ,0 ,0 ,0 ,0 ,5 ,0 ,0 ,0 ,0,12737 , 0 
23881.482,12,122 ,5 ,769 ,0 ,0 ,1 ,1 ,0 ,0 ,0 ,2 ,0 ,2 ,0 ,2,14269 , 0 
23881.596,9,122 ,5 ,798 ,0 ,0 ,0 ,0 ,0 ,0 ,0 ,0 ,0 ,7 ,0 ,7,24340 , 0 
23881.603,5,122 ,13 ,512 ,0 ,0 ,2 ,0 ,1 ,0 ,0 ,3 ,0 ,5 ,1 ,6,22756 , 0 
23881.606,19,122 ,1 ,256 ,0 ,0 ,2 ,0 ,0 ,0 ,0 ,2 ,0 ,5 ,0 ,5,14565 , 0 
23881.696,17,122 ,6 ,862 ,0 ,0 ,5 ,0 ,0 ,0 ,0 ,5 ,0 ,6 ,0 ,6,18219 , 0 
23881.771,13,122 ,1 ,256 ,0 ,0 ,1 ,0 ,1 ,0 ,0 ,2 ,0 ,4 ,1 ,5,12838 , 0 
23881.786,3,122 ,1 ,256 ,0 ,0 ,2 ,0 ,0 ,0 ,0 ,2 ,0 ,1 ,0 ,1,8980 , 0 
24000.96,8,122 ,1 ,256 ,0 ,0 ,1 ,0 ,0 ,0 ,0 ,1 ,0 ,1 ,0 ,1,10113 , 0 
24001.078,11,122 ,12 ,1052 ,0 ,0 ,2 ,2 ,0 ,0 ,0 ,4 ,0 ,4 ,0 ,4,16448 , 0 
24001.123,2,122 ,1 ,256 ,0 ,0 ,3 ,0 ,2 ,0 ,0 ,5 ,0 ,4 ,2 ,6,18975 , 0 
24001.138,6,122 ,2 ,512 ,0 ,0 ,0 ,1 ,1 ,0 ,0 ,2 ,0 ,3 ,1 ,4,26258 , 0 
24001.214,18,122 ,19 ,513 ,0 ,0 ,2 ,0 ,0 ,1 ,0 ,3 ,0 ,1 ,0 ,1,13361 , 0 
24001.236,4,122 ,19 ,513 ,0 ,0 ,0 ,0 ,0 ,0 ,0 ,0 ,0 ,2 ,0 ,2,11554 , 0 
24001.289,7,122 ,16 ,1054 ,0 ,0 ,1 ,1 ,0 ,0 ,0 ,2 ,0 ,2 ,0 ,2,21409 , 0 
24001.337,14,122 ,1 ,256 ,0 ,0 ,0 ,0 ,0 ,0 ,0 ,0 ,0 ,4 ,0 ,4,11547 , 0 
24001.35,15,122 ,9 ,1094 ,0 ,0 ,0 ,0 ,0 ,0 ,0 ,0 ,0 ,3 ,0 ,3,15067 , 0 
24001.36,20,122 ,12 ,1059 ,0 ,0 ,1 ,1 ,0 ,0 ,0 ,2 ,0 ,2 ,0 ,2,12784 , 0 
24001.36,16,122 ,6 ,798 ,0 ,0 ,2 ,0 ,1 ,0 ,0 ,3 ,0 ,2 ,1 ,3,29764 , 0 
24001.444,10,122 ,14 ,512 ,0 ,0 ,1 ,0 ,0 ,0 ,0 ,1 ,0 ,0 ,0 ,0,13308 , 0 
24001.482,12,122 ,5 ,769 ,0 ,0 ,2 ,0 ,3 ,0 ,0 ,5 ,0 ,2 ,3 ,5,14098 , 0 
24001.596,9,122 ,5 ,798 ,0 ,0 ,2 ,0 ,0 ,0 ,0 ,2 ,0 ,2 ,0 ,2,25016 , 0 
24001.603,5,122 ,13 ,512 ,0 ,0 ,1 ,0 ,3 ,0 ,1 ,5 ,0 ,6 ,4 ,10,22361 , 0 
24001.606,19,122 ,1 ,256 ,0 ,0 ,1 ,0 ,0 ,0 ,0 ,1 ,0 ,4 ,0 ,4,14310 , 0 
24001.696,17,122 ,6 ,862 ,0 ,0 ,1 ,0 ,0 ,0 ,0 ,1 ,0 ,1 ,0 ,1,18072 , 0 
24001.771,13,122 ,1 ,256 ,0 ,0 ,1 ,0 ,3 ,0 ,1 ,5 ,0 ,2 ,4 ,6,12825 , 0 
24001.786,3,122 ,1 ,256 ,0 ,0 ,2 ,0 ,0 ,0 ,0 ,2 ,0 ,0 ,0 ,0,8595 , 0 
24120.96,8,122 ,1 ,256 ,0 ,0 ,2 ,0 ,0 ,0 ,0 ,2 ,0 ,2 ,0 ,2,9804 , 0 
24121.078,11,122 ,12 ,1052 ,0 ,0 ,2 ,0 ,0 ,0 ,0 ,2 ,0 ,3 ,0 ,3,17033 , 0 
24121.123,2,122 ,1 ,256 ,0 ,0 ,1 ,0 ,0 ,0 ,0 ,1 ,0 ,1 ,0 ,1,17729 , 0 
24121.138,6,122 ,2 ,512 ,0 ,0 ,1 ,0 ,0 ,0 ,0 ,1 ,0 ,2 ,0 ,2,23195 , 0 
24121.214,18,122 ,19 ,513 ,0 ,0 ,6 ,1 ,0 ,0 ,0 ,7 ,0 ,3 ,0 ,3,13905 , 0 
24121.236,4,122 ,19 ,513 ,0 ,0 ,1 ,0 ,0 ,0 ,0 ,1 ,0 ,5 ,0 ,5,11917 , 0 
24121.289,7,122 ,16 ,1054 ,0 ,0 ,2 ,0 ,0 ,0 ,0 ,2 ,0 ,2 ,0 ,2,21007 , 0 
24121.337,14,122 ,1 ,256 ,0 ,0 ,2 ,0 ,0 ,0 ,0 ,2 ,0 ,0 ,0 ,0,12184 , 0 
24121.35,15,122 ,9 ,1094 ,0 ,0 ,2 ,0 ,0 ,0 ,0 ,2 ,0 ,1 ,0 ,1,15935 , 0 
24121.36,20,122 ,12 ,1049 ,0 ,0 ,2 ,1 ,0 ,0 ,0 ,3 ,0 ,2 ,0 ,2,13637 , 0 
24121.36,16,122 ,6 ,798 ,0 ,0 ,1 ,0 ,0 ,0 ,0 ,1 ,0 ,0 ,0 ,0,28149 , 0 
24121.444,10,122 ,14 ,512 ,0 ,0 ,2 ,0 ,0 ,0 ,0 ,2 ,0 ,1 ,0 ,1,12803 , 0 
24121.482,12,122 ,5 ,769 ,0 ,0 ,2 ,0 ,1 ,0 ,0 ,3 ,0 ,8 ,1 ,9,14382 , 0 
24121.596,9,122 ,5 ,798 ,0 ,0 ,0 ,0 ,0 ,0 ,0 ,0 ,0 ,5 ,0 ,5,24423 , 0 
24121.603,5,122 ,13 ,512 ,0 ,0 ,1 ,1 ,1 ,1 ,0 ,4 ,0 ,10 ,1 ,11,22860 , 0 
24121.606,19,122 ,1 ,256 ,0 ,0 ,1 ,0 ,1 ,0 ,0 ,2 ,0 ,6 ,1 ,7,14664 , 0 
24121.696,17,122 ,6 ,862 ,0 ,0 ,1 ,0 ,0 ,0 ,0 ,1 ,0 ,1 ,0 ,1,18284 , 0 
24121.771,13,122 ,1 ,256 ,0 ,0 ,1 ,0 ,2 ,1 ,0 ,4 ,0 ,1 ,3 ,4,12922 , 0 
24121.786,3,122 ,1 ,256 ,0 ,0 ,2 ,0 ,0 ,0 ,0 ,2 ,0 ,1 ,0 ,1,9035 , 0 
24240.96,8,122 ,1 ,256 ,0 ,0 ,1 ,0 ,0 ,0 ,0 ,1 ,0 ,1 ,0 ,1,10174 , 0 
24241.078,11,122 ,12 ,1041 ,0 ,0 ,1 ,0 ,0 ,0 ,0 ,1 ,0 ,4 ,0 ,4,16512 , 0 
24241.124,2,122 ,1 ,256 ,0 ,0 ,3 ,0 ,9 ,0 ,1 ,13 ,0 ,5 ,10 ,15,19073 , 0 
24241.138,6,122 ,2 ,512 ,0 ,0 ,4 ,3 ,6 ,0 ,1 ,14 ,0 ,12 ,7 ,19,26440 , 0 
24241.214,18,122 ,19 ,513 ,0 ,0 ,1 ,0 ,0 ,0 ,0 ,1 ,0 ,0 ,0 ,0,13423 , 0 
24241.236,4,122 ,19 ,513 ,0 ,0 ,1 ,0 ,0 ,0 ,0 ,1 ,0 ,0 ,0 ,0,11614 , 0 
24241.29,7,122 ,17 ,1160 ,0 ,0 ,4 ,3 ,0 ,1 ,0 ,8 ,0 ,12 ,0 ,12,21528 , 0 
24241.337,14,122 ,1 ,256 ,0 ,0 ,0 ,0 ,0 ,0 ,0 ,0 ,0 ,5 ,0 ,5,11619 , 0 
24241.35,15,122 ,9 ,1076 ,0 ,0 ,1 ,2 ,0 ,0 ,0 ,3 ,0 ,7 ,0 ,7,15139 , 0 
24241.36,20,122 ,12 ,1049 ,0 ,0 ,0 ,0 ,0 ,0 ,0 ,0 ,0 ,2 ,0 ,2,12847 , 0 
24241.361,16,122 ,6 ,777 ,0 ,0 ,2 ,2 ,0 ,0 ,1 ,5 ,0 ,13 ,1 ,14,29872 , 1 
24241.444,10,122 ,14 ,512 ,0 ,0 ,3 ,0 ,0 ,0 ,0 ,3 ,0 ,3 ,0 ,3,13403 , 0 
24241.482,12,122 ,5 ,769 ,0 ,0 ,1 ,0 ,0 ,0 ,0 ,1 ,0 ,0 ,0 ,0,14158 , 0 
24241.596,9,122 ,5 ,798 ,0 ,0 ,5 ,0 ,2 ,0 ,0 ,7 ,0 ,4 ,2 ,6,25141 , 0 
24241.603,5,122 ,13 ,512 ,0 ,0 ,1 ,0 ,2 ,0 ,0 ,3 ,0 ,6 ,2 ,8,22502 , 0 
24241.606,19,122 ,1 ,256 ,0 ,0 ,2 ,0 ,0 ,0 ,0 ,2 ,0 ,3 ,0 ,3,14414 , 0 
24241.697,17,122 ,6 ,777 ,0 ,0 ,9 ,1 ,3 ,0 ,0 ,13 ,0 ,7 ,3 ,10,18256 , 0 
24241.771,13,122 ,1 ,256 ,0 ,0 ,1 ,0 ,2 ,0 ,0 ,3 ,0 ,4 ,2 ,6,12923 , 0 
24241.786,3,122 ,1 ,256 ,0 ,0 ,1 ,0 ,0 ,0 ,0 ,1 ,0 ,1 ,0 ,1,8665 , 0 
24360.96,8,122 ,1 ,256 ,0 ,0 ,0 ,0 ,0 ,0 ,0 ,0 ,0 ,0 ,0 ,0,9864 , 0 
24361.078,11,122 ,12 ,1041 ,0 ,0 ,1 ,0 ,0 ,0 ,0 ,1 ,0 ,5 ,0 ,5,17123 , 0 
24361.124,2,122 ,1 ,256 ,0 ,0 ,6 ,0 ,11 ,0 ,0 ,17 ,0 ,3 ,11 ,14,17845 , 0 
24361.138,6,122 ,2 ,512 ,0 ,0 ,3 ,4 ,7 ,0 ,0 ,14 ,0 ,7 ,8 ,15,23352 , 0 
24361.214,18,122 ,19 ,513 ,0 ,0 ,2 ,0 ,0 ,0 ,0 ,2 ,0 ,1 ,0 ,1,13976 , 0 
24361.236,4,122 ,19 ,513 ,0 ,0 ,2 ,0 ,0 ,0 ,0 ,2 ,0 ,0 ,0 ,0,11980 , 0 
24361.289,7,122 ,17 ,1154 ,0 ,0 ,3 ,2 ,0 ,0 ,0 ,5 ,0 ,4 ,0 ,4,21081 , 0 
24361.337,14,122 ,1 ,256 ,0 ,0 ,1 ,0 ,0 ,0 ,0 ,1 ,0 ,5 ,0 ,5,12241 , 0 
24361.35,15,122 ,9 ,1073 ,0 ,0 ,1 ,0 ,0 ,0 ,0 ,1 ,0 ,2 ,0 ,2,16005 , 0 
24361.36,20,122 ,12 ,1049 ,0 ,0 ,1 ,0 ,0 ,0 ,0 ,1 ,0 ,0 ,0 ,0,13708 , 0 
24361.361,16,122 ,6 ,782 ,0 ,0 ,1 ,3 ,0 ,1 ,0 ,5 ,0 ,10 ,0 ,10,28249 , 1 
24361.444,10,122 ,14 ,512 ,0 ,0 ,1 ,0 ,0 ,0 ,0 ,1 ,0 ,2 ,0 ,2,12862 , 0 
24361.482,12,122 ,5 ,769 ,0 ,0 ,0 ,0 ,0 ,0 ,0 ,0 ,0 ,2 ,0 ,2,14448 , 0 
24361.596,9,122 ,5 ,798 ,0 ,0 ,3 ,0 ,0 ,0 ,0 ,3 ,0 ,2 ,0 ,2,24514 , 0 
24361.602,5,122 ,13 ,512 ,0 ,0 ,1 ,0 ,0 ,0 ,0 ,1 ,0 ,7 ,0 ,7,22957 , 0 
24361.606,19,122 ,1 ,256 ,0 ,0 ,1 ,0 ,0 ,0 ,0 ,1 ,0 ,6 ,0 ,6,14748 , 0 
24361.696,17,122 ,6 ,782 ,0 ,0 ,3 ,2 ,2 ,0 ,0 ,7 ,0 ,3 ,2 ,5,18385 , 0 
24361.771,13,122 ,1 ,256 ,0 ,0 ,1 ,0 ,0 ,0 ,0 ,1 ,0 ,4 ,0 ,4,12987 , 0 
24361.786,3,122 ,1 ,256 ,0 ,0 ,0 ,0 ,0 ,0 ,0 ,0 ,0 ,0 ,0 ,0,9103 , 0 
24480.96,8,122 ,1 ,256 ,0 ,0 ,2 ,0 ,0 ,0 ,0 ,2 ,0 ,1 ,0 ,1,10275 , 0 
24481.078,11,122 ,12 ,1041 ,0 ,0 ,1 ,0 ,0 ,0 ,0 ,1 ,0 ,2 ,0 ,2,16582 , 0 
24481.124,2,122 ,1 ,256 ,0 ,0 ,4 ,0 ,10 ,0 ,1 ,15 ,0 ,5 ,11 ,16,19207 , 0 
24481.138,6,122 ,2 ,525 ,0 ,0 ,4 ,1 ,6 ,0 ,1 ,12 ,0 ,7 ,7 ,14,26602 , 0 
24481.214,18,122 ,19 ,513 ,0 ,0 ,2 ,0 ,0 ,0 ,0 ,2 ,0 ,2 ,0 ,2,13499 , 0 
24481.236,4,122 ,19 ,513 ,0 ,0 ,1 ,0 ,0 ,0 ,0 ,1 ,0 ,3 ,0 ,3,11707 , 0 
24481.289,7,122 ,17 ,1117 ,0 ,0 ,8 ,2 ,0 ,0 ,0 ,10 ,0 ,8 ,0 ,8,21657 , 0 
24481.337,14,122 ,1 ,256 ,0 ,0 ,1 ,0 ,0 ,0 ,0 ,1 ,0 ,4 ,0 ,4,11702 , 0 
24481.35,15,122 ,9 ,1071 ,0 ,0 ,1 ,2 ,0 ,0 ,0 ,3 ,0 ,9 ,0 ,9,15239 , 0 
24481.36,20,122 ,12 ,1049 ,0 ,0 ,1 ,0 ,0 ,0 ,0 ,1 ,0 ,0 ,0 ,0,12916 , 0 
24481.361,16,122 ,2 ,525 ,0 ,0 ,3 ,4 ,0 ,1 ,0 ,8 ,0 ,14 ,0 ,14,30009 , 1 
24481.444,10,122 ,14 ,512 ,0 ,0 ,0 ,0 ,0 ,0 ,0 ,0 ,0 ,2 ,0 ,2,13462 , 0 
24481.482,12,122 ,5 ,769 ,0 ,0 ,1 ,0 ,0 ,0 ,0 ,1 ,0 ,1 ,0 ,1,14268 , 0 
24481.606,19,122 ,1 ,256 ,0 ,0 ,1 ,0 ,0 ,0 ,0 ,1 ,0 ,6 ,0 ,6,14511 , 0 
24481.613,5,122 ,13 ,512 ,0 ,0 ,1 ,0 ,2 ,0 ,0 ,3 ,0 ,8 ,2 ,10,22619 , 0 
24481.697,17,122 ,6 ,812 ,0 ,0 ,5 ,3 ,2 ,0 ,0 ,10 ,0 ,13 ,2 ,15,18389 , 0 
24481.713,9,122 ,5 ,798 ,0 ,0 ,4 ,0 ,2 ,0 ,0 ,6 ,0 ,9 ,2 ,11,25248 , 0 
24481.771,13,122 ,1 ,256 ,0 ,0 ,1 ,0 ,2 ,0 ,0 ,3 ,0 ,4 ,2 ,6,13007 , 0 
24481.786,3,122 ,1 ,256 ,0 ,0 ,2 ,0 ,0 ,0 ,0 ,2 ,0 ,0 ,0 ,0,8739 , 0 
24600.96,8,122 ,1 ,256 ,0 ,0 ,1 ,0 ,0 ,0 ,0 ,1 ,0 ,1 ,0 ,1,9934 , 0 
24601.078,11,122 ,12 ,1037 ,0 ,0 ,1 ,0 ,0 ,0 ,0 ,1 ,0 ,6 ,0 ,6,17199 , 0 
24601.124,2,122 ,1 ,256 ,0 ,0 ,5 ,0 ,16 ,0 ,1 ,22 ,0 ,7 ,19 ,26,18025 , 0 
24601.138,6,122 ,2 ,522 ,0 ,0 ,5 ,5 ,4 ,2 ,1 ,17 ,0 ,11 ,6 ,17,23569 , 0 
24601.214,18,122 ,19 ,513 ,0 ,0 ,1 ,0 ,0 ,0 ,0 ,1 ,0 ,1 ,0 ,1,14076 , 0 
24601.236,4,122 ,19 ,513 ,0 ,0 ,0 ,0 ,0 ,0 ,0 ,0 ,0 ,0 ,0 ,0,12033 , 0 
24601.289,7,122 ,16 ,889 ,0 ,0 ,5 ,3 ,0 ,1 ,0 ,9 ,0 ,12 ,0 ,12,21222 , 0 
24601.337,14,122 ,1 ,256 ,0 ,0 ,2 ,0 ,0 ,0 ,0 ,2 ,0 ,5 ,0 ,5,12317 , 0 
24601.35,15,122 ,9 ,1081 ,0 ,0 ,0 ,3 ,0 ,0 ,0 ,3 ,0 ,9 ,0 ,9,16090 , 0 
24601.36,20,122 ,12 ,1049 ,0 ,0 ,1 ,0 ,0 ,0 ,0 ,1 ,0 ,0 ,0 ,0,13771 , 0 
24601.361,16,122 ,2 ,522 ,0 ,0 ,4 ,4 ,3 ,0 ,0 ,11 ,0 ,16 ,3 ,19,28423 , 0 
24601.444,10,122 ,14 ,512 ,0 ,0 ,1 ,0 ,0 ,0 ,0 ,1 ,0 ,4 ,0 ,4,12931 , 0 
24601.482,12,122 ,5 ,769 ,0 ,0 ,1 ,0 ,0 ,0 ,0 ,1 ,0 ,0 ,0 ,0,14507 , 0 
24601.596,9,122 ,5 ,798 ,0 ,0 ,5 ,0 ,3 ,0 ,0 ,8 ,0 ,8 ,3 ,11,24690 , 0 
24601.602,5,122 ,13 ,512 ,0 ,0 ,1 ,0 ,3 ,0 ,0 ,4 ,0 ,6 ,3 ,9,23056 , 0 
24601.606,19,122 ,1 ,256 ,0 ,0 ,1 ,0 ,0 ,0 ,0 ,1 ,0 ,4 ,0 ,4,14824 , 0 
24601.697,17,122 ,6 ,842 ,0 ,0 ,4 ,4 ,0 ,1 ,1 ,10 ,0 ,9 ,1 ,10,18525 , 0 
24601.771,13,122 ,1 ,256 ,0 ,0 ,1 ,0 ,3 ,0 ,0 ,4 ,0 ,5 ,3 ,8,13111 , 0 
24601.786,3,122 ,1 ,256 ,0 ,0 ,1 ,0 ,0 ,0 ,0 ,1 ,0 ,2 ,0 ,2,9163 , 0 
24720.96,8,122 ,1 ,256 ,0 ,0 ,1 ,0 ,0 ,0 ,0 ,1 ,0 ,1 ,0 ,1,10336 , 0 
24721.078,11,122 ,12 ,1037 ,0 ,0 ,2 ,0 ,0 ,0 ,0 ,2 ,0 ,2 ,0 ,2,16672 , 0 
24721.123,2,122 ,1 ,256 ,0 ,0 ,2 ,0 ,5 ,0 ,0 ,7 ,0 ,2 ,5 ,7,19294 , 0 
24721.138,6,122 ,2 ,517 ,0 ,0 ,3 ,1 ,2 ,0 ,0 ,6 ,0 ,4 ,2 ,6,26704 , 0 
24721.214,18,122 ,19 ,513 ,0 ,0 ,1 ,0 ,0 ,0 ,0 ,1 ,0 ,0 ,0 ,0,13566 , 0 
24721.236,4,122 ,19 ,513 ,0 ,0 ,1 ,0 ,0 ,0 ,0 ,1 ,0 ,2 ,0 ,2,11772 , 0 
24721.289,7,122 ,16 ,824 ,0 ,0 ,3 ,1 ,0 ,0 ,0 ,4 ,0 ,6 ,0 ,6,21734 , 0 
24721.337,14,122 ,1 ,256 ,0 ,0 ,1 ,0 ,0 ,0 ,0 ,1 ,0 ,5 ,0 ,5,11782 , 0 
24721.35,15,122 ,9 ,1081 ,0 ,0 ,1 ,1 ,0 ,0 ,0 ,2 ,0 ,4 ,0 ,4,15316 , 0 
24721.36,20,122 ,12 ,1037 ,0 ,0 ,2 ,0 ,0 ,0 ,0 ,2 ,0 ,3 ,0 ,3,13002 , 0 
24721.36,16,122 ,2 ,517 ,0 ,0 ,2 ,1 ,1 ,0 ,0 ,4 ,0 ,9 ,1 ,10,30109 , 0 
24721.444,10,122 ,14 ,512 ,0 ,0 ,2 ,0 ,0 ,0 ,0 ,2 ,0 ,2 ,0 ,2,13533 , 0 
24721.482,12,122 ,5 ,769 ,0 ,0 ,1 ,0 ,0 ,0 ,0 ,1 ,0 ,2 ,0 ,2,14345 , 0 
24721.596,9,122 ,5 ,798 ,0 ,0 ,2 ,0 ,1 ,0 ,0 ,3 ,0 ,4 ,1 ,5,25338 , 0 
24721.603,5,122 ,13 ,512 ,0 ,0 ,0 ,0 ,1 ,0 ,0 ,1 ,0 ,5 ,1 ,6,22702 , 0 
24721.606,19,122 ,1 ,256 ,0 ,0 ,1 ,0 ,0 ,0 ,0 ,1 ,0 ,1 ,0 ,1,14605 , 0 
24721.771,13,122 ,1 ,256 ,0 ,0 ,1 ,0 ,1 ,0 ,0 ,2 ,0 ,1 ,1 ,2,13066 , 0 
24721.786,3,122 ,1 ,256 ,0 ,0 ,1 ,0 ,0 ,0 ,0 ,1 ,0 ,0 ,0 ,0,8808 , 0 
24721.83,17,122 ,6 ,805 ,0 ,0 ,2 ,2 ,0 ,0 ,0 ,4 ,0 ,6 ,0 ,6,18485 , 0 
24840.96,8,122 ,1 ,256 ,0 ,0 ,2 ,0 ,0 ,0 ,0 ,2 ,0 ,1 ,0 ,1,10003 , 0 
24841.078,11,122 ,12 ,1034 ,0 ,0 ,1 ,0 ,0 ,0 ,0 ,1 ,0 ,5 ,0 ,5,17272 , 0 
24841.123,2,122 ,1 ,256 ,0 ,0 ,2 ,0 ,0 ,0 ,0 ,2 ,0 ,1 ,0 ,1,18128 , 0 
24841.138,6,122 ,2 ,517 ,0 ,0 ,0 ,0 ,0 ,0 ,0 ,0 ,0 ,2 ,0 ,2,23648 , 0 
24841.214,18,122 ,19 ,513 ,0 ,0 ,2 ,0 ,0 ,0 ,0 ,2 ,0 ,3 ,0 ,3,14181 , 0 
24841.236,4,122 ,19 ,513 ,0 ,0 ,2 ,0 ,0 ,0 ,0 ,2 ,0 ,0 ,0 ,0,12106 , 0 
24841.289,7,122 ,16 ,824 ,0 ,0 ,1 ,0 ,0 ,0 ,0 ,1 ,0 ,0 ,0 ,0,21295 , 0 
24841.337,14,122 ,1 ,256 ,0 ,0 ,1 ,0 ,0 ,0 ,0 ,1 ,0 ,1 ,0 ,1,12418 , 0 
24841.35,15,122 ,9 ,1081 ,0 ,0 ,1 ,0 ,0 ,0 ,0 ,1 ,0 ,0 ,0 ,0,16156 , 0 
24841.36,20,122 ,12 ,1034 ,0 ,0 ,1 ,0 ,0 ,0 ,0 ,1 ,0 ,1 ,0 ,1,13835 , 0 
24841.36,16,122 ,2 ,517 ,0 ,0 ,1 ,0 ,0 ,0 ,0 ,1 ,0 ,2 ,0 ,2,28508 , 0 
24841.444,10,122 ,14 ,512 ,0 ,0 ,2 ,0 ,0 ,0 ,0 ,2 ,0 ,0 ,0 ,0,12994 , 0 
24841.482,12,122 ,5 ,769 ,0 ,0 ,2 ,0 ,0 ,0 ,0 ,2 ,0 ,1 ,0 ,1,14625 , 0 
24841.596,9,122 ,5 ,798 ,0 ,0 ,2 ,0 ,0 ,0 ,0 ,2 ,0 ,2 ,0 ,2,24764 , 0 
24841.603,5,122 ,13 ,523 ,0 ,0 ,2 ,0 ,0 ,0 ,0 ,2 ,0 ,5 ,0 ,5,23176 , 0 
24841.625,19,122 ,1 ,256 ,0 ,0 ,1 ,0 ,0 ,0 ,0 ,1 ,0 ,4 ,0 ,4,14915 , 0 
24841.696,17,122 ,6 ,805 ,0 ,0 ,1 ,0 ,0 ,0 ,0 ,1 ,0 ,0 ,0 ,0,18601 , 0 
24841.771,13,122 ,1 ,256 ,0 ,0 ,1 ,0 ,0 ,0 ,0 ,1 ,0 ,1 ,0 ,1,13221 , 0 
24841.786,3,122 ,1 ,256 ,0 ,0 ,1 ,0 ,0 ,0 ,0 ,1 ,0 ,1 ,0 ,1,9223 , 0 
24960.96,8,122 ,1 ,256 ,0 ,0 ,1 ,0 ,0 ,0 ,0 ,1 ,0 ,2 ,0 ,2,10405 , 0 
24961.078,11,122 ,12 ,1034 ,0 ,0 ,1 ,0 ,0 ,0 ,0 ,1 ,0 ,0 ,0 ,0,16732 , 0 
24961.123,2,122 ,1 ,256 ,0 ,0 ,2 ,0 ,3 ,0 ,1 ,6 ,0 ,3 ,4 ,7,19400 , 0 
24961.138,6,122 ,2 ,512 ,0 ,0 ,2 ,1 ,2 ,0 ,0 ,5 ,0 ,3 ,2 ,5,26796 , 0 
24961.214,18,122 ,19 ,513 ,0 ,0 ,2 ,0 ,0 ,0 ,0 ,2 ,0 ,1 ,0 ,1,13645 , 0 
24961.236,4,122 ,19 ,513 ,0 ,0 ,2 ,0 ,0 ,0 ,0 ,2 ,0 ,1 ,0 ,1,11837 , 0 
24961.289,7,122 ,17 ,1070 ,0 ,0 ,3 ,1 ,0 ,1 ,0 ,5 ,0 ,4 ,0 ,4,21831 , 0 
24961.337,14,122 ,1 ,256 ,0 ,0 ,1 ,0 ,0 ,0 ,0 ,1 ,0 ,3 ,0 ,3,11851 , 0 
24961.35,15,122 ,9 ,1081 ,0 ,0 ,2 ,0 ,0 ,0 ,0 ,2 ,0 ,1 ,0 ,1,15387 , 0 
24961.36,20,122 ,12 ,1034 ,0 ,0 ,0 ,1 ,0 ,0 ,0 ,1 ,0 ,2 ,0 ,2,13057 , 0 
24961.36,16,122 ,2 ,517 ,0 ,0 ,2 ,0 ,0 ,0 ,1 ,3 ,0 ,4 ,1 ,5,30228 , 1 
24961.444,10,122 ,14 ,512 ,0 ,0 ,0 ,0 ,0 ,0 ,0 ,0 ,0 ,2 ,0 ,2,13594 , 0 
24961.482,12,122 ,5 ,769 ,0 ,0 ,1 ,0 ,1 ,0 ,0 ,2 ,0 ,1 ,1 ,2,14412 , 0 
24961.596,9,122 ,5 ,798 ,0 ,0 ,0 ,0 ,0 ,0 ,0 ,0 ,0 ,5 ,0 ,5,25427 , 0 
24961.602,5,122 ,13 ,523 ,0 ,0 ,1 ,0 ,1 ,0 ,0 ,2 ,0 ,2 ,1 ,3,22801 , 0 
24961.606,19,122 ,1 ,256 ,0 ,0 ,1 ,0 ,0 ,0 ,0 ,1 ,0 ,6 ,0 ,6,14686 , 0 
24961.696,17,122 ,6 ,793 ,0 ,0 ,2 ,1 ,1 ,0 ,0 ,4 ,0 ,5 ,1 ,6,18564 , 0 
24961.771,13,122 ,1 ,256 ,0 ,0 ,2 ,0 ,1 ,0 ,0 ,3 ,0 ,1 ,1 ,2,13148 , 0 
24961.786,3,122 ,1 ,256 ,0 ,0 ,1 ,0 ,0 ,0 ,0 ,1 ,0 ,1 ,0 ,1,8863 , 0 
25080.96,8,122 ,1 ,256 ,0 ,0 ,1 ,0 ,0 ,0 ,0 ,1 ,0 ,0 ,0 ,0,10058 , 0 
25081.078,11,122 ,12 ,1034 ,0 ,0 ,1 ,0 ,0 ,0 ,0 ,1 ,0 ,4 ,0 ,4,17352 , 0 
25081.123,2,122 ,1 ,256 ,0 ,0 ,1 ,0 ,2 ,0 ,0 ,3 ,0 ,0 ,3 ,3,18218 , 0 
25081.138,6,122 ,2 ,512 ,0 ,0 ,1 ,0 ,2 ,0 ,0 ,3 ,0 ,0 ,2 ,2,23729 , 0 
25081.214,18,122 ,19 ,513 ,0 ,0 ,1 ,0 ,0 ,0 ,0 ,1 ,0 ,1 ,0 ,1,14248 , 0 
25081.236,4,122 ,19 ,512 ,0 ,0 ,0 ,1 ,0 ,0 ,0 ,1 ,0 ,1 ,0 ,1,12173 , 0 
25081.289,7,122 ,17 ,1055 ,0 ,0 ,6 ,1 ,0 ,0 ,0 ,7 ,0 ,3 ,0 ,3,21414 , 0 
25081.337,14,122 ,1 ,256 ,0 ,0 ,0 ,0 ,0 ,0 ,0 ,0 ,0 ,1 ,0 ,1,12480 , 0 
25081.35,15,122 ,9 ,1070 ,0 ,0 ,2 ,1 ,0 ,0 ,0 ,3 ,0 ,7 ,0 ,7,16238 , 0 
25081.36,20,122 ,12 ,1034 ,0 ,0 ,1 ,0 ,0 ,0 ,0 ,1 ,0 ,1 ,0 ,1,13924 , 0 
25081.36,16,122 ,2 ,517 ,0 ,0 ,1 ,0 ,0 ,1 ,0 ,2 ,0 ,5 ,0 ,5,28594 , 1 
25081.444,10,122 ,14 ,512 ,0 ,0 ,1 ,0 ,0 ,0 ,0 ,1 ,0 ,0 ,0 ,0,13054 , 0 
25081.482,12,122 ,5 ,769 ,0 ,0 ,1 ,0 ,0 ,0 ,0 ,1 ,0 ,1 ,0 ,1,14701 , 0 
25081.596,9,122 ,5 ,798 ,0 ,0 ,3 ,0 ,1 ,0 ,0 ,4 ,0 ,5 ,1 ,6,24877 , 0 
25081.603,5,122 ,13 ,518 ,0 ,0 ,1 ,0 ,1 ,0 ,0 ,2 ,0 ,3 ,1 ,4,23261 , 0 
25081.606,19,122 ,1 ,256 ,0 ,0 ,1 ,0 ,1 ,0 ,0 ,2 ,0 ,0 ,1 ,1,15018 , 0 
25081.696,17,122 ,6 ,783 ,0 ,0 ,1 ,1 ,1 ,0 ,0 ,3 ,0 ,6 ,1 ,7,18697 , 0 
25081.771,13,122 ,1 ,256 ,0 ,0 ,1 ,0 ,1 ,0 ,0 ,2 ,0 ,1 ,1 ,2,13299 , 0 
25081.786,3,122 ,1 ,256 ,0 ,0 ,1 ,0 ,0 ,0 ,0 ,1 ,0 ,0 ,0 ,0,9273 , 0 
25200.96,8,122 ,1 ,256 ,0 ,0 ,1 ,0 ,0 ,0 ,0 ,1 ,0 ,3 ,0 ,3,10480 , 0 
25201.078,11,122 ,12 ,1030 ,0 ,0 ,1 ,1 ,0 ,0 ,0 ,2 ,0 ,3 ,0 ,3,16812 , 0 
25201.123,2,122 ,1 ,256 ,0 ,0 ,1 ,0 ,0 ,0 ,0 ,1 ,0 ,2 ,0 ,2,19488 , 0 
25201.138,6,122 ,2 ,512 ,0 ,0 ,1 ,0 ,0 ,0 ,0 ,1 ,0 ,1 ,0 ,1,26874 , 0 
25201.214,18,122 ,19 ,513 ,0 ,0 ,1 ,0 ,0 ,0 ,0 ,1 ,0 ,0 ,0 ,0,13709 , 0 
25201.236,4,122 ,19 ,512 ,0 ,0 ,2 ,0 ,0 ,0 ,0 ,2 ,0 ,1 ,0 ,1,11919 , 0 
25201.289,7,122 ,17 ,1055 ,0 ,0 ,1 ,0 ,0 ,0 ,0 ,1 ,0 ,1 ,0 ,1,21900 , 0 
25201.337,14,122 ,1 ,256 ,0 ,0 ,2 ,0 ,0 ,0 ,0 ,2 ,0 ,1 ,0 ,1,11920 , 0 
25201.35,15,122 ,9 ,1070 ,0 ,0 ,1 ,0 ,0 ,0 ,0 ,1 ,0 ,2 ,0 ,2,15442 , 0 
25201.36,20,122 ,12 ,1034 ,0 ,0 ,2 ,0 ,0 ,0 ,0 ,2 ,0 ,0 ,0 ,0,13114 , 0 
25201.36,16,122 ,2 ,517 ,0 ,0 ,1 ,0 ,0 ,0 ,0 ,1 ,0 ,2 ,0 ,2,30297 , 1 
25201.444,10,122 ,14 ,512 ,0 ,0 ,1 ,0 ,0 ,0 ,0 ,1 ,0 ,0 ,0 ,0,13648 , 0 
25201.482,12,122 ,5 ,769 ,0 ,0 ,2 ,0 ,1 ,0 ,0 ,3 ,0 ,0 ,1 ,1,14498 , 0 
25201.596,9,122 ,5 ,798 ,0 ,0 ,0 ,0 ,0 ,0 ,0 ,0 ,0 ,2 ,0 ,2,25501 , 0 
25201.603,5,122 ,13 ,518 ,0 ,0 ,2 ,0 ,1 ,0 ,0 ,3 ,0 ,4 ,1 ,5,22930 , 0 
25201.606,19,122 ,1 ,256 ,0 ,0 ,2 ,0 ,0 ,0 ,0 ,2 ,0 ,2 ,0 ,2,14775 , 0 
25201.696,17,122 ,6 ,783 ,0 ,0 ,0 ,0 ,0 ,0 ,0 ,0 ,0 ,1 ,0 ,1,18625 , 0 
25201.771,13,122 ,1 ,256 ,0 ,0 ,0 ,0 ,1 ,0 ,0 ,1 ,0 ,1 ,1 ,2,13211 , 0 
25201.786,3,122 ,1 ,256 ,0 ,0 ,2 ,0 ,0 ,0 ,0 ,2 ,0 ,1 ,0 ,1,8931 , 0 
25320.96,8,122 ,1 ,256 ,0 ,0 ,1 ,0 ,0 ,0 ,0 ,1 ,0 ,1 ,0 ,1,10142 , 0 
25321.078,11,122 ,12 ,1030 ,0 ,0 ,1 ,0 ,0 ,0 ,0 ,1 ,0 ,2 ,0 ,2,17418 , 0 
25321.123,2,122 ,1 ,256 ,0 ,0 ,2 ,0 ,2 ,0 ,0 ,4 ,0 ,1 ,2 ,3,18314 , 0 
25321.138,6,122 ,2 ,512 ,0 ,0 ,0 ,1 ,0 ,0 ,0 ,1 ,0 ,2 ,0 ,2,23793 , 0 
25321.214,18,122 ,19 ,513 ,0 ,0 ,1 ,0 ,0 ,0 ,0 ,1 ,0 ,3 ,0 ,3,14333 , 0 
25321.236,4,122 ,19 ,512 ,0 ,0 ,1 ,0 ,0 ,0 ,0 ,1 ,0 ,1 ,0 ,1,12244 , 0 
25321.289,7,122 ,17 ,1049 ,0 ,0 ,1 ,0 ,0 ,0 ,0 ,1 ,0 ,2 ,0 ,2,21472 , 0 
25321.337,14,122 ,1 ,256 ,0 ,0 ,2 ,0 ,0 ,0 ,0 ,2 ,0 ,5 ,0 ,5,12617 , 0 
25321.35,15,122 ,9 ,1070 ,0 ,0 ,1 ,0 ,0 ,0 ,0 ,1 ,0 ,0 ,0 ,0,16328 , 0 
25321.36,20,122 ,12 ,1034 ,0 ,0 ,1 ,0 ,0 ,0 ,0 ,1 ,0 ,1 ,0 ,1,13978 , 0 
25321.36,16,122 ,2 ,512 ,0 ,0 ,0 ,1 ,0 ,0 ,0 ,1 ,0 ,4 ,0 ,4,28670 , 0 
25321.444,10,122 ,14 ,512 ,0 ,0 ,1 ,0 ,0 ,0 ,0 ,1 ,0 ,1 ,0 ,1,13112 , 0 
25321.482,12,122 ,5 ,769 ,0 ,0 ,1 ,0 ,0 ,0 ,0 ,1 ,0 ,1 ,0 ,1,14766 , 0 
25321.596,9,122 ,5 ,798 ,0 ,0 ,2 ,0 ,0 ,0 ,0 ,2 ,0 ,1 ,0 ,1,24959 , 0 
25321.602,5,122 ,13 ,518 ,0 ,0 ,1 ,0 ,0 ,0 ,0 ,1 ,0 ,2 ,0 ,2,23342 , 0 
25321.606,19,122 ,1 ,256 ,0 ,0 ,1 ,0 ,0 ,0 ,0 ,1 ,0 ,1 ,0 ,1,15113 , 0 
25321.696,17,122 ,6 ,783 ,0 ,0 ,3 ,0 ,0 ,0 ,0 ,3 ,0 ,0 ,0 ,0,18760 , 0 
25321.771,13,122 ,1 ,256 ,0 ,0 ,1 ,0 ,0 ,0 ,0 ,1 ,0 ,2 ,0 ,2,13373 , 0 
25321.786,3,122 ,1 ,256 ,0 ,0 ,2 ,0 ,0 ,0 ,0 ,2 ,0 ,1 ,0 ,1,9340 , 0 
25440.96,8,122 ,1 ,256 ,0 ,0 ,2 ,0 ,0 ,0 ,0 ,2 ,0 ,2 ,0 ,2,10541 , 0 
25441.078,11,122 ,12 ,1030 ,0 ,0 ,1 ,0 ,0 ,0 ,0 ,1 ,0 ,4 ,0 ,4,16880 , 0 
25441.123,2,122 ,1 ,256 ,0 ,0 ,1 ,0 ,4 ,0 ,1 ,6 ,0 ,2 ,6 ,8,19585 , 0 
25441.138,6,122 ,2 ,512 ,0 ,0 ,3 ,0 ,2 ,1 ,1 ,7 ,0 ,2 ,4 ,6,26999 , 0 
25441.214,18,122 ,19 ,513 ,0 ,0 ,1 ,0 ,0 ,0 ,0 ,1 ,0 ,0 ,0 ,0,13776 , 0 
25441.236,4,122 ,19 ,512 ,0 ,0 ,1 ,0 ,0 ,0 ,0 ,1 ,0 ,2 ,0 ,2,11987 , 0 
25441.289,7,122 ,16 ,787 ,0 ,0 ,5 ,2 ,0 ,1 ,0 ,8 ,0 ,3 ,0 ,3,22024 , 0 
25441.337,14,122 ,1 ,256 ,0 ,0 ,1 ,0 ,1 ,0 ,0 ,2 ,0 ,0 ,1 ,1,11999 , 0 
25441.35,15,122 ,9 ,1070 ,0 ,0 ,1 ,0 ,0 ,0 ,0 ,1 ,0 ,5 ,0 ,5,15512 , 0 
25441.36,20,122 ,5 ,774 ,0 ,0 ,4 ,1 ,0 ,1 ,0 ,6 ,0 ,2 ,0 ,2,13227 , 0 
25441.36,16,122 ,2 ,512 ,0 ,0 ,3 ,0 ,2 ,0 ,0 ,5 ,0 ,6 ,2 ,8,30412 , 0 
25441.444,10,122 ,14 ,512 ,0 ,0 ,1 ,1 ,0 ,0 ,0 ,2 ,0 ,3 ,0 ,3,13733 , 0 
25441.482,12,122 ,5 ,769 ,0 ,0 ,1 ,0 ,0 ,1 ,1 ,3 ,0 ,3 ,1 ,4,14604 , 0 
25441.596,9,122 ,5 ,798 ,0 ,0 ,1 ,0 ,0 ,0 ,0 ,1 ,0 ,7 ,0 ,7,25602 , 0 
25441.602,5,122 ,13 ,513 ,0 ,0 ,1 ,0 ,1 ,0 ,1 ,3 ,0 ,4 ,3 ,7,23042 , 0 
25441.606,19,122 ,1 ,256 ,0 ,0 ,1 ,0 ,0 ,0 ,0 ,1 ,0 ,1 ,0 ,1,14870 , 0 
25441.696,17,122 ,6 ,789 ,0 ,0 ,1 ,2 ,0 ,1 ,1 ,5 ,0 ,7 ,1 ,8,18714 , 0 
25441.771,13,122 ,1 ,256 ,0 ,0 ,1 ,0 ,1 ,0 ,1 ,3 ,0 ,2 ,2 ,4,13313 , 0 
25441.786,3,122 ,1 ,256 ,0 ,0 ,1 ,0 ,0 ,0 ,0 ,1 ,0 ,1 ,0 ,1,8985 , 0 
25560.96,8,122 ,1 ,256 ,0 ,0 ,2 ,0 ,0 ,0 ,0 ,2 ,0 ,0 ,0 ,0,10208 , 0 
25561.078,11,122 ,12 ,1025 ,0 ,0 ,1 ,0 ,0 ,0 ,0 ,1 ,0 ,4 ,0 ,4,17482 , 0 
25561.123,2,122 ,1 ,256 ,0 ,0 ,1 ,0 ,0 ,0 ,0 ,1 ,0 ,0 ,0 ,0,18389 , 0 
25561.138,6,122 ,2 ,512 ,0 ,0 ,1 ,0 ,0 ,0 ,0 ,1 ,0 ,1 ,0 ,1,23862 , 0 
25561.214,18,122 ,19 ,513 ,0 ,0 ,0 ,0 ,0 ,0 ,0 ,0 ,0 ,1 ,0 ,1,14395 , 0 
25561.236,4,122 ,19 ,512 ,0 ,0 ,1 ,0 ,0 ,0 ,0 ,1 ,0 ,1 ,0 ,1,12316 , 0 
25561.292,7,122 ,16 ,787 ,0 ,0 ,3 ,0 ,0 ,0 ,0 ,3 ,0 ,1 ,0 ,1,21551 , 0 
25561.337,14,122 ,1 ,256 ,0 ,0 ,2 ,0 ,0 ,0 ,0 ,2 ,0 ,2 ,0 ,2,12683 , 0 
25561.35,15,122 ,9 ,1070 ,0 ,0 ,2 ,0 ,0 ,0 ,0 ,2 ,0 ,2 ,0 ,2,16389 , 0 
25561.36,20,122 ,5 ,774 ,0 ,0 ,2 ,0 ,0 ,0 ,0 ,2 ,0 ,0 ,0 ,0,14049 , 0 
25561.36,16,122 ,2 ,512 ,0 ,0 ,0 ,0 ,0 ,0 ,0 ,0 ,0 ,3 ,0 ,3,28737 , 0 
25561.444,10,122 ,14 ,512 ,0 ,0 ,1 ,0 ,0 ,0 ,0 ,1 ,0 ,0 ,0 ,0,13168 , 0 
25561.482,12,122 ,5 ,769 ,0 ,0 ,2 ,0 ,0 ,0 ,0 ,2 ,0 ,1 ,0 ,1,14826 , 0 
25561.596,9,122 ,5 ,798 ,0 ,0 ,1 ,0 ,0 ,0 ,0 ,1 ,0 ,3 ,0 ,3,25038 , 0 
25561.602,5,122 ,13 ,513 ,0 ,0 ,1 ,0 ,0 ,0 ,0 ,1 ,0 ,4 ,0 ,4,23454 , 0 
25561.606,19,122 ,1 ,256 ,0 ,0 ,1 ,0 ,0 ,0 ,0 ,1 ,0 ,1 ,0 ,1,15191 , 0 
25561.696,17,122 ,6 ,789 ,0 ,0 ,1 ,0 ,0 ,0 ,0 ,1 ,0 ,2 ,0 ,2,18839 , 0 
25561.771,13,122 ,1 ,256 ,0 ,0 ,1 ,0 ,0 ,0 ,0 ,1 ,0 ,1 ,0 ,1,13446 , 0 
25561.786,3,122 ,1 ,256 ,0 ,0 ,1 ,0 ,0 ,0 ,0 ,1 ,0 ,2 ,0 ,2,9400 , 0 
25680.96,8,145 ,1 ,256 ,0 ,0 ,9 ,8 ,2 ,6 ,1 ,26 ,0 ,21 ,4 ,25,10801 , 0 
25681.078,11,144 ,15 ,1318 ,0 ,0 ,12 ,1 ,3 ,2 ,0 ,18 ,0 ,40 ,7 ,47,17214 , 0 
25681.124,2,145 ,1 ,256 ,0 ,0 ,14 ,4 ,2 ,6 ,4 ,30 ,0 ,38 ,7 ,45,19939 , 0 
25681.138,6,148 ,2 ,512 ,0 ,0 ,13 ,3 ,0 ,5 ,1 ,22 ,0 ,31 ,6 ,37,27401 , 0 
25681.214,18,145 ,4 ,768 ,0 ,0 ,12 ,3 ,1 ,4 ,0 ,20 ,0 ,21 ,3 ,24,14113 , 0 
25681.246,4,145 ,19 ,512 ,0 ,0 ,8 ,5 ,0 ,4 ,0 ,17 ,0 ,20 ,0 ,20,12251 , 0 
25681.29,7,149 ,16 ,65535 ,0 ,0 ,14 ,0 ,2 ,1 ,0 ,17 ,0 ,28 ,11 ,39,22284 , 1 
25681.338,14,144 ,1 ,256 ,0 ,0 ,9 ,5 ,5 ,5 ,2 ,26 ,0 ,28 ,10 ,38,12258 , 0 
25681.35,15,148 ,7 ,1056 ,0 ,0 ,11 ,3 ,0 ,4 ,0 ,18 ,0 ,29 ,2 ,31,15893 , 0 
25681.361,20,144 ,11 ,1578 ,0 ,0 ,11 ,1 ,0 ,2 ,0 ,14 ,0 ,24 ,0 ,24,13415 , 0 
25681.361,16,144 ,7 ,65535 ,0 ,0 ,12 ,1 ,0 ,2 ,0 ,15 ,0 ,29 ,2 ,31,30776 , 0 
25681.444,10,144 ,14 ,512 ,0 ,0 ,9 ,3 ,0 ,6 ,0 ,18 ,0 ,16 ,0 ,16,13998 , 0 
25681.482,12,145 ,0 ,0 ,0 ,0 ,11 ,1 ,0 ,2 ,1 ,15 ,0 ,31 ,1 ,32,14839 , 0 
25681.596,9,148 ,7 ,1056 ,0 ,0 ,14 ,2 ,1 ,4 ,1 ,22 ,0 ,37 ,2 ,39,25928 , 0 
25681.619,5,145 ,0 ,0 ,0 ,0 ,14 ,1 ,2 ,4 ,4 ,25 ,0 ,49 ,14 ,63,23439 , 0 
25681.63,19,145 ,1 ,256 ,0 ,0 ,11 ,7 ,3 ,9 ,2 ,32 ,0 ,47 ,6 ,53,15219 , 0 
25681.697,17,148 ,6 ,3364 ,0 ,0 ,12 ,1 ,1 ,3 ,1 ,18 ,0 ,23 ,2 ,25,18939 , 0 
25681.772,13,145 ,1 ,256 ,0 ,0 ,8 ,4 ,1 ,4 ,3 ,20 ,0 ,29 ,5 ,34,13533 , 0 
25681.787,3,145 ,1 ,256 ,0 ,0 ,7 ,6 ,0 ,5 ,0 ,18 ,0 ,18 ,0 ,18,9194 , 0 
25800.961,8,179 ,1 ,256 ,0 ,0 ,16 ,9 ,4 ,8 ,1 ,38 ,0 ,39 ,8 ,47,10544 , 0 
25801.078,11,186 ,5 ,793 ,0 ,0 ,22 ,3 ,1 ,6 ,0 ,32 ,0 ,62 ,3 ,65,17855 , 0 
25801.124,2,179 ,1 ,256 ,0 ,0 ,16 ,5 ,9 ,5 ,5 ,40 ,0 ,59 ,19 ,78,18719 , 0 
25801.138,6,179 ,2 ,512 ,0 ,0 ,17 ,3 ,0 ,5 ,0 ,25 ,0 ,43 ,0 ,43,24235 , 0 
25801.214,18,186 ,19 ,742 ,0 ,0 ,16 ,7 ,6 ,8 ,4 ,41 ,0 ,44 ,13 ,57,14929 , 0 
25801.236,4,179 ,8 ,512 ,0 ,0 ,15 ,9 ,2 ,10 ,1 ,37 ,0 ,35 ,4 ,39,12838 , 0 
25801.29,7,191 ,16 ,65535 ,0 ,0 ,21 ,0 ,0 ,0 ,0 ,21 ,0 ,41 ,0 ,41,21770 , 1 
25801.338,14,179 ,1 ,256 ,0 ,0 ,16 ,11 ,6 ,9 ,2 ,44 ,0 ,44 ,10 ,54,12985 , 0 
25801.35,15,186 ,9 ,1074 ,0 ,0 ,22 ,1 ,0 ,2 ,0 ,25 ,0 ,49 ,0 ,49,16674 , 0 
25801.36,20,186 ,11 ,1560 ,0 ,0 ,19 ,5 ,0 ,6 ,0 ,30 ,0 ,42 ,0 ,42,14477 , 0 
25801.361,16,188 ,2 ,512 ,0 ,0 ,19 ,1 ,0 ,1 ,0 ,21 ,0 ,49 ,0 ,49,29001 , 0 
25801.444,10,179 ,14 ,512 ,0 ,0 ,18 ,5 ,1 ,4 ,0 ,28 ,0 ,26 ,2 ,28,13493 , 0 
25801.482,12,186 ,5 ,804 ,0 ,0 ,19 ,7 ,2 ,10 ,1 ,39 ,0 ,50 ,5 ,55,15334 , 0 
25801.596,9,188 ,5 ,793 ,0 ,0 ,21 ,1 ,1 ,2 ,0 ,25 ,0 ,58 ,3 ,61,25340 , 0 
25801.603,5,186 ,2 ,512 ,0 ,0 ,18 ,5 ,7 ,7 ,4 ,41 ,0 ,83 ,22 ,105,24022 , 0 
25801.607,19,179 ,1 ,256 ,0 ,0 ,17 ,8 ,18 ,8 ,9 ,60 ,0 ,70 ,45 ,115,15616 , 0 
25801.697,17,186 ,6 ,3364 ,0 ,0 ,19 ,0 ,0 ,0 ,0 ,19 ,0 ,38 ,0 ,38,19041 , 0 
25801.772,13,179 ,1 ,256 ,0 ,0 ,15 ,9 ,0 ,6 ,0 ,30 ,0 ,49 ,0 ,49,13734 , 0 
25801.787,3,179 ,1 ,256 ,0 ,0 ,15 ,11 ,0 ,7 ,0 ,33 ,0 ,33 ,0 ,33,9670 , 0 
25921.067,8,235 ,1 ,256 ,0 ,0 ,18 ,14 ,5 ,14 ,2 ,53 ,0 ,47 ,11 ,58,11143 , 0 
25921.081,11,234 ,5 ,793 ,0 ,0 ,22 ,0 ,0 ,0 ,0 ,22 ,0 ,78 ,0 ,78,17459 , 0 
25921.124,2,235 ,0 ,0 ,0 ,0 ,22 ,4 ,4 ,6 ,3 ,39 ,0 ,72 ,12 ,84,20296 , 0 
25921.138,6,234 ,2 ,512 ,0 ,0 ,18 ,0 ,0 ,1 ,0 ,19 ,0 ,59 ,0 ,59,27641 , 0 
25921.221,18,232 ,0 ,0 ,0 ,0 ,20 ,4 ,0 ,5 ,0 ,29 ,0 ,41 ,0 ,41,14400 , 0 
25921.243,4,232 ,0 ,0 ,0 ,0 ,13 ,8 ,0 ,10 ,0 ,31 ,0 ,35 ,0 ,35,12580 , 0 
25921.29,7,237 ,16 ,65535 ,0 ,0 ,23 ,0 ,0 ,0 ,0 ,23 ,0 ,62 ,0 ,62,22514 , 1 
25921.338,14,235 ,1 ,256 ,0 ,0 ,19 ,7 ,4 ,15 ,5 ,50 ,0 ,68 ,15 ,83,12587 , 0 
25921.35,15,234 ,9 ,1074 ,0 ,0 ,23 ,0 ,0 ,0 ,0 ,23 ,0 ,58 ,0 ,58,16119 , 0 
25921.36,20,232 ,11 ,1560 ,0 ,0 ,19 ,0 ,0 ,0 ,0 ,19 ,0 ,43 ,0 ,43,13615 , 0 
25921.361,16,234 ,2 ,512 ,0 ,0 ,19 ,0 ,0 ,0 ,0 ,19 ,0 ,51 ,0 ,51,30989 , 0 
25921.444,10,234 ,14 ,512 ,0 ,0 ,18 ,6 ,0 ,8 ,0 ,32 ,0 ,24 ,0 ,24,14337 , 0 
25921.482,12,232 ,18 ,768 ,0 ,0 ,20 ,0 ,0 ,1 ,0 ,21 ,0 ,41 ,0 ,41,15087 , 0 
25921.596,9,236 ,5 ,793 ,0 ,0 ,22 ,0 ,0 ,0 ,0 ,22 ,0 ,81 ,0 ,81,26175 , 0 
25921.603,5,236 ,19 ,512 ,0 ,0 ,23 ,0 ,0 ,3 ,0 ,26 ,0 ,82 ,0 ,82,23763 , 0 
25921.607,19,235 ,1 ,256 ,0 ,0 ,19 ,6 ,6 ,11 ,3 ,45 ,0 ,75 ,18 ,93,15647 , 0 
25921.703,17,236 ,6 ,3364 ,0 ,0 ,19 ,0 ,0 ,0 ,0 ,19 ,0 ,52 ,0 ,52,19137 , 0 
25921.772,13,234 ,1 ,256 ,0 ,0 ,19 ,7 ,0 ,9 ,0 ,35 ,0 ,62 ,2 ,64,13907 , 0 
25921.787,3,233 ,1 ,256 ,0 ,0 ,20 ,10 ,1 ,14 ,1 ,46 ,0 ,39 ,4 ,43,9485 , 0 
26040.96,8,239 ,1 ,256 ,0 ,0 ,9 ,5 ,3 ,3 ,0 ,20 ,0 ,24 ,4 ,28,10799 , 0 
26041.078,11,239 ,12 ,1068 ,0 ,0 ,15 ,4 ,4 ,5 ,3 ,31 ,0 ,36 ,7 ,43,18392 , 0 
26041.124,2,239 ,1 ,256 ,0 ,0 ,9 ,4 ,16 ,3 ,2 ,34 ,0 ,29 ,21 ,50,19086 , 0 
26041.138,6,239 ,2 ,535 ,0 ,0 ,9 ,3 ,0 ,1 ,0 ,13 ,0 ,20 ,2 ,22,24531 , 0 
26041.214,18,239 ,5 ,812 ,0 ,0 ,13 ,6 ,0 ,3 ,0 ,22 ,0 ,31 ,0 ,31,15247 , 0 
26041.236,4,239 ,8 ,699 ,0 ,0 ,10 ,5 ,0 ,4 ,0 ,19 ,0 ,21 ,1 ,22,13159 , 0 
26041.29,7,239 ,9 ,1310 ,0 ,0 ,14 ,7 ,0 ,4 ,0 ,25 ,0 ,24 ,0 ,24,22319 , 0 
26041.338,14,239 ,1 ,256 ,0 ,0 ,7 ,4 ,3 ,3 ,0 ,17 ,0 ,25 ,4 ,29,13194 , 0 
26041.35,15,239 ,9 ,1310 ,0 ,0 ,14 ,6 ,0 ,2 ,0 ,22 ,0 ,29 ,2 ,31,17055 , 0 
26041.36,20,239 ,5 ,812 ,0 ,0 ,14 ,4 ,0 ,2 ,0 ,20 ,0 ,28 ,0 ,28,14767 , 0 
26041.361,16,239 ,2 ,537 ,0 ,0 ,10 ,2 ,11 ,0 ,3 ,26 ,0 ,24 ,14 ,38,29412 , 0 
26041.444,10,239 ,14 ,512 ,0 ,0 ,7 ,3 ,0 ,2 ,0 ,12 ,0 ,9 ,0 ,9,13661 , 0 
26041.498,12,239 ,5 ,809 ,0 ,0 ,14 ,7 ,4 ,1 ,1 ,27 ,0 ,34 ,8 ,42,15698 , 0 
26041.597,9,239 ,16 ,1054 ,0 ,0 ,12 ,2 ,10 ,2 ,3 ,29 ,0 ,34 ,17 ,51,25868 , 0 
26041.603,5,239 ,13 ,531 ,0 ,0 ,14 ,6 ,18 ,4 ,2 ,44 ,0 ,49 ,22 ,71,24665 , 0 
26041.607,19,239 ,1 ,256 ,0 ,0 ,8 ,4 ,13 ,3 ,6 ,34 ,0 ,37 ,21 ,58,15973 , 0 
26041.697,17,239 ,16 ,1054 ,0 ,0 ,11 ,3 ,3 ,1 ,1 ,19 ,0 ,20 ,4 ,24,19415 , 0 
26041.772,13,239 ,1 ,256 ,0 ,0 ,9 ,5 ,12 ,4 ,1 ,31 ,0 ,22 ,13 ,35,13956 , 0 
26041.787,3,239 ,1 ,256 ,0 ,0 ,9 ,8 ,0 ,3 ,0 ,20 ,0 ,16 ,2 ,18,9834 , 0 
26160.96,8,239 ,1 ,256 ,0 ,0 ,2 ,1 ,0 ,0 ,0 ,3 ,0 ,3 ,0 ,3,11219 , 0 
26161.078,11,239 ,12 ,1136 ,0 ,0 ,2 ,1 ,0 ,1 ,0 ,4 ,0 ,11 ,0 ,11,17557 , 0 
26161.124,2,239 ,1 ,256 ,0 ,0 ,4 ,1 ,9 ,0 ,0 ,14 ,0 ,8 ,11 ,19,20452 , 0 
26161.138,6,239 ,2 ,537 ,0 ,0 ,2 ,2 ,0 ,0 ,0 ,4 ,0 ,7 ,0 ,7,27747 , 0 
26161.214,18,239 ,5 ,773 ,0 ,0 ,4 ,2 ,0 ,0 ,0 ,6 ,0 ,4 ,0 ,4,14499 , 0 
26161.236,4,239 ,8 ,699 ,0 ,0 ,1 ,0 ,0 ,0 ,0 ,1 ,0 ,3 ,0 ,3,12639 , 0 
26161.289,7,239 ,9 ,1310 ,0 ,0 ,3 ,2 ,0 ,0 ,0 ,5 ,0 ,6 ,0 ,6,22604 , 0 
26161.337,14,239 ,1 ,256 ,0 ,0 ,2 ,1 ,1 ,0 ,0 ,4 ,0 ,7 ,1 ,8,12683 , 0 
26161.35,15,239 ,9 ,1310 ,0 ,0 ,2 ,1 ,0 ,0 ,0 ,3 ,0 ,5 ,0 ,5,16198 , 0 
26161.36,20,239 ,5 ,773 ,0 ,0 ,5 ,3 ,0 ,0 ,0 ,8 ,0 ,6 ,0 ,6,13761 , 0 
26161.36,16,239 ,2 ,537 ,0 ,0 ,2 ,2 ,5 ,2 ,0 ,11 ,0 ,6 ,7 ,13,31153 , 0 
26161.444,10,239 ,14 ,537 ,0 ,0 ,2 ,1 ,0 ,0 ,0 ,3 ,0 ,3 ,0 ,3,14411 , 0 
26161.482,12,239 ,5 ,796 ,0 ,0 ,2 ,0 ,1 ,1 ,0 ,4 ,0 ,8 ,2 ,10,15239 , 0 
26161.596,9,239 ,16 ,1054 ,0 ,0 ,2 ,0 ,3 ,1 ,0 ,6 ,0 ,6 ,3 ,9,26305 , 0 
26161.603,5,239 ,13 ,512 ,0 ,0 ,3 ,1 ,6 ,1 ,1 ,12 ,0 ,13 ,8 ,21,23941 , 0 
26161.606,19,239 ,1 ,256 ,0 ,0 ,3 ,1 ,0 ,3 ,0 ,7 ,0 ,9 ,0 ,9,15745 , 0 
26161.696,17,239 ,16 ,853 ,0 ,0 ,2 ,2 ,0 ,1 ,0 ,5 ,0 ,4 ,0 ,4,19228 , 0 
26161.771,13,239 ,1 ,256 ,0 ,0 ,2 ,0 ,7 ,0 ,1 ,10 ,0 ,7 ,9 ,16,14007 , 0 
26161.786,3,239 ,1 ,256 ,0 ,0 ,1 ,1 ,0 ,0 ,0 ,2 ,0 ,3 ,0 ,3,9565 , 0 
26280.96,8,239 ,1 ,256 ,0 ,0 ,2 ,1 ,1 ,0 ,0 ,4 ,0 ,5 ,1 ,6,10873 , 0 
26281.078,11,239 ,12 ,1112 ,0 ,0 ,2 ,1 ,0 ,0 ,0 ,3 ,0 ,7 ,0 ,7,18464 , 0 
26281.124,2,239 ,1 ,256 ,0 ,0 ,1 ,1 ,5 ,0 ,0 ,7 ,0 ,6 ,5 ,11,19162 , 0 
26281.138,6,239 ,2 ,537 ,0 ,0 ,2 ,0 ,0 ,0 ,0 ,2 ,0 ,4 ,0 ,4,24594 , 0 
26281.214,18,239 ,5 ,773 ,0 ,0 ,2 ,0 ,0 ,0 ,0 ,2 ,0 ,4 ,0 ,4,15317 , 0 
26281.236,4,239 ,8 ,620 ,0 ,0 ,2 ,1 ,0 ,0 ,0 ,3 ,0 ,3 ,0 ,3,13252 , 0 
26281.289,7,239 ,9 ,1092 ,0 ,0 ,2 ,2 ,0 ,0 ,0 ,4 ,0 ,7 ,0 ,7,22391 , 0 
26281.337,14,239 ,1 ,256 ,0 ,0 ,2 ,1 ,1 ,0 ,0 ,4 ,0 ,3 ,1 ,4,13265 , 0 
26281.35,15,239 ,9 ,1092 ,0 ,0 ,2 ,1 ,0 ,0 ,0 ,3 ,0 ,4 ,0 ,4,17120 , 0 
26281.36,20,239 ,5 ,773 ,0 ,0 ,1 ,0 ,0 ,0 ,0 ,1 ,0 ,2 ,0 ,2,14821 , 0 
26281.36,16,239 ,2 ,537 ,0 ,0 ,3 ,0 ,5 ,0 ,0 ,8 ,0 ,5 ,5 ,10,29531 , 0 
26281.444,10,239 ,14 ,531 ,0 ,0 ,1 ,1 ,0 ,0 ,0 ,2 ,0 ,2 ,0 ,2,13721 , 0 
26281.482,12,239 ,5 ,796 ,0 ,0 ,3 ,0 ,1 ,0 ,0 ,4 ,0 ,3 ,1 ,4,15779 , 0 
26281.596,9,239 ,16 ,836 ,0 ,0 ,3 ,1 ,3 ,0 ,0 ,7 ,0 ,4 ,3 ,7,25965 , 0 
26281.603,5,239 ,13 ,512 ,0 ,0 ,2 ,0 ,1 ,0 ,0 ,3 ,0 ,8 ,1 ,9,24751 , 0 
26281.606,19,239 ,1 ,256 ,0 ,0 ,2 ,1 ,0 ,0 ,0 ,3 ,0 ,5 ,0 ,5,16066 , 0 
26281.696,17,239 ,16 ,836 ,0 ,0 ,2 ,1 ,0 ,0 ,0 ,3 ,0 ,4 ,0 ,4,19491 , 0 
26281.771,13,239 ,1 ,256 ,0 ,0 ,1 ,1 ,1 ,0 ,0 ,3 ,0 ,4 ,1 ,5,14028 , 0 
26281.786,3,239 ,1 ,256 ,0 ,0 ,2 ,1 ,0 ,0 ,0 ,3 ,0 ,4 ,0 ,4,9897 , 0 
26400.96,8,239 ,1 ,256 ,0 ,0 ,1 ,1 ,0 ,0 ,0 ,2 ,0 ,1 ,0 ,1,11285 , 0 
26401.078,11,239 ,9 ,300 ,0 ,0 ,4 ,2 ,0 ,1 ,0 ,7 ,0 ,3 ,0 ,3,17698 , 0 
26401.123,2,239 ,1 ,256 ,0 ,0 ,0 ,1 ,2 ,0 ,0 ,3 ,0 ,7 ,2 ,9,20543 , 0 
26401.138,6,239 ,2 ,537 ,0 ,0 ,1 ,0 ,0 ,0 ,0 ,1 ,0 ,5 ,0 ,5,27834 , 0 
26401.214,18,239 ,5 ,768 ,0 ,0 ,2 ,1 ,0 ,0 ,0 ,3 ,0 ,2 ,0 ,2,14612 , 0 
26401.236,4,239 ,8 ,620 ,0 ,0 ,1 ,0 ,0 ,0 ,0 ,1 ,0 ,1 ,0 ,1,12768 , 0 
26401.289,7,239 ,9 ,1092 ,0 ,0 ,1 ,0 ,0 ,0 ,0 ,1 ,0 ,3 ,0 ,3,22702 , 0 
26401.337,14,239 ,1 ,256 ,0 ,0 ,2 ,1 ,1 ,0 ,0 ,4 ,0 ,4 ,1 ,5,12793 , 0 
26401.35,15,239 ,9 ,1092 ,0 ,0 ,2 ,0 ,0 ,0 ,0 ,2 ,0 ,2 ,0 ,2,16276 , 0 
26401.36,20,239 ,5 ,768 ,0 ,0 ,2 ,1 ,0 ,0 ,0 ,3 ,0 ,4 ,0 ,4,13843 , 0 
26401.36,16,239 ,2 ,537 ,0 ,0 ,2 ,0 ,2 ,0 ,0 ,4 ,0 ,0 ,2 ,2,31295 , 0 
26401.444,10,239 ,14 ,525 ,0 ,0 ,3 ,1 ,0 ,0 ,0 ,4 ,0 ,1 ,0 ,1,14492 , 0 
26401.482,12,239 ,5 ,768 ,0 ,0 ,0 ,1 ,1 ,0 ,1 ,3 ,0 ,6 ,2 ,8,15319 , 0 
26401.596,9,239 ,16 ,834 ,0 ,0 ,1 ,1 ,0 ,0 ,0 ,2 ,0 ,6 ,1 ,7,26437 , 1 
26401.603,5,239 ,13 ,512 ,0 ,0 ,2 ,0 ,4 ,0 ,1 ,7 ,0 ,6 ,5 ,11,24090 , 0 
26401.606,19,239 ,1 ,256 ,0 ,0 ,1 ,1 ,0 ,0 ,0 ,2 ,0 ,5 ,0 ,5,15843 , 0 
26401.696,17,239 ,16 ,834 ,0 ,0 ,1 ,1 ,0 ,0 ,0 ,2 ,0 ,2 ,0 ,2,19338 , 0 
26401.771,13,239 ,1 ,256 ,0 ,0 ,2 ,1 ,4 ,0 ,1 ,8 ,0 ,2 ,5 ,7,14092 , 0 
26401.786,3,239 ,1 ,256 ,0 ,0 ,1 ,1 ,0 ,0 ,0 ,2 ,0 ,1 ,0 ,1,9630 , 0 
26520.96,8,239 ,1 ,256 ,0 ,0 ,2 ,0 ,2 ,0 ,0 ,4 ,0 ,4 ,2 ,6,10975 , 0 
26521.078,11,239 ,9 ,300 ,0 ,0 ,3 ,13 ,0 ,0 ,0 ,16 ,0 ,21 ,0 ,21,18646 , 0 
26521.124,2,239 ,1 ,256 ,0 ,0 ,3 ,0 ,17 ,1 ,9 ,30 ,0 ,16 ,27 ,43,19341 , 0 
26521.138,6,239 ,2 ,515 ,0 ,0 ,7 ,3 ,0 ,2 ,0 ,12 ,0 ,16 ,0 ,16,24746 , 0 
26521.214,18,239 ,5 ,768 ,0 ,0 ,1 ,0 ,0 ,0 ,0 ,1 ,0 ,4 ,0 ,4,15394 , 0 
26521.236,4,239 ,8 ,575 ,0 ,0 ,2 ,2 ,0 ,0 ,0 ,4 ,0 ,3 ,0 ,3,13333 , 0 
26521.29,7,239 ,15 ,735 ,0 ,0 ,15 ,13 ,4 ,8 ,1 ,41 ,0 ,37 ,18 ,55,22785 , 0 
26521.337,14,239 ,1 ,256 ,0 ,0 ,1 ,0 ,0 ,0 ,0 ,1 ,0 ,5 ,0 ,5,13345 , 0 
26521.35,15,239 ,9 ,300 ,0 ,0 ,9 ,10 ,1 ,4 ,1 ,25 ,0 ,25 ,12 ,37,17451 , 0 
26521.36,20,239 ,5 ,768 ,0 ,0 ,1 ,0 ,0 ,0 ,0 ,1 ,0 ,4 ,0 ,4,14891 , 0 
26521.361,16,239 ,7 ,595 ,0 ,0 ,14 ,14 ,12 ,13 ,3 ,56 ,0 ,33 ,25 ,58,30079 , 0 
26521.444,10,239 ,14 ,525 ,0 ,0 ,1 ,0 ,0 ,0 ,0 ,1 ,0 ,6 ,0 ,6,13776 , 0 
26521.482,12,239 ,5 ,768 ,0 ,0 ,2 ,0 ,0 ,1 ,0 ,3 ,0 ,3 ,0 ,3,15910 , 0 
26521.597,9,239 ,15 ,735 ,0 ,0 ,16 ,7 ,14 ,18 ,2 ,57 ,0 ,34 ,65 ,99,26584 , 1 
26521.603,5,239 ,13 ,512 ,0 ,0 ,1 ,1 ,0 ,1 ,0 ,3 ,0 ,18 ,4 ,22,24920 , 0 
26521.606,19,239 ,1 ,256 ,0 ,0 ,2 ,0 ,0 ,0 ,0 ,2 ,0 ,7 ,0 ,7,16199 , 0 
26521.771,13,239 ,1 ,256 ,0 ,0 ,2 ,0 ,1 ,1 ,0 ,4 ,0 ,3 ,2 ,5,14169 , 0 
26521.786,3,239 ,1 ,256 ,0 ,0 ,2 ,0 ,0 ,0 ,0 ,2 ,0 ,1 ,0 ,1,9975 , 0 
26521.809,17,239 ,7 ,595 ,0 ,0 ,7 ,11 ,0 ,1 ,0 ,19 ,0 ,31 ,2 ,33,19763 , 0 
26640.96,8,239 ,1 ,256 ,0 ,0 ,1 ,0 ,0 ,0 ,0 ,1 ,0 ,0 ,0 ,0,11364 , 0 
26641.078,11,239 ,9 ,300 ,0 ,0 ,8 ,15 ,1 ,4 ,1 ,29 ,0 ,33 ,5 ,38,18058 , 0 
26641.131,2,239 ,1 ,256 ,0 ,0 ,4 ,0 ,18 ,0 ,1 ,23 ,0 ,13 ,20 ,33,20702 , 0 
26641.138,6,239 ,2 ,512 ,0 ,0 ,6 ,3 ,0 ,0 ,0 ,9 ,0 ,18 ,0 ,18,28024 , 0 
26641.214,18,239 ,5 ,768 ,0 ,0 ,2 ,0 ,0 ,0 ,0 ,2 ,0 ,1 ,0 ,1,14679 , 0 
26641.236,4,239 ,8 ,575 ,0 ,0 ,1 ,0 ,0 ,0 ,0 ,1 ,0 ,2 ,0 ,2,12844 , 0 
26641.29,7,239 ,9 ,300 ,0 ,0 ,18 ,15 ,2 ,22 ,3 ,60 ,0 ,39 ,36 ,75,23236 , 0 
26641.337,14,239 ,1 ,256 ,0 ,0 ,1 ,0 ,1 ,0 ,0 ,2 ,0 ,5 ,1 ,6,12860 , 0 
26641.36,20,239 ,5 ,768 ,0 ,0 ,2 ,0 ,0 ,0 ,0 ,2 ,0 ,6 ,1 ,7,13939 , 0 
26641.444,10,239 ,14 ,521 ,0 ,0 ,2 ,1 ,0 ,0 ,0 ,3 ,0 ,6 ,0 ,6,14596 , 0 
26641.482,12,239 ,5 ,768 ,0 ,0 ,1 ,0 ,0 ,0 ,0 ,1 ,0 ,6 ,0 ,6,15401 , 0 
26641.488,15,239 ,9 ,65535 ,0 ,0 ,14 ,15 ,4 ,15 ,3 ,51 ,0 ,36 ,20 ,56,16866 , 0 
26641.49,16,239 ,2 ,512 ,0 ,0 ,11 ,4 ,15 ,6 ,1 ,37 ,0 ,39 ,36 ,75,31797 , 0 
26641.597,9,239 ,15 ,65535 ,0 ,0 ,19 ,13 ,17 ,27 ,4 ,80 ,0 ,38 ,72 ,110,27179 , 1 
26641.603,5,239 ,13 ,512 ,0 ,0 ,0 ,0 ,1 ,1 ,1 ,3 ,0 ,26 ,4 ,30,24241 , 0 
26641.606,19,239 ,1 ,256 ,0 ,0 ,1 ,0 ,0 ,0 ,0 ,1 ,0 ,6 ,0 ,6,15976 , 0 
26641.697,17,239 ,16 ,789 ,0 ,0 ,11 ,9 ,0 ,3 ,0 ,23 ,0 ,29 ,4 ,33,19674 , 0 
26641.771,13,239 ,1 ,256 ,0 ,0 ,1 ,0 ,1 ,1 ,1 ,4 ,0 ,3 ,3 ,6,14196 , 0 
26641.786,3,239 ,1 ,256 ,0 ,0 ,1 ,0 ,0 ,0 ,0 ,1 ,0 ,0 ,0 ,0,9685 , 0 
26760.96,8,239 ,1 ,256 ,0 ,0 ,1 ,0 ,0 ,0 ,0 ,1 ,0 ,1 ,0 ,1,11034 , 0 
26761.078,11,239 ,20 ,1169 ,0 ,0 ,8 ,6 ,0 ,2 ,0 ,16 ,0 ,27 ,0 ,27,18848 , 0 
26761.126,2,239 ,1 ,256 ,0 ,0 ,3 ,0 ,10 ,1 ,1 ,15 ,0 ,13 ,12 ,25,19541 , 0 
26761.138,6,239 ,2 ,534 ,0 ,0 ,2 ,2 ,0 ,0 ,0 ,4 ,0 ,12 ,0 ,12,24887 , 0 
26761.214,18,239 ,19 ,512 ,0 ,0 ,4 ,3 ,3 ,1 ,0 ,11 ,0 ,9 ,5 ,14,15592 , 0 
26761.236,4,239 ,8 ,575 ,0 ,0 ,1 ,0 ,0 ,0 ,0 ,1 ,0 ,3 ,0 ,3,13396 , 0 
26761.29,7,239 ,9 ,1107 ,0 ,0 ,8 ,6 ,2 ,3 ,1 ,20 ,0 ,22 ,8 ,30,23030 , 0 
26761.337,14,239 ,1 ,256 ,0 ,0 ,2 ,0 ,0 ,0 ,0 ,2 ,0 ,2 ,0 ,2,13442 , 0 
26761.35,15,239 ,9 ,1107 ,0 ,0 ,11 ,5 ,0 ,5 ,0 ,21 ,0 ,19 ,1 ,20,17696 , 0 
26761.36,20,239 ,5 ,793 ,0 ,0 ,5 ,4 ,3 ,0 ,0 ,12 ,0 ,15 ,3 ,18,15139 , 0 
26761.361,16,239 ,2 ,512 ,0 ,0 ,6 ,1 ,9 ,1 ,1 ,18 ,0 ,14 ,10 ,24,30444 , 0 
26761.444,10,239 ,14 ,518 ,0 ,0 ,1 ,0 ,0 ,0 ,0 ,1 ,0 ,2 ,0 ,2,13839 , 0 
26761.482,12,239 ,18 ,949 ,0 ,0 ,7 ,5 ,2 ,2 ,1 ,17 ,0 ,14 ,3 ,17,16219 , 0 
26761.596,9,239 ,5 ,793 ,0 ,0 ,9 ,5 ,10 ,3 ,2 ,29 ,0 ,26 ,16 ,42,26985 , 0 
26761.603,5,239 ,13 ,512 ,0 ,0 ,5 ,0 ,21 ,2 ,3 ,31 ,0 ,23 ,25 ,48,25213 , 0 
26761.606,19,239 ,1 ,256 ,0 ,0 ,1 ,0 ,4 ,0 ,0 ,5 ,0 ,8 ,4 ,12,16287 , 0 
26761.697,17,239 ,16 ,997 ,0 ,0 ,4 ,4 ,0 ,0 ,0 ,8 ,0 ,13 ,1 ,14,19932 , 0 
26761.772,13,239 ,1 ,256 ,0 ,0 ,0 ,0 ,21 ,2 ,3 ,26 ,0 ,6 ,26 ,32,14281 , 0 
26761.787,3,239 ,1 ,256 ,0 ,0 ,3 ,0 ,0 ,0 ,0 ,3 ,0 ,3 ,0 ,3,10040 , 0 
26880.96,8,239 ,1 ,256 ,0 ,0 ,0 ,0 ,0 ,0 ,0 ,0 ,0 ,3 ,0 ,3,11446 , 0 
26881.078,11,239 ,20 ,1226 ,0 ,0 ,2 ,2 ,0 ,0 ,0 ,4 ,0 ,11 ,0 ,11,18158 , 0 
26881.123,2,239 ,1 ,256 ,0 ,0 ,1 ,0 ,3 ,0 ,0 ,4 ,0 ,3 ,3 ,6,20786 , 0 
26881.138,6,239 ,2 ,525 ,0 ,0 ,1 ,0 ,0 ,0 ,0 ,1 ,0 ,4 ,0 ,4,28097 , 0 
26881.214,18,239 ,19 ,512 ,0 ,0 ,4 ,0 ,2 ,0 ,0 ,6 ,0 ,5 ,2 ,7,14801 , 0 
26881.236,4,239 ,8 ,575 ,0 ,0 ,1 ,0 ,0 ,0 ,0 ,1 ,0 ,2 ,0 ,2,12926 , 0 
26881.289,7,239 ,9 ,1107 ,0 ,0 ,1 ,0 ,0 ,1 ,0 ,2 ,0 ,6 ,0 ,6,23309 , 0 
26881.337,14,239 ,1 ,256 ,0 ,0 ,1 ,0 ,0 ,0 ,0 ,1 ,0 ,4 ,0 ,4,12943 , 0 
26881.35,15,239 ,9 ,1071 ,0 ,0 ,3 ,1 ,0 ,0 ,0 ,4 ,0 ,4 ,0 ,4,16945 , 0 
26881.36,20,239 ,5 ,789 ,0 ,0 ,3 ,2 ,2 ,0 ,0 ,7 ,0 ,5 ,2 ,7,14062 , 0 
26881.36,16,239 ,2 ,525 ,0 ,0 ,2 ,1 ,2 ,0 ,0 ,5 ,0 ,3 ,2 ,5,31888 , 0 
26881.444,10,239 ,14 ,518 ,0 ,0 ,2 ,0 ,0 ,0 ,0 ,2 ,0 ,1 ,0 ,1,14668 , 0 
26881.482,12,239 ,18 ,913 ,0 ,0 ,3 ,2 ,0 ,0 ,0 ,5 ,0 ,11 ,0 ,11,15512 , 0 
26881.596,9,239 ,5 ,789 ,0 ,0 ,3 ,2 ,1 ,0 ,0 ,6 ,0 ,6 ,2 ,8,27308 , 0 
26881.603,5,239 ,13 ,512 ,0 ,0 ,4 ,0 ,7 ,0 ,0 ,11 ,0 ,9 ,7 ,16,24379 , 0 
26881.606,19,239 ,1 ,256 ,0 ,0 ,1 ,0 ,2 ,0 ,0 ,3 ,0 ,5 ,2 ,7,16061 , 0 
26881.696,17,239 ,16 ,947 ,0 ,0 ,3 ,2 ,0 ,0 ,0 ,5 ,0 ,2 ,0 ,2,19775 , 0 
26881.771,13,239 ,1 ,256 ,0 ,0 ,2 ,0 ,7 ,0 ,0 ,9 ,0 ,3 ,7 ,10,14283 , 0 
26881.786,3,239 ,1 ,256 ,0 ,0 ,1 ,0 ,0 ,0 ,0 ,1 ,0 ,0 ,0 ,0,9785 , 0 
27000.96,8,239 ,1 ,256 ,0 ,0 ,3 ,0 ,0 ,0 ,0 ,3 ,0 ,2 ,0 ,2,11102 , 0 
27001.078,11,239 ,20 ,1207 ,0 ,0 ,2 ,1 ,0 ,0 ,0 ,3 ,0 ,4 ,0 ,4,18921 , 0 
27001.123,2,239 ,1 ,256 ,0 ,0 ,2 ,0 ,2 ,0 ,0 ,4 ,0 ,4 ,2 ,6,19622 , 0 
27001.138,6,239 ,2 ,520 ,0 ,0 ,2 ,1 ,0 ,0 ,0 ,3 ,0 ,4 ,0 ,4,24952 , 0 
27001.214,18,239 ,19 ,512 ,0 ,0 ,0 ,1 ,0 ,0 ,0 ,1 ,0 ,1 ,0 ,1,15657 , 0 
27001.236,4,239 ,8 ,577 ,0 ,0 ,2 ,0 ,0 ,0 ,0 ,2 ,0 ,3 ,0 ,3,13487 , 0 
27001.289,7,239 ,9 ,1109 ,0 ,0 ,2 ,2 ,0 ,0 ,0 ,4 ,0 ,4 ,0 ,4,23105 , 0 
27001.337,14,239 ,1 ,256 ,0 ,0 ,1 ,0 ,1 ,0 ,0 ,2 ,0 ,2 ,1 ,3,13506 , 0 
27001.35,15,239 ,9 ,1125 ,0 ,0 ,2 ,1 ,0 ,0 ,0 ,3 ,0 ,3 ,0 ,3,17779 , 0 
27001.36,20,239 ,5 ,789 ,0 ,0 ,1 ,0 ,1 ,0 ,0 ,2 ,0 ,2 ,1 ,3,15205 , 0 
27001.36,16,239 ,2 ,521 ,0 ,0 ,1 ,1 ,0 ,0 ,0 ,2 ,0 ,5 ,0 ,5,30519 , 0 
27001.444,10,239 ,14 ,515 ,0 ,0 ,2 ,1 ,0 ,0 ,0 ,3 ,0 ,2 ,0 ,2,13897 , 0 
27001.482,12,239 ,18 ,913 ,0 ,0 ,1 ,0 ,0 ,0 ,0 ,1 ,0 ,1 ,0 ,1,16278 , 0 
27001.596,9,239 ,5 ,789 ,0 ,0 ,2 ,0 ,3 ,0 ,0 ,5 ,0 ,5 ,3 ,8,27091 , 0 
27001.603,5,239 ,13 ,512 ,0 ,0 ,0 ,0 ,4 ,0 ,0 ,4 ,0 ,5 ,4 ,9,25304 , 0 
27001.606,19,239 ,1 ,256 ,0 ,0 ,2 ,0 ,1 ,0 ,0 ,3 ,0 ,5 ,1 ,6,16400 , 0 
27001.696,17,239 ,16 ,947 ,0 ,0 ,2 ,0 ,0 ,0 ,0 ,2 ,0 ,2 ,0 ,2,20002 , 0 
27001.771,13,239 ,1 ,256 ,0 ,0 ,2 ,0 ,4 ,0 ,0 ,6 ,0 ,2 ,4 ,6,14366 , 0 
27001.787,3,239 ,1 ,256 ,0 ,0 ,0 ,0 ,0 ,0 ,0 ,0 ,0 ,1 ,0 ,1,10089 , 0 
27120.96,8,239 ,1 ,256 ,0 ,0 ,0 ,0 ,0 ,0 ,0 ,0 ,0 ,0 ,0 ,0,11500 , 0 
27121.078,11,239 ,20 ,1207 ,0 ,0 ,1 ,0 ,0 ,0 ,0 ,1 ,0 ,2 ,0 ,2,18250 , 0 
27121.124,2,239 ,1 ,256 ,0 ,0 ,25 ,0 ,39 ,0 ,0 ,64 ,114 ,21 ,39 ,174,21138 , 0 
27121.214,18,239 ,19 ,512 ,0 ,0 ,2 ,0 ,1 ,0 ,0 ,3 ,0 ,2 ,1 ,3,14891 , 0 
27121.236,4,239 ,8 ,577 ,0 ,0 ,2 ,0 ,0 ,0 ,0 ,2 ,0 ,1 ,0 ,1,12990 , 0 
27121.275,6,239 ,2 ,512 ,0 ,120 ,1 ,13 ,0 ,0 ,0 ,134 ,0 ,77 ,0 ,77,28946 , 1 
27121.289,7,239 ,9 ,1109 ,0 ,0 ,2 ,0 ,0 ,0 ,0 ,2 ,0 ,41 ,0 ,41,23438 , 0 
27121.338,14,239 ,1 ,256 ,0 ,0 ,2 ,0 ,0 ,0 ,0 ,2 ,0 ,41 ,0 ,41,13107 , 0 
27121.35,15,239 ,9 ,1125 ,0 ,0 ,1 ,0 ,0 ,0 ,0 ,1 ,0 ,1 ,0 ,1,17051 , 0 
27121.36,20,239 ,5 ,789 ,0 ,0 ,1 ,0 ,0 ,0 ,0 ,1 ,0 ,0 ,0 ,0,14135 , 0 
27121.361,16,239 ,2 ,512 ,0 ,0 ,25 ,9 ,17 ,0 ,0 ,51 ,114 ,27 ,17 ,158,32379 , 0 
27121.445,10,239 ,14 ,515 ,0 ,0 ,25 ,0 ,0 ,0 ,0 ,25 ,112 ,0 ,0 ,112,14932 , 0 
27121.482,12,239 ,18 ,852 ,0 ,0 ,1 ,1 ,0 ,0 ,0 ,2 ,0 ,3 ,0 ,3,15611 , 0 
27121.596,9,239 ,5 ,789 ,0 ,0 ,1 ,0 ,0 ,0 ,0 ,1 ,0 ,23 ,0 ,23,27453 , 0 
27121.603,5,239 ,13 ,512 ,0 ,0 ,2 ,0 ,0 ,0 ,0 ,2 ,0 ,17 ,0 ,17,24517 , 0 
27121.607,19,239 ,1 ,256 ,0 ,0 ,1 ,0 ,1 ,0 ,0 ,2 ,0 ,23 ,1 ,24,16142 , 0 
27121.697,17,239 ,16 ,809 ,0 ,0 ,25 ,17 ,0 ,0 ,0 ,42 ,111 ,23 ,0 ,134,20140 , 0 
27121.771,13,239 ,1 ,256 ,0 ,0 ,1 ,0 ,0 ,0 ,0 ,1 ,0 ,19 ,0 ,19,14371 , 0 
27121.786,3,239 ,1 ,256 ,0 ,0 ,2 ,0 ,0 ,0 ,0 ,2 ,0 ,1 ,0 ,1,9854 , 0 
27240.96,8,239 ,1 ,256 ,0 ,0 ,1 ,0 ,0 ,0 ,0 ,1 ,0 ,3 ,0 ,3,11182 , 0 
27241.078,11,239 ,20 ,1175 ,0 ,0 ,3 ,0 ,0 ,0 ,0 ,3 ,0 ,6 ,0 ,6,19075 , 0 
27241.124,2,239 ,1 ,256 ,0 ,0 ,26 ,0 ,47 ,0 ,0 ,73 ,111 ,23 ,47 ,181,19957 , 0 
27241.214,18,239 ,19 ,512 ,0 ,0 ,1 ,0 ,0 ,0 ,0 ,1 ,0 ,1 ,0 ,1,15719 , 0 
27241.236,4,239 ,8 ,577 ,0 ,0 ,1 ,0 ,0 ,0 ,0 ,1 ,0 ,1 ,0 ,1,13548 , 0 
27241.27,6,239 ,2 ,512 ,0 ,120 ,1 ,16 ,0 ,0 ,0 ,137 ,0 ,77 ,0 ,77,25830 , 1 
27241.289,7,239 ,9 ,1090 ,0 ,0 ,1 ,0 ,0 ,0 ,0 ,1 ,0 ,42 ,0 ,42,23200 , 0 
27241.338,14,239 ,1 ,256 ,0 ,0 ,1 ,0 ,0 ,0 ,0 ,1 ,0 ,40 ,0 ,40,13614 , 0 
27241.35,15,239 ,9 ,1090 ,0 ,0 ,2 ,1 ,0 ,0 ,0 ,3 ,0 ,2 ,0 ,2,17862 , 0 
27241.36,20,239 ,5 ,789 ,0 ,0 ,2 ,0 ,0 ,0 ,0 ,2 ,0 ,1 ,0 ,1,15307 , 0 
27241.445,10,239 ,14 ,515 ,0 ,0 ,25 ,0 ,0 ,0 ,0 ,25 ,114 ,0 ,0 ,114,14150 , 0 
27241.482,12,239 ,18 ,852 ,0 ,0 ,2 ,0 ,0 ,0 ,0 ,2 ,0 ,3 ,0 ,3,16390 , 0 
27241.495,16,239 ,2 ,512 ,0 ,0 ,26 ,14 ,18 ,0 ,0 ,58 ,110 ,37 ,18 ,165,31116 , 0 
27241.596,9,239 ,5 ,789 ,0 ,0 ,2 ,0 ,1 ,0 ,0 ,3 ,0 ,23 ,1 ,24,27230 , 0 
27241.603,5,239 ,13 ,512 ,0 ,0 ,2 ,0 ,1 ,0 ,0 ,3 ,0 ,25 ,1 ,26,25424 , 0 
27241.697,17,239 ,16 ,825 ,0 ,0 ,25 ,18 ,0 ,0 ,0 ,43 ,108 ,22 ,0 ,130,20373 , 0 
27241.715,19,239 ,1 ,256 ,0 ,0 ,1 ,0 ,0 ,0 ,0 ,1 ,0 ,23 ,0 ,23,16540 , 0 
27241.771,13,239 ,1 ,256 ,0 ,0 ,1 ,0 ,1 ,0 ,0 ,2 ,0 ,19 ,1 ,20,14515 , 0 
27241.787,3,239 ,1 ,256 ,0 ,0 ,1 ,0 ,0 ,0 ,0 ,1 ,0 ,1 ,0 ,1,10165 , 0 
27360.96,8,239 ,1 ,256 ,0 ,0 ,1 ,0 ,0 ,0 ,0 ,1 ,0 ,0 ,0 ,0,11560 , 0 
27361.078,11,239 ,20 ,1175 ,0 ,0 ,0 ,0 ,0 ,0 ,0 ,0 ,0 ,1 ,0 ,1,18305 , 0 
27361.124,2,239 ,1 ,256 ,0 ,0 ,27 ,0 ,48 ,0 ,0 ,75 ,118 ,25 ,48 ,191,21489 , 0 
27361.214,18,239 ,19 ,512 ,0 ,0 ,1 ,0 ,0 ,0 ,0 ,1 ,0 ,1 ,0 ,1,14956 , 0 
27361.236,4,239 ,8 ,577 ,0 ,0 ,1 ,0 ,0 ,0 ,0 ,1 ,0 ,1 ,0 ,1,13073 , 0 
27361.275,6,239 ,2 ,512 ,0 ,120 ,1 ,15 ,0 ,0 ,0 ,136 ,0 ,92 ,0 ,92,29855 , 1 
27361.289,7,239 ,9 ,1085 ,0 ,0 ,2 ,1 ,0 ,0 ,0 ,3 ,0 ,49 ,0 ,49,23554 , 0 
27361.338,14,239 ,1 ,256 ,0 ,0 ,1 ,0 ,0 ,0 ,0 ,1 ,0 ,40 ,0 ,40,13225 , 0 
27361.35,15,239 ,9 ,1090 ,0 ,0 ,1 ,0 ,0 ,0 ,0 ,1 ,0 ,0 ,0 ,0,17107 , 0 
27361.36,20,239 ,5 ,789 ,0 ,0 ,1 ,0 ,0 ,0 ,0 ,1 ,0 ,0 ,0 ,0,14192 , 0 
27361.361,16,239 ,2 ,512 ,0 ,0 ,27 ,13 ,19 ,0 ,0 ,59 ,115 ,35 ,19 ,169,32945 , 0 
27361.445,10,239 ,14 ,515 ,0 ,0 ,26 ,0 ,0 ,0 ,0 ,26 ,117 ,1 ,0 ,118,15210 , 0 
27361.482,12,239 ,18 ,852 ,0 ,0 ,1 ,0 ,0 ,0 ,0 ,1 ,0 ,0 ,0 ,0,15687 , 0 
27361.596,9,239 ,5 ,789 ,0 ,0 ,1 ,0 ,1 ,0 ,0 ,2 ,0 ,26 ,1 ,27,27565 , 0 
27361.603,5,239 ,13 ,512 ,0 ,0 ,1 ,0 ,1 ,0 ,0 ,2 ,0 ,22 ,1 ,23,24613 , 0 
27361.607,19,239 ,1 ,256 ,0 ,0 ,1 ,0 ,0 ,0 ,0 ,1 ,0 ,22 ,0 ,22,16238 , 0 
27361.697,17,239 ,16 ,784 ,0 ,0 ,27 ,19 ,0 ,0 ,0 ,46 ,117 ,25 ,0 ,142,20566 , 0 
27361.771,13,239 ,1 ,256 ,0 ,0 ,1 ,0 ,1 ,0 ,0 ,2 ,0 ,20 ,1 ,21,14463 , 0 
27361.786,3,239 ,1 ,256 ,0 ,0 ,1 ,0 ,0 ,0 ,0 ,1 ,0 ,0 ,0 ,0,9923 , 0 
27480.96,8,239 ,1 ,256 ,0 ,0 ,1 ,0 ,0 ,0 ,0 ,1 ,0 ,2 ,0 ,2,11242 , 0 
27481.078,11,239 ,20 ,1175 ,0 ,0 ,2 ,0 ,0 ,0 ,0 ,2 ,0 ,1 ,0 ,1,19160 , 0 
27481.124,2,239 ,1 ,256 ,0 ,0 ,6 ,0 ,16 ,0 ,0 ,22 ,1 ,4 ,16 ,21,20075 , 0 
27481.138,6,239 ,2 ,512 ,0 ,0 ,1 ,5 ,0 ,0 ,0 ,6 ,0 ,18 ,0 ,18,25917 , 0 
27481.214,18,239 ,19 ,512 ,0 ,0 ,1 ,0 ,1 ,0 ,0 ,2 ,0 ,2 ,1 ,3,15802 , 0 
27481.236,4,239 ,8 ,577 ,0 ,0 ,1 ,0 ,0 ,0 ,0 ,1 ,0 ,0 ,0 ,0,13612 , 0 
27481.289,7,239 ,9 ,1085 ,0 ,0 ,1 ,0 ,0 ,0 ,0 ,1 ,0 ,10 ,0 ,10,23291 , 0 
27481.338,14,239 ,1 ,256 ,0 ,0 ,0 ,0 ,0 ,0 ,0 ,0 ,0 ,10 ,0 ,10,13673 , 0 
27481.35,15,239 ,9 ,1090 ,0 ,0 ,1 ,0 ,0 ,0 ,0 ,1 ,0 ,1 ,0 ,1,17946 , 0 
27481.36,20,239 ,5 ,789 ,0 ,0 ,1 ,0 ,0 ,0 ,0 ,1 ,0 ,0 ,0 ,0,15406 , 0 
27481.361,16,239 ,2 ,512 ,0 ,0 ,6 ,5 ,6 ,0 ,0 ,17 ,0 ,9 ,6 ,15,31317 , 0 
27481.444,10,239 ,14 ,515 ,0 ,0 ,6 ,0 ,0 ,0 ,0 ,6 ,0 ,0 ,0 ,0,14231 , 0 
27481.482,12,239 ,18 ,835 ,0 ,0 ,1 ,1 ,0 ,0 ,0 ,2 ,0 ,3 ,0 ,3,16477 , 0 
27481.596,9,239 ,5 ,789 ,0 ,0 ,1 ,0 ,0 ,0 ,0 ,1 ,0 ,5 ,0 ,5,27315 , 0 
27481.603,5,239 ,13 ,512 ,0 ,0 ,1 ,0 ,0 ,0 ,0 ,1 ,0 ,7 ,0 ,7,25531 , 0 
27481.606,19,239 ,1 ,256 ,0 ,0 ,1 ,0 ,1 ,0 ,0 ,2 ,0 ,6 ,1 ,7,16633 , 0 
27481.697,17,239 ,16 ,790 ,0 ,0 ,5 ,6 ,0 ,0 ,0 ,11 ,0 ,5 ,0 ,5,20491 , 0 
27481.771,13,239 ,1 ,256 ,0 ,0 ,0 ,0 ,0 ,0 ,0 ,0 ,0 ,6 ,0 ,6,14589 , 0 
27481.787,3,239 ,1 ,256 ,0 ,0 ,2 ,0 ,0 ,0 ,0 ,2 ,0 ,0 ,0 ,0,10219 , 0 
27600.96,8,239 ,1 ,256 ,0 ,0 ,1 ,0 ,0 ,0 ,0 ,1 ,0 ,0 ,0 ,0,11619 , 0 
27601.078,11,239 ,20 ,1139 ,0 ,0 ,2 ,1 ,0 ,0 ,0 ,3 ,0 ,3 ,0 ,3,18384 , 0 
27601.123,2,239 ,1 ,256 ,0 ,0 ,2 ,0 ,3 ,0 ,0 ,5 ,0 ,2 ,3 ,5,21608 , 0 
27601.138,6,239 ,2 ,512 ,0 ,0 ,1 ,1 ,0 ,0 ,0 ,2 ,0 ,6 ,0 ,6,29930 , 0 
27601.214,18,239 ,19 ,512 ,0 ,0 ,2 ,0 ,0 ,0 ,0 ,2 ,0 ,1 ,0 ,1,15020 , 0 
27601.236,4,239 ,8 ,577 ,0 ,0 ,1 ,0 ,0 ,0 ,0 ,1 ,0 ,2 ,0 ,2,13130 , 0 
27601.289,7,239 ,9 ,1073 ,0 ,0 ,0 ,0 ,0 ,0 ,0 ,0 ,0 ,4 ,0 ,4,23624 , 0 
27601.337,14,239 ,1 ,256 ,0 ,0 ,1 ,0 ,0 ,0 ,0 ,1 ,0 ,4 ,0 ,4,13298 , 0 
27601.35,15,239 ,9 ,1090 ,0 ,0 ,3 ,0 ,0 ,0 ,0 ,3 ,0 ,1 ,0 ,1,17203 , 0 
27601.36,20,239 ,5 ,789 ,0 ,0 ,2 ,0 ,1 ,0 ,0 ,3 ,0 ,1 ,1 ,2,14273 , 0 
27601.36,16,239 ,2 ,512 ,0 ,0 ,2 ,1 ,1 ,0 ,0 ,4 ,0 ,2 ,1 ,3,33069 , 0 
27601.444,10,239 ,14 ,515 ,0 ,0 ,2 ,0 ,0 ,0 ,0 ,2 ,0 ,0 ,0 ,0,15274 , 0 
27601.482,12,239 ,18 ,816 ,0 ,0 ,1 ,0 ,0 ,0 ,0 ,1 ,0 ,3 ,0 ,3,15763 , 0 
27601.596,9,239 ,5 ,789 ,0 ,0 ,1 ,0 ,0 ,0 ,0 ,1 ,0 ,4 ,0 ,4,27642 , 0 
27601.603,5,239 ,13 ,512 ,0 ,0 ,1 ,0 ,1 ,0 ,0 ,2 ,0 ,5 ,1 ,6,24689 , 0 
27601.606,19,239 ,1 ,256 ,0 ,0 ,1 ,0 ,0 ,0 ,0 ,1 ,0 ,2 ,0 ,2,16322 , 0 
27601.696,17,239 ,16 ,785 ,0 ,0 ,2 ,1 ,0 ,0 ,0 ,3 ,0 ,2 ,0 ,2,20647 , 0 
27601.771,13,239 ,1 ,256 ,0 ,0 ,1 ,0 ,1 ,0 ,0 ,2 ,0 ,2 ,1 ,3,14529 , 0 
27601.786,3,239 ,1 ,256 ,0 ,0 ,1 ,0 ,0 ,0 ,0 ,1 ,0 ,1 ,0 ,1,9976 , 0 
27720.96,8,239 ,1 ,256 ,0 ,0 ,1 ,0 ,0 ,0 ,0 ,1 ,0 ,1 ,0 ,1,11313 , 0 
27721.078,11,239 ,20 ,1135 ,0 ,0 ,1 ,1 ,0 ,0 ,0 ,2 ,0 ,4 ,0 ,4,19230 , 0 
27721.123,2,239 ,1 ,256 ,0 ,0 ,1 ,0 ,1 ,0 ,0 ,2 ,0 ,1 ,1 ,2,20145 , 0 
27721.138,6,239 ,2 ,512 ,0 ,0 ,1 ,0 ,0 ,0 ,0 ,1 ,0 ,2 ,0 ,2,25978 , 0 
27721.214,18,239 ,19 ,512 ,0 ,0 ,1 ,0 ,0 ,0 ,0 ,1 ,0 ,2 ,0 ,2,15863 , 0 
27721.236,4,239 ,8 ,577 ,0 ,0 ,1 ,0 ,0 ,0 ,0 ,1 ,0 ,0 ,0 ,0,13671 , 0 
27721.289,7,239 ,9 ,1073 ,0 ,0 ,1 ,0 ,0 ,0 ,0 ,1 ,0 ,3 ,0 ,3,23360 , 0 
27721.337,14,239 ,1 ,256 ,0 ,0 ,2 ,0 ,0 ,0 ,0 ,2 ,0 ,1 ,0 ,1,13769 , 0 
27721.35,15,239 ,9 ,1064 ,0 ,0 ,1 ,2 ,0 ,0 ,0 ,3 ,0 ,2 ,0 ,2,18009 , 0 
27721.36,20,239 ,5 ,789 ,0 ,0 ,1 ,0 ,1 ,0 ,0 ,2 ,0 ,1 ,1 ,2,15474 , 0 
27721.36,16,239 ,2 ,512 ,0 ,0 ,1 ,0 ,1 ,0 ,0 ,2 ,0 ,1 ,1 ,2,31399 , 0 
27721.444,10,239 ,14 ,515 ,0 ,0 ,1 ,0 ,0 ,0 ,0 ,1 ,0 ,1 ,0 ,1,14292 , 0 
27721.482,12,239 ,18 ,816 ,0 ,0 ,2 ,0 ,0 ,0 ,0 ,2 ,0 ,1 ,0 ,1,16559 , 0 
27721.596,9,239 ,5 ,789 ,0 ,0 ,2 ,0 ,2 ,0 ,0 ,4 ,0 ,1 ,2 ,3,27420 , 0 
27721.603,5,239 ,13 ,512 ,0 ,0 ,2 ,0 ,3 ,0 ,0 ,5 ,0 ,4 ,3 ,7,25655 , 0 
27721.606,19,239 ,1 ,256 ,0 ,0 ,1 ,0 ,0 ,0 ,0 ,1 ,0 ,3 ,0 ,3,16715 , 0 
27721.696,17,239 ,16 ,829 ,0 ,0 ,1 ,1 ,0 ,0 ,0 ,2 ,0 ,2 ,0 ,2,20576 , 0 
27721.771,13,239 ,1 ,256 ,0 ,0 ,1 ,0 ,3 ,0 ,0 ,4 ,0 ,2 ,3 ,5,14673 , 0 
27721.787,3,239 ,1 ,256 ,0 ,0 ,0 ,0 ,0 ,0 ,0 ,0 ,0 ,1 ,0 ,1,10277 , 0 
27840.96,8,239 ,1 ,256 ,0 ,0 ,1 ,0 ,1 ,0 ,0 ,2 ,0 ,3 ,1 ,4,11694 , 0 
27841.078,11,239 ,20 ,1135 ,0 ,0 ,2 ,0 ,0 ,0 ,0 ,2 ,0 ,5 ,0 ,5,18469 , 0 
27841.124,2,239 ,1 ,256 ,0 ,0 ,5 ,0 ,10 ,0 ,1 ,16 ,0 ,7 ,12 ,19,21725 , 0 
27841.138,6,239 ,2 ,512 ,0 ,0 ,5 ,3 ,4 ,0 ,0 ,12 ,0 ,9 ,4 ,13,30086 , 0 
27841.214,18,239 ,19 ,512 ,0 ,0 ,1 ,0 ,0 ,0 ,0 ,1 ,0 ,1 ,0 ,1,15098 , 0 
27841.236,4,239 ,8 ,537 ,0 ,0 ,2 ,1 ,0 ,0 ,0 ,3 ,0 ,3 ,0 ,3,13220 , 0 
27841.289,7,239 ,9 ,1058 ,0 ,0 ,7 ,2 ,0 ,0 ,0 ,9 ,0 ,9 ,0 ,9,23747 , 0 
27841.337,14,239 ,1 ,256 ,0 ,0 ,1 ,0 ,0 ,0 ,0 ,1 ,0 ,4 ,0 ,4,13360 , 0 
27841.35,15,239 ,9 ,1058 ,0 ,0 ,1 ,2 ,0 ,0 ,0 ,3 ,0 ,11 ,0 ,11,17302 , 0 
27841.36,20,239 ,5 ,789 ,0 ,0 ,0 ,0 ,0 ,0 ,0 ,0 ,0 ,0 ,0 ,0,14330 , 0 
27841.36,16,239 ,2 ,512 ,0 ,0 ,2 ,3 ,0 ,1 ,1 ,7 ,0 ,22 ,1 ,23,33207 , 1 
27841.444,10,239 ,14 ,515 ,0 ,0 ,2 ,0 ,0 ,0 ,0 ,2 ,0 ,4 ,0 ,4,15343 , 0 
27841.482,12,239 ,18 ,816 ,0 ,0 ,1 ,0 ,0 ,0 ,0 ,1 ,0 ,0 ,0 ,0,15845 , 0 
27841.596,9,239 ,5 ,789 ,0 ,0 ,5 ,0 ,4 ,0 ,0 ,9 ,0 ,7 ,4 ,11,27779 , 0 
27841.603,5,239 ,13 ,512 ,0 ,0 ,0 ,0 ,4 ,0 ,0 ,4 ,0 ,7 ,4 ,11,24789 , 0 
27841.606,19,239 ,1 ,256 ,0 ,0 ,2 ,0 ,0 ,0 ,0 ,2 ,0 ,5 ,0 ,5,16423 , 0 
27841.697,17,239 ,6 ,786 ,0 ,0 ,6 ,4 ,0 ,1 ,0 ,11 ,0 ,11 ,0 ,11,20759 , 0 
27841.771,13,239 ,1 ,256 ,0 ,0 ,1 ,0 ,4 ,0 ,0 ,5 ,0 ,3 ,4 ,7,14622 , 0 
27841.787,3,239 ,1 ,256 ,0 ,0 ,2 ,0 ,0 ,0 ,0 ,2 ,0 ,0 ,0 ,0,10041 , 0 
27960.96,8,239 ,1 ,256 ,0 ,0 ,1 ,0 ,0 ,0 ,0 ,1 ,0 ,1 ,0 ,1,11371 , 0 
27961.078,11,239 ,20 ,1135 ,0 ,0 ,0 ,0 ,0 ,0 ,0 ,0 ,0 ,2 ,0 ,2,19288 , 0 
27961.123,2,239 ,1 ,256 ,0 ,0 ,2 ,0 ,3 ,0 ,0 ,5 ,0 ,2 ,3 ,5,20219 , 0 
27961.138,6,239 ,2 ,512 ,0 ,0 ,2 ,1 ,1 ,0 ,0 ,4 ,0 ,6 ,1 ,7,26060 , 0 
27961.214,18,239 ,19 ,512 ,0 ,0 ,2 ,0 ,0 ,0 ,0 ,2 ,0 ,0 ,0 ,0,15929 , 0 
27961.236,4,239 ,8 ,537 ,0 ,0 ,1 ,0 ,0 ,0 ,0 ,1 ,0 ,0 ,0 ,0,13736 , 0 
27961.289,7,239 ,9 ,1054 ,0 ,0 ,2 ,1 ,0 ,0 ,0 ,3 ,0 ,7 ,0 ,7,23439 , 0 
27961.337,14,239 ,1 ,256 ,0 ,0 ,1 ,0 ,0 ,0 ,0 ,1 ,0 ,4 ,0 ,4,13825 , 0 
27961.35,15,239 ,9 ,1054 ,0 ,0 ,1 ,1 ,0 ,0 ,0 ,2 ,0 ,2 ,0 ,2,18087 , 0 
27961.36,20,239 ,5 ,789 ,0 ,0 ,1 ,0 ,0 ,0 ,0 ,1 ,0 ,1 ,0 ,1,15538 , 0 
27961.361,16,239 ,2 ,512 ,0 ,0 ,1 ,1 ,0 ,0 ,0 ,2 ,0 ,11 ,0 ,11,31476 , 1 
27961.444,10,239 ,14 ,515 ,0 ,0 ,1 ,0 ,0 ,0 ,0 ,1 ,0 ,1 ,0 ,1,14345 , 0 
27961.482,12,239 ,18 ,816 ,0 ,0 ,2 ,0 ,0 ,0 ,0 ,2 ,0 ,1 ,0 ,1,16638 , 0 
27961.596,9,239 ,5 ,789 ,0 ,0 ,2 ,0 ,2 ,0 ,0 ,4 ,0 ,1 ,2 ,3,27514 , 0 
27961.603,5,239 ,13 ,512 ,0 ,0 ,1 ,0 ,2 ,0 ,0 ,3 ,0 ,4 ,2 ,6,25741 , 0 
27961.606,19,239 ,1 ,256 ,0 ,0 ,0 ,0 ,0 ,0 ,0 ,0 ,0 ,6 ,0 ,6,16781 , 0 
27961.696,17,239 ,6 ,780 ,0 ,0 ,6 ,1 ,0 ,0 ,0 ,7 ,0 ,4 ,0 ,4,20691 , 0 
27961.771,13,239 ,1 ,256 ,0 ,0 ,1 ,0 ,2 ,0 ,0 ,3 ,0 ,1 ,2 ,3,14738 , 0 
27961.787,3,239 ,1 ,256 ,0 ,0 ,2 ,0 ,0 ,0 ,0 ,2 ,0 ,0 ,0 ,0,10336 , 0 
28080.96,8,239 ,1 ,256 ,0 ,0 ,2 ,0 ,0 ,0 ,0 ,2 ,0 ,0 ,0 ,0,11759 , 0 
28081.078,11,239 ,20 ,1135 ,0 ,0 ,2 ,0 ,0 ,0 ,0 ,2 ,0 ,3 ,0 ,3,18549 , 0 
28081.123,2,239 ,1 ,256 ,0 ,0 ,2 ,0 ,3 ,0 ,0 ,5 ,0 ,3 ,3 ,6,21833 , 0 
28081.138,6,239 ,2 ,512 ,0 ,0 ,3 ,1 ,1 ,0 ,0 ,5 ,0 ,4 ,1 ,5,30177 , 0 
28081.214,18,239 ,19 ,512 ,0 ,0 ,0 ,0 ,0 ,0 ,0 ,0 ,0 ,1 ,0 ,1,15153 , 0 
28081.236,4,239 ,8 ,534 ,0 ,0 ,1 ,0 ,0 ,0 ,0 ,1 ,0 ,1 ,0 ,1,13284 , 0 
28081.289,7,239 ,9 ,1052 ,0 ,0 ,5 ,1 ,0 ,0 ,0 ,6 ,0 ,3 ,0 ,3,23838 , 0 
28081.337,14,239 ,1 ,256 ,0 ,0 ,1 ,0 ,0 ,0 ,0 ,1 ,0 ,2 ,0 ,2,13444 , 0 
28081.35,15,239 ,9 ,1048 ,0 ,0 ,0 ,2 ,0 ,0 ,0 ,2 ,0 ,5 ,0 ,5,17375 , 0 
28081.36,20,239 ,5 ,789 ,0 ,0 ,1 ,0 ,0 ,0 ,0 ,1 ,0 ,1 ,0 ,1,14411 , 0 
28081.36,16,239 ,2 ,512 ,0 ,0 ,2 ,1 ,0 ,0 ,0 ,3 ,0 ,9 ,0 ,9,33275 , 1 
28081.444,10,239 ,14 ,515 ,0 ,0 ,1 ,0 ,0 ,0 ,0 ,1 ,0 ,3 ,0 ,3,15403 , 0 
28081.482,12,239 ,18 ,816 ,0 ,0 ,1 ,0 ,0 ,0 ,0 ,1 ,0 ,0 ,0 ,0,15904 , 0 
28081.596,9,239 ,5 ,789 ,0 ,0 ,2 ,0 ,3 ,0 ,0 ,5 ,0 ,3 ,3 ,6,27906 , 0 
28081.603,5,239 ,13 ,512 ,0 ,0 ,1 ,0 ,3 ,0 ,0 ,4 ,0 ,5 ,3 ,8,24915 , 0 
28081.606,19,239 ,1 ,256 ,0 ,0 ,1 ,0 ,0 ,0 ,0 ,1 ,0 ,2 ,0 ,2,16499 , 0 
28081.696,17,239 ,6 ,774 ,0 ,0 ,1 ,1 ,0 ,0 ,0 ,2 ,0 ,5 ,0 ,5,20821 , 0 
28081.771,13,239 ,1 ,256 ,0 ,0 ,2 ,0 ,3 ,0 ,0 ,5 ,0 ,2 ,3 ,5,14699 , 0 
28081.787,3,239 ,1 ,256 ,0 ,0 ,1 ,0 ,0 ,0 ,0 ,1 ,0 ,3 ,0 ,3,10113 , 0 
28200.96,8,239 ,1 ,256 ,0 ,0 ,1 ,0 ,1 ,0 ,0 ,2 ,0 ,2 ,1 ,3,11441 , 0 
28201.078,11,239 ,20 ,1135 ,0 ,0 ,1 ,0 ,0 ,0 ,0 ,1 ,0 ,1 ,0 ,1,19356 , 0 
28201.123,2,239 ,1 ,256 ,0 ,0 ,1 ,0 ,5 ,0 ,0 ,6 ,0 ,4 ,5 ,9,20283 , 0 
28201.138,6,239 ,2 ,512 ,0 ,0 ,6 ,0 ,5 ,0 ,0 ,11 ,0 ,2 ,5 ,7,26197 , 0 
28201.214,18,239 ,19 ,512 ,0 ,0 ,1 ,0 ,0 ,0 ,0 ,1 ,0 ,1 ,0 ,1,16006 , 0 
28201.236,4,239 ,8 ,529 ,0 ,0 ,1 ,1 ,0 ,0 ,0 ,2 ,0 ,2 ,0 ,2,13810 , 0 
28201.307,7,239 ,9 ,1052 ,0 ,0 ,4 ,0 ,0 ,0 ,0 ,4 ,0 ,2 ,0 ,2,23513 , 0 
28201.337,14,239 ,1 ,256 ,0 ,0 ,0 ,0 ,0 ,0 ,0 ,0 ,0 ,0 ,0 ,0,13879 , 0 
28201.35,15,239 ,9 ,1048 ,0 ,0 ,1 ,0 ,0 ,0 ,0 ,1 ,0 ,3 ,0 ,3,18169 , 0 
28201.36,20,239 ,5 ,789 ,0 ,0 ,2 ,0 ,0 ,0 ,0 ,2 ,0 ,1 ,0 ,1,15603 , 0 
28201.36,16,239 ,2 ,512 ,0 ,0 ,0 ,0 ,0 ,0 ,0 ,0 ,0 ,9 ,0 ,9,31542 , 0 
28201.444,10,239 ,14 ,515 ,0 ,0 ,1 ,0 ,0 ,0 ,0 ,1 ,0 ,4 ,0 ,4,14404 , 0 
28201.482,12,239 ,18 ,816 ,0 ,0 ,1 ,0 ,0 ,0 ,0 ,1 ,0 ,2 ,0 ,2,16715 , 0 
28201.596,9,239 ,5 ,789 ,0 ,0 ,1 ,0 ,0 ,0 ,0 ,1 ,0 ,2 ,0 ,2,27584 , 0 
28201.603,5,239 ,13 ,512 ,0 ,0 ,1 ,0 ,0 ,0 ,0 ,1 ,0 ,1 ,0 ,1,25814 , 0 
28201.606,19,239 ,1 ,256 ,0 ,0 ,1 ,0 ,0 ,0 ,0 ,1 ,0 ,1 ,0 ,1,16877 , 0 
28201.696,17,239 ,6 ,770 ,0 ,0 ,3 ,5 ,0 ,0 ,0 ,8 ,0 ,8 ,0 ,8,20788 , 0 
28201.771,13,239 ,1 ,256 ,0 ,0 ,0 ,0 ,0 ,0 ,0 ,0 ,0 ,1 ,0 ,1,14794 , 0 
28201.787,3,239 ,1 ,256 ,0 ,0 ,1 ,0 ,0 ,0 ,0 ,1 ,0 ,0 ,0 ,0,10394 , 0 
28320.96,8,239 ,1 ,256 ,0 ,0 ,1 ,0 ,0 ,0 ,0 ,1 ,0 ,0 ,0 ,0,11833 , 0 
28321.078,11,239 ,20 ,1096 ,0 ,0 ,1 ,0 ,0 ,0 ,0 ,1 ,0 ,3 ,0 ,3,18616 , 0 
28321.123,2,239 ,1 ,256 ,0 ,0 ,2 ,0 ,3 ,0 ,0 ,5 ,0 ,2 ,3 ,5,21942 , 0 
28321.138,6,239 ,2 ,512 ,0 ,0 ,2 ,1 ,1 ,0 ,0 ,4 ,0 ,2 ,1 ,3,30273 , 0 
28321.214,18,239 ,19 ,512 ,0 ,0 ,2 ,0 ,2 ,0 ,0 ,4 ,0 ,1 ,2 ,3,15243 , 0 
28321.236,4,239 ,8 ,529 ,0 ,0 ,1 ,0 ,0 ,0 ,0 ,1 ,0 ,0 ,0 ,0,13367 , 0 
28321.289,7,239 ,9 ,1047 ,0 ,0 ,1 ,1 ,0 ,0 ,0 ,2 ,0 ,4 ,0 ,4,23906 , 0 
28321.337,14,239 ,1 ,256 ,0 ,0 ,2 ,0 ,0 ,0 ,0 ,2 ,0 ,3 ,0 ,3,13547 , 0 
28321.35,15,239 ,9 ,1046 ,0 ,0 ,1 ,1 ,0 ,0 ,0 ,2 ,0 ,2 ,0 ,2,17445 , 0 
28321.36,20,239 ,5 ,789 ,0 ,0 ,1 ,0 ,0 ,0 ,0 ,1 ,0 ,0 ,0 ,0,14471 , 0 
28321.36,16,239 ,2 ,512 ,0 ,0 ,1 ,1 ,0 ,0 ,0 ,2 ,0 ,5 ,0 ,5,33375 , 0 
28321.444,10,239 ,14 ,515 ,0 ,0 ,1 ,0 ,0 ,0 ,0 ,1 ,0 ,2 ,0 ,2,15477 , 0 
28321.482,12,239 ,18 ,795 ,0 ,0 ,1 ,2 ,0 ,0 ,0 ,3 ,0 ,3 ,0 ,3,15980 , 0 
28321.596,9,239 ,5 ,789 ,0 ,0 ,3 ,0 ,2 ,0 ,0 ,5 ,0 ,2 ,2 ,4,28034 , 0 
28321.603,5,239 ,13 ,512 ,0 ,0 ,1 ,1 ,2 ,0 ,0 ,4 ,0 ,6 ,2 ,8,25035 , 0 
28321.606,19,239 ,1 ,256 ,0 ,0 ,1 ,0 ,2 ,0 ,0 ,3 ,0 ,5 ,2 ,7,16590 , 0 
28321.696,17,239 ,6 ,768 ,0 ,0 ,2 ,1 ,0 ,0 ,0 ,3 ,0 ,1 ,0 ,1,20906 , 0 
28321.771,13,239 ,1 ,256 ,0 ,0 ,2 ,0 ,3 ,0 ,0 ,5 ,0 ,2 ,3 ,5,14800 , 0 
28321.787,3,239 ,1 ,256 ,0 ,0 ,1 ,0 ,0 ,0 ,0 ,1 ,0 ,0 ,0 ,0,10170 , 0 
28440.96,8,239 ,1 ,256 ,0 ,0 ,1 ,0 ,0 ,0 ,0 ,1 ,0 ,2 ,0 ,2,11496 , 0 
28441.078,11,239 ,20 ,1096 ,0 ,0 ,1 ,0 ,0 ,0 ,0 ,1 ,0 ,3 ,0 ,3,19424 , 0 
28441.123,2,239 ,1 ,256 ,0 ,0 ,1 ,0 ,0 ,0 ,0 ,1 ,0 ,1 ,0 ,1,20353 , 0 
28441.138,6,239 ,2 ,512 ,0 ,0 ,1 ,0 ,0 ,0 ,0 ,1 ,0 ,3 ,0 ,3,26261 , 0 
28441.214,18,239 ,19 ,512 ,0 ,0 ,1 ,0 ,0 ,0 ,0 ,1 ,0 ,0 ,0 ,0,16066 , 0 
28441.236,4,239 ,8 ,529 ,0 ,0 ,1 ,0 ,0 ,0 ,0 ,1 ,0 ,0 ,0 ,0,13867 , 0 
28441.289,7,239 ,9 ,1047 ,0 ,0 ,1 ,0 ,0 ,0 ,0 ,1 ,0 ,0 ,0 ,0,23581 , 0 
28441.337,14,239 ,1 ,256 ,0 ,0 ,1 ,0 ,0 ,0 ,0 ,1 ,0 ,1 ,0 ,1,13946 , 0 
28441.35,15,239 ,9 ,1046 ,0 ,0 ,1 ,0 ,0 ,0 ,0 ,1 ,0 ,2 ,0 ,2,18241 , 0 
28441.36,20,239 ,5 ,789 ,0 ,0 ,1 ,0 ,0 ,0 ,0 ,1 ,0 ,0 ,0 ,0,15687 , 0 
28441.36,16,239 ,2 ,512 ,0 ,0 ,1 ,0 ,0 ,0 ,0 ,1 ,0 ,4 ,0 ,4,31617 , 0 
28441.444,10,239 ,14 ,515 ,0 ,0 ,2 ,0 ,0 ,0 ,0 ,2 ,0 ,0 ,0 ,0,14462 , 0 
28441.482,12,239 ,18 ,795 ,0 ,0 ,1 ,0 ,0 ,0 ,0 ,1 ,0 ,1 ,0 ,1,16797 , 0 
28441.596,9,239 ,5 ,789 ,0 ,0 ,1 ,0 ,0 ,0 ,0 ,1 ,0 ,1 ,0 ,1,27652 , 0 
28441.602,5,239 ,13 ,512 ,0 ,0 ,1 ,0 ,0 ,0 ,0 ,1 ,0 ,2 ,0 ,2,25899 , 0 
28441.606,19,239 ,1 ,256 ,0 ,0 ,2 ,0 ,0 ,0 ,0 ,2 ,0 ,1 ,0 ,1,16948 , 0 
28441.696,17,239 ,6 ,768 ,0 ,0 ,1 ,0 ,0 ,0 ,0 ,1 ,0 ,1 ,0 ,1,20849 , 0 
28441.771,13,239 ,1 ,256 ,0 ,0 ,1 ,0 ,0 ,0 ,0 ,1 ,0 ,1 ,0 ,1,14863 , 0 
28441.787,3,239 ,1 ,256 ,0 ,0 ,1 ,0 ,0 ,0 ,0 ,1 ,0 ,1 ,0 ,1,10454 , 0 
28560.96,8,239 ,1 ,256 ,0 ,0 ,2 ,0 ,0 ,0 ,0 ,2 ,0 ,1 ,0 ,1,11895 , 0 
28561.078,11,239 ,20 ,1096 ,0 ,0 ,1 ,0 ,0 ,0 ,0 ,1 ,0 ,1 ,0 ,1,18692 , 0 
28561.123,2,239 ,1 ,256 ,0 ,0 ,0 ,0 ,1 ,0 ,0 ,1 ,0 ,2 ,1 ,3,22009 , 0 
28561.138,6,239 ,2 ,512 ,0 ,0 ,3 ,0 ,1 ,0 ,0 ,4 ,0 ,0 ,1 ,1,30359 , 0 
28561.214,18,239 ,19 ,512 ,0 ,0 ,2 ,0 ,0 ,0 ,0 ,2 ,0 ,2 ,0 ,2,15308 , 0 
28561.236,4,239 ,8 ,521 ,0 ,0 ,2 ,0 ,0 ,0 ,0 ,2 ,0 ,3 ,0 ,3,13434 , 0 
28561.289,7,239 ,9 ,1047 ,0 ,0 ,2 ,0 ,0 ,0 ,0 ,2 ,0 ,1 ,0 ,1,23992 , 0 
28561.337,14,239 ,1 ,256 ,0 ,0 ,1 ,0 ,0 ,0 ,0 ,1 ,0 ,1 ,0 ,1,13606 , 0 
28561.35,15,239 ,9 ,1046 ,0 ,0 ,1 ,0 ,0 ,0 ,0 ,1 ,0 ,0 ,0 ,0,17508 , 0 
28561.36,20,239 ,5 ,789 ,0 ,0 ,1 ,0 ,0 ,0 ,0 ,1 ,0 ,0 ,0 ,0,14529 , 0 
28561.36,16,239 ,2 ,512 ,0 ,0 ,1 ,0 ,0 ,0 ,0 ,1 ,0 ,2 ,0 ,2,33439 , 1 
28561.444,10,239 ,14 ,515 ,0 ,0 ,1 ,0 ,0 ,0 ,0 ,1 ,0 ,2 ,0 ,2,15529 , 0 
28561.482,12,239 ,18 ,795 ,0 ,0 ,1 ,0 ,0 ,0 ,0 ,1 ,0 ,1 ,0 ,1,16054 , 0 
28561.596,9,239 ,5 ,789 ,0 ,0 ,1 ,0 ,0 ,0 ,0 ,1 ,0 ,1 ,0 ,1,28095 , 0 
28561.603,5,239 ,13 ,512 ,0 ,0 ,1 ,0 ,0 ,0 ,0 ,1 ,0 ,2 ,0 ,2,25107 , 0 
28561.606,19,239 ,1 ,256 ,0 ,0 ,1 ,0 ,0 ,0 ,0 ,1 ,0 ,1 ,0 ,1,16662 , 0 
28561.696,17,239 ,6 ,768 ,0 ,0 ,1 ,1 ,0 ,0 ,0 ,2 ,0 ,3 ,0 ,3,20989 , 0 
28561.771,13,239 ,1 ,256 ,0 ,0 ,0 ,0 ,0 ,0 ,0 ,0 ,0 ,1 ,0 ,1,14861 , 0 
28561.787,3,239 ,1 ,256 ,0 ,0 ,1 ,0 ,0 ,0 ,0 ,1 ,0 ,1 ,0 ,1,10221 , 0 
28680.96,8,239 ,1 ,256 ,0 ,0 ,2 ,0 ,0 ,0 ,0 ,2 ,0 ,1 ,0 ,1,11571 , 0 
28681.078,11,239 ,20 ,1085 ,0 ,0 ,1 ,0 ,0 ,0 ,0 ,1 ,0 ,5 ,0 ,5,19496 , 0 
28681.123,2,239 ,1 ,256 ,0 ,0 ,1 ,0 ,0 ,0 ,0 ,1 ,0 ,3 ,0 ,3,20446 , 0 
28681.138,6,239 ,2 ,512 ,0 ,0 ,1 ,0 ,0 ,0 ,0 ,1 ,0 ,1 ,0 ,1,26341 , 0 
28681.214,18,239 ,19 ,512 ,0 ,0 ,1 ,0 ,0 ,0 ,0 ,1 ,0 ,1 ,0 ,1,16147 , 0 
28681.236,4,239 ,8 ,521 ,0 ,0 ,2 ,0 ,0 ,0 ,0 ,2 ,0 ,1 ,0 ,1,13955 , 0 
28681.289,7,239 ,9 ,1045 ,0 ,0 ,1 ,1 ,0 ,0 ,0 ,2 ,0 ,3 ,0 ,3,23663 , 0 
28681.337,14,239 ,1 ,256 ,0 ,0 ,1 ,0 ,0 ,0 ,0 ,1 ,0 ,2 ,0 ,2,14040 , 0 
28681.35,15,239 ,9 ,1045 ,0 ,0 ,2 ,0 ,0 ,0 ,0 ,2 ,0 ,2 ,0 ,2,18325 , 0 
28681.36,20,239 ,5 ,789 ,0 ,0 ,3 ,0 ,0 ,0 ,0 ,3 ,0 ,2 ,0 ,2,15748 , 0 
28681.36,16,239 ,2 ,512 ,0 ,0 ,1 ,0 ,0 ,0 ,0 ,1 ,0 ,3 ,0 ,3,31729 , 1 
28681.444,10,239 ,14 ,515 ,0 ,0 ,1 ,0 ,0 ,0 ,0 ,1 ,0 ,0 ,0 ,0,14524 , 0 
28681.482,12,239 ,18 ,795 ,0 ,0 ,1 ,0 ,0 ,0 ,0 ,1 ,0 ,3 ,0 ,3,16867 , 0 
28681.596,9,239 ,5 ,789 ,0 ,0 ,2 ,0 ,1 ,0 ,0 ,3 ,0 ,2 ,1 ,3,27770 , 0 
28681.602,5,239 ,13 ,512 ,0 ,0 ,1 ,0 ,1 ,0 ,0 ,2 ,0 ,4 ,1 ,5,26019 , 0 
28681.606,19,239 ,1 ,256 ,0 ,0 ,1 ,0 ,0 ,0 ,0 ,1 ,0 ,6 ,0 ,6,17074 , 0 
28681.696,17,239 ,6 ,768 ,0 ,0 ,1 ,0 ,0 ,0 ,0 ,1 ,0 ,1 ,0 ,1,20910 , 0 
28681.771,13,239 ,1 ,256 ,0 ,0 ,2 ,0 ,1 ,0 ,0 ,3 ,0 ,1 ,1 ,2,14956 , 0 
28681.787,3,239 ,1 ,256 ,0 ,0 ,0 ,0 ,0 ,0 ,0 ,0 ,0 ,1 ,0 ,1,10507 , 0 
28800.96,8,239 ,1 ,256 ,0 ,0 ,1 ,0 ,0 ,0 ,0 ,1 ,0 ,1 ,0 ,1,11959 , 0 
28801.078,11,239 ,20 ,1085 ,0 ,0 ,1 ,0 ,0 ,0 ,0 ,1 ,0 ,2 ,0 ,2,18763 , 0 
28801.123,2,239 ,1 ,256 ,0 ,0 ,2 ,0 ,2 ,0 ,0 ,4 ,0 ,1 ,2 ,3,22108 , 0 
28801.138,6,239 ,2 ,512 ,0 ,0 ,1 ,1 ,0 ,0 ,0 ,2 ,0 ,1 ,0 ,1,30436 , 0 
28801.214,18,239 ,19 ,512 ,0 ,0 ,1 ,1 ,0 ,0 ,0 ,2 ,0 ,4 ,0 ,4,15379 , 0 
28801.236,4,239 ,8 ,521 ,0 ,0 ,1 ,0 ,0 ,0 ,0 ,1 ,0 ,0 ,0 ,0,13503 , 0 
28801.289,7,239 ,9 ,1045 ,0 ,0 ,2 ,0 ,0 ,0 ,0 ,2 ,0 ,1 ,0 ,1,24054 , 0 
28801.337,14,239 ,1 ,256 ,0 ,0 ,1 ,0 ,0 ,0 ,0 ,1 ,0 ,5 ,0 ,5,13672 , 0 
28801.35,15,239 ,9 ,1070 ,0 ,0 ,1 ,1 ,0 ,0 ,0 ,2 ,0 ,1 ,0 ,1,17581 , 0 
28801.36,20,239 ,5 ,789 ,0 ,0 ,0 ,0 ,0 ,0 ,0 ,0 ,0 ,1 ,0 ,1,14602 , 0 
28801.36,16,239 ,2 ,512 ,0 ,0 ,0 ,1 ,0 ,0 ,0 ,1 ,0 ,2 ,0 ,2,33510 , 1 
28801.444,10,239 ,14 ,515 ,0 ,0 ,1 ,0 ,0 ,0 ,0 ,1 ,0 ,1 ,0 ,1,15594 , 0 
28801.482,12,239 ,18 ,795 ,0 ,0 ,2 ,0 ,0 ,0 ,0 ,2 ,0 ,0 ,0 ,0,16133 , 0 
28801.596,9,239 ,5 ,789 ,0 ,0 ,1 ,0 ,1 ,0 ,0 ,2 ,0 ,1 ,1 ,2,28187 , 0 
28801.603,5,239 ,13 ,512 ,0 ,0 ,2 ,0 ,1 ,0 ,0 ,3 ,0 ,2 ,1 ,3,25200 , 0 
28801.606,19,239 ,1 ,256 ,0 ,0 ,1 ,0 ,1 ,0 ,0 ,2 ,0 ,3 ,1 ,4,16739 , 0 
28801.696,17,239 ,6 ,768 ,0 ,0 ,1 ,0 ,0 ,0 ,0 ,1 ,0 ,2 ,0 ,2,21056 , 0 
28801.771,13,239 ,1 ,256 ,0 ,0 ,1 ,0 ,1 ,0 ,0 ,2 ,0 ,1 ,1 ,2,14937 , 0 
28801.787,3,239 ,1 ,256 ,0 ,0 ,2 ,0 ,0 ,0 ,0 ,2 ,0 ,2 ,0 ,2,10295 , 0 
28920.96,8,239 ,1 ,256 ,0 ,0 ,1 ,1 ,1 ,0 ,0 ,3 ,0 ,3 ,1 ,4,11631 , 0 
28921.078,11,239 ,20 ,1085 ,0 ,0 ,1 ,0 ,0 ,0 ,0 ,1 ,0 ,2 ,0 ,2,19558 , 0 
28921.123,2,239 ,1 ,256 ,0 ,0 ,1 ,1 ,0 ,0 ,0 ,2 ,0 ,1 ,0 ,1,20533 , 0 
28921.138,6,239 ,2 ,512 ,0 ,0 ,1 ,0 ,0 ,0 ,0 ,1 ,0 ,2 ,0 ,2,26404 , 0 
28921.214,18,239 ,19 ,512 ,0 ,0 ,2 ,1 ,0 ,0 ,0 ,3 ,0 ,1 ,0 ,1,16215 , 0 
28921.236,4,239 ,8 ,518 ,0 ,0 ,1 ,1 ,0 ,0 ,0 ,2 ,0 ,3 ,0 ,3,14023 , 0 
28921.289,7,239 ,9 ,1093 ,0 ,0 ,1 ,1 ,0 ,0 ,0 ,2 ,0 ,2 ,0 ,2,23739 , 0 
28921.337,14,239 ,1 ,256 ,0 ,0 ,1 ,1 ,0 ,0 ,0 ,2 ,0 ,2 ,0 ,2,14116 , 0 
28921.35,15,239 ,9 ,1070 ,0 ,0 ,1 ,0 ,0 ,0 ,0 ,1 ,0 ,1 ,0 ,1,18398 , 0 
28921.36,20,239 ,5 ,789 ,0 ,0 ,1 ,0 ,0 ,0 ,0 ,1 ,0 ,0 ,0 ,0,15822 , 0 
28921.36,16,239 ,2 ,512 ,0 ,0 ,2 ,0 ,0 ,0 ,0 ,2 ,0 ,1 ,0 ,1,31805 , 0 
28921.444,10,239 ,14 ,515 ,0 ,0 ,1 ,0 ,0 ,0 ,0 ,1 ,0 ,0 ,0 ,0,14579 , 0 
28921.482,12,239 ,18 ,795 ,0 ,0 ,2 ,0 ,0 ,0 ,0 ,2 ,0 ,1 ,0 ,1,16936 , 0 
28921.596,9,239 ,5 ,789 ,0 ,0 ,1 ,0 ,1 ,0 ,0 ,2 ,0 ,1 ,1 ,2,27835 , 0 
28921.602,5,239 ,13 ,512 ,0 ,0 ,0 ,1 ,1 ,0 ,0 ,2 ,0 ,4 ,1 ,5,26109 , 0 
28921.606,19,239 ,1 ,256 ,0 ,0 ,1 ,1 ,1 ,0 ,0 ,3 ,0 ,3 ,1 ,4,17153 , 0 
28921.696,17,239 ,6 ,768 ,0 ,0 ,2 ,0 ,0 ,0 ,0 ,2 ,0 ,0 ,0 ,0,21000 , 0 
28921.771,13,239 ,1 ,256 ,0 ,0 ,1 ,1 ,2 ,0 ,0 ,4 ,0 ,2 ,2 ,4,15029 , 0 
28921.787,3,239 ,1 ,256 ,0 ,0 ,2 ,1 ,0 ,0 ,0 ,3 ,0 ,1 ,0 ,1,10576 , 0 
29040.96,8,239 ,1 ,256 ,0 ,0 ,1 ,0 ,0 ,0 ,0 ,1 ,0 ,0 ,0 ,0,12040 , 0 
29041.078,11,239 ,20 ,1085 ,0 ,0 ,1 ,0 ,0 ,0 ,0 ,1 ,0 ,0 ,0 ,0,18840 , 0 
29041.123,2,239 ,1 ,256 ,0 ,0 ,1 ,0 ,2 ,0 ,0 ,3 ,0 ,1 ,2 ,3,22187 , 0 
29041.138,6,239 ,2 ,512 ,0 ,0 ,2 ,0 ,1 ,0 ,0 ,3 ,0 ,1 ,1 ,2,30518 , 0 
29041.214,18,239 ,19 ,512 ,0 ,0 ,0 ,0 ,0 ,0 ,0 ,0 ,0 ,2 ,0 ,2,15443 , 0 
29041.236,4,239 ,8 ,518 ,0 ,0 ,1 ,0 ,0 ,0 ,0 ,1 ,0 ,1 ,0 ,1,13577 , 0 
29041.289,7,239 ,16 ,774 ,0 ,0 ,4 ,1 ,0 ,1 ,0 ,6 ,0 ,1 ,0 ,1,24173 , 0 
29041.337,14,239 ,1 ,256 ,0 ,0 ,1 ,0 ,1 ,0 ,0 ,2 ,0 ,2 ,1 ,3,13758 , 0 
29041.35,15,239 ,9 ,1070 ,0 ,0 ,1 ,0 ,0 ,0 ,0 ,1 ,0 ,2 ,0 ,2,17641 , 0 
29041.36,20,239 ,5 ,789 ,0 ,0 ,1 ,0 ,0 ,0 ,0 ,1 ,0 ,0 ,0 ,0,14672 , 0 
29041.36,16,239 ,2 ,512 ,0 ,0 ,1 ,0 ,1 ,0 ,0 ,2 ,0 ,7 ,1 ,8,33601 , 0 
29041.444,10,239 ,14 ,512 ,0 ,0 ,1 ,1 ,0 ,0 ,0 ,2 ,0 ,3 ,0 ,3,15661 , 0 
29041.482,12,239 ,18 ,795 ,0 ,0 ,1 ,0 ,0 ,0 ,0 ,1 ,0 ,2 ,0 ,2,16220 , 0 
29041.596,9,239 ,5 ,789 ,0 ,0 ,1 ,0 ,0 ,0 ,1 ,2 ,0 ,4 ,1 ,5,28301 , 0 
29041.603,5,239 ,13 ,512 ,0 ,0 ,1 ,0 ,0 ,0 ,1 ,2 ,0 ,2 ,1 ,3,25315 , 0 
29041.606,19,239 ,1 ,256 ,0 ,0 ,2 ,0 ,0 ,0 ,0 ,2 ,0 ,1 ,0 ,1,16827 , 0 
29041.696,17,239 ,6 ,768 ,0 ,0 ,1 ,1 ,0 ,0 ,0 ,2 ,0 ,4 ,0 ,4,21118 , 0 
29041.771,13,239 ,1 ,256 ,0 ,0 ,1 ,0 ,0 ,0 ,1 ,2 ,0 ,1 ,1 ,2,15026 , 0 
29041.787,3,239 ,1 ,256 ,0 ,0 ,1 ,0 ,0 ,0 ,0 ,1 ,0 ,0 ,0 ,0,10349 , 0 
29160.96,8,239 ,1 ,256 ,0 ,0 ,1 ,0 ,0 ,0 ,0 ,1 ,0 ,1 ,0 ,1,11703 , 0 
29161.078,11,239 ,20 ,1085 ,0 ,0 ,0 ,0 ,0 ,0 ,0 ,0 ,0 ,0 ,0 ,0,19614 , 0 
29161.123,2,239 ,1 ,256 ,0 ,0 ,1 ,0 ,1 ,0 ,0 ,2 ,0 ,1 ,1 ,2,20608 , 0 
29161.138,6,239 ,2 ,512 ,0 ,0 ,1 ,0 ,1 ,0 ,0 ,2 ,0 ,1 ,1 ,2,26467 , 0 
29161.214,18,239 ,19 ,512 ,0 ,0 ,1 ,0 ,1 ,0 ,0 ,2 ,0 ,1 ,1 ,2,16309 , 0 
29161.236,4,239 ,8 ,515 ,0 ,0 ,1 ,0 ,0 ,0 ,0 ,1 ,0 ,1 ,0 ,1,14096 , 0 
29161.289,7,239 ,16 ,774 ,0 ,0 ,3 ,0 ,0 ,0 ,0 ,3 ,0 ,2 ,0 ,2,23809 , 0 
29161.337,14,239 ,1 ,256 ,0 ,0 ,2 ,0 ,0 ,0 ,0 ,2 ,0 ,2 ,0 ,2,14188 , 0 
29161.35,15,239 ,9 ,1070 ,0 ,0 ,1 ,0 ,0 ,0 ,0 ,1 ,0 ,3 ,0 ,3,18466 , 0 
29161.36,20,239 ,5 ,789 ,0 ,0 ,2 ,0 ,0 ,0 ,0 ,2 ,0 ,1 ,0 ,1,15877 , 0 
29161.36,16,239 ,2 ,512 ,0 ,0 ,1 ,0 ,0 ,0 ,0 ,1 ,0 ,2 ,0 ,2,31862 , 0 
29161.444,10,239 ,14 ,512 ,0 ,0 ,2 ,0 ,0 ,0 ,0 ,2 ,0 ,0 ,0 ,0,14641 , 0 
29161.482,12,239 ,18 ,777 ,0 ,0 ,1 ,1 ,0 ,0 ,0 ,2 ,0 ,2 ,0 ,2,17023 , 0 
29161.596,9,239 ,5 ,789 ,0 ,0 ,0 ,0 ,0 ,1 ,0 ,1 ,0 ,2 ,0 ,2,27907 , 0 
29161.603,5,239 ,13 ,512 ,0 ,0 ,1 ,0 ,0 ,1 ,0 ,2 ,0 ,3 ,1 ,4,26211 , 0 
29161.606,19,239 ,1 ,256 ,0 ,0 ,1 ,0 ,1 ,0 ,0 ,2 ,0 ,1 ,1 ,2,17241 , 0 
29161.696,17,239 ,6 ,768 ,0 ,0 ,1 ,1 ,0 ,0 ,0 ,2 ,0 ,4 ,0 ,4,21059 , 0 
29161.771,13,239 ,1 ,256 ,0 ,0 ,1 ,0 ,0 ,1 ,0 ,2 ,0 ,1 ,1 ,2,15116 , 0 
29161.787,3,239 ,1 ,256 ,0 ,0 ,1 ,0 ,0 ,0 ,0 ,1 ,0 ,1 ,0 ,1,10639 , 0 
29280.96,8,0 ,1 ,256 ,0 ,0 ,8 ,6 ,1 ,4 ,2 ,21 ,0 ,22 ,3 ,25,12214 , 0 
29281.078,11,3 ,9 ,1101 ,0 ,0 ,12 ,2 ,0 ,4 ,0 ,18 ,0 ,37 ,4 ,41,19122 , 0 
29281.124,2,3 ,1 ,256 ,0 ,0 ,11 ,5 ,4 ,6 ,5 ,31 ,0 ,38 ,15 ,53,22496 , 0 
29281.138,6,5 ,2 ,512 ,0 ,0 ,11 ,3 ,1 ,5 ,1 ,21 ,0 ,26 ,4 ,30,30915 , 0 
29281.214,18,0 ,19 ,512 ,0 ,0 ,11 ,3 ,0 ,7 ,0 ,21 ,0 ,23 ,1 ,24,15747 , 0 
29281.236,4,0 ,19 ,512 ,0 ,0 ,8 ,3 ,1 ,5 ,1 ,18 ,0 ,21 ,3 ,24,13920 , 0 
29281.29,7,8 ,16 ,65535 ,0 ,0 ,13 ,0 ,2 ,1 ,0 ,16 ,0 ,25 ,9 ,34,24464 , 1 
29281.338,14,0 ,1 ,256 ,0 ,0 ,10 ,6 ,3 ,7 ,3 ,29 ,0 ,24 ,9 ,33,14031 , 0 
29281.35,15,5 ,7 ,1207 ,0 ,0 ,12 ,1 ,0 ,2 ,0 ,15 ,0 ,25 ,2 ,27,17864 , 0 
29281.36,20,0 ,5 ,768 ,0 ,0 ,9 ,2 ,2 ,8 ,1 ,22 ,0 ,20 ,4 ,24,15098 , 0 
29281.36,16,5 ,2 ,512 ,0 ,0 ,11 ,2 ,0 ,3 ,0 ,16 ,0 ,28 ,7 ,35,33896 , 0 
29281.444,10,3 ,6 ,998 ,0 ,0 ,10 ,4 ,0 ,5 ,0 ,19 ,0 ,16 ,0 ,16,15876 , 0 
29281.482,12,0 ,20 ,1024 ,0 ,0 ,9 ,4 ,0 ,5 ,0 ,18 ,0 ,27 ,2 ,29,16560 , 0 
29281.607,19,0 ,1 ,256 ,0 ,0 ,10 ,5 ,4 ,6 ,2 ,27 ,0 ,35 ,11 ,46,17115 , 0 
29281.607,5,3 ,13 ,512 ,0 ,0 ,11 ,3 ,4 ,8 ,4 ,30 ,0 ,40 ,16 ,56,25727 , 0 
29281.669,9,5 ,16 ,773 ,0 ,0 ,13 ,1 ,0 ,3 ,1 ,18 ,0 ,31 ,3 ,34,28574 , 0 
29281.697,17,7 ,7 ,1207 ,0 ,0 ,10 ,1 ,0 ,2 ,0 ,13 ,0 ,26 ,0 ,26,21387 , 0 
29281.771,13,3 ,1 ,256 ,0 ,0 ,9 ,6 ,5 ,9 ,4 ,33 ,0 ,27 ,11 ,38,15295 , 0 
29281.787,3,0 ,1 ,256 ,0 ,0 ,9 ,6 ,0 ,5 ,0 ,20 ,0 ,20 ,0 ,20,10585 , 0 
29400.961,8,40 ,1 ,256 ,0 ,0 ,16 ,10 ,2 ,12 ,0 ,40 ,0 ,48 ,7 ,55,12027 , 0 
29401.078,11,40 ,5 ,980 ,0 ,0 ,21 ,4 ,1 ,2 ,1 ,29 ,0 ,55 ,3 ,58,20013 , 0 
29401.124,2,40 ,1 ,256 ,0 ,0 ,21 ,6 ,11 ,12 ,2 ,52 ,0 ,71 ,17 ,88,21147 , 0 
29401.138,6,40 ,2 ,537 ,0 ,0 ,21 ,3 ,3 ,3 ,0 ,30 ,0 ,48 ,8 ,56,26892 , 0 
29401.214,18,40 ,5 ,980 ,0 ,0 ,18 ,5 ,4 ,9 ,2 ,38 ,0 ,45 ,10 ,55,16794 , 0 
29401.236,4,40 ,18 ,1536 ,0 ,0 ,18 ,9 ,1 ,14 ,0 ,42 ,0 ,37 ,4 ,41,14751 , 0 
29401.29,7,44 ,16 ,65535 ,0 ,0 ,18 ,0 ,0 ,0 ,0 ,18 ,0 ,36 ,0 ,36,24009 , 1 
29401.338,14,40 ,1 ,256 ,0 ,0 ,18 ,7 ,2 ,10 ,0 ,37 ,0 ,54 ,6 ,60,14495 , 0 
29401.35,15,40 ,0 ,0 ,0 ,0 ,19 ,0 ,0 ,1 ,0 ,20 ,0 ,41 ,0 ,41,18696 , 0 
29401.36,20,40 ,5 ,980 ,0 ,0 ,21 ,6 ,1 ,6 ,0 ,34 ,0 ,42 ,2 ,44,16348 , 0 
29401.361,16,40 ,6 ,818 ,0 ,0 ,19 ,2 ,0 ,1 ,0 ,22 ,0 ,48 ,1 ,49,32167 , 0 
29401.444,10,40 ,14 ,512 ,0 ,0 ,16 ,3 ,0 ,5 ,0 ,24 ,0 ,28 ,0 ,28,14940 , 0 
29401.482,12,40 ,5 ,980 ,0 ,0 ,19 ,5 ,1 ,8 ,0 ,33 ,0 ,50 ,3 ,53,17515 , 0 
29401.596,9,40 ,5 ,1024 ,0 ,0 ,20 ,2 ,0 ,2 ,0 ,24 ,0 ,59 ,1 ,60,28311 , 0 
29401.603,5,40 ,2 ,512 ,0 ,0 ,20 ,2 ,9 ,5 ,2 ,38 ,0 ,76 ,23 ,99,26764 , 0 
29401.607,19,40 ,1 ,256 ,0 ,0 ,19 ,7 ,12 ,13 ,6 ,57 ,0 ,77 ,31 ,108,17663 , 0 
29401.697,17,40 ,6 ,892 ,0 ,0 ,16 ,2 ,0 ,1 ,0 ,19 ,0 ,32 ,0 ,32,21301 , 0 
29401.772,13,40 ,1 ,256 ,0 ,0 ,18 ,6 ,0 ,9 ,0 ,33 ,0 ,53 ,0 ,53,15416 , 0 
29401.787,3,40 ,1 ,256 ,0 ,0 ,16 ,11 ,2 ,13 ,3 ,45 ,0 ,33 ,6 ,39,10930 , 0 
29520.994,8,80 ,1 ,256 ,0 ,0 ,14 ,7 ,0 ,9 ,0 ,30 ,0 ,42 ,0 ,42,12470 , 0 
29521.078,11,81 ,9 ,2192 ,0 ,0 ,19 ,1 ,0 ,2 ,0 ,22 ,0 ,63 ,2 ,65,19439 , 0 
29521.124,2,81 ,1 ,256 ,0 ,0 ,17 ,5 ,10 ,10 ,7 ,49 ,0 ,63 ,19 ,82,22862 , 0 
29521.138,6,81 ,2 ,512 ,0 ,0 ,18 ,3 ,3 ,3 ,2 ,29 ,0 ,51 ,6 ,57,31320 , 0 
29521.214,18,79 ,18 ,0 ,0 ,0 ,22 ,5 ,0 ,11 ,1 ,39 ,0 ,45 ,3 ,48,16362 , 0 
29521.236,4,79 ,0 ,0 ,0 ,0 ,16 ,7 ,0 ,8 ,0 ,31 ,0 ,31 ,0 ,31,14343 , 0 
29521.29,7,84 ,16 ,65535 ,0 ,0 ,20 ,0 ,0 ,0 ,0 ,20 ,0 ,47 ,0 ,47,24683 , 1 
29521.338,14,80 ,1 ,256 ,0 ,0 ,12 ,8 ,3 ,8 ,3 ,34 ,0 ,46 ,7 ,53,14318 , 0 
29521.35,15,81 ,9 ,2192 ,0 ,0 ,20 ,3 ,0 ,4 ,0 ,27 ,0 ,50 ,0 ,50,18296 , 0 
29521.36,20,79 ,12 ,1231 ,0 ,0 ,17 ,1 ,0 ,4 ,0 ,22 ,0 ,36 ,0 ,36,15484 , 0 
29521.361,16,81 ,2 ,512 ,0 ,0 ,20 ,2 ,1 ,4 ,0 ,27 ,0 ,51 ,5 ,56,34269 , 0 
29521.444,10,81 ,14 ,512 ,0 ,0 ,15 ,3 ,0 ,5 ,0 ,23 ,0 ,23 ,0 ,23,16151 , 0 
29521.482,12,79 ,18 ,768 ,0 ,0 ,17 ,2 ,0 ,4 ,0 ,23 ,0 ,39 ,0 ,39,16893 , 0 
29521.596,9,83 ,16 ,1729 ,0 ,0 ,19 ,1 ,1 ,2 ,1 ,24 ,0 ,59 ,5 ,64,28915 , 0 
29521.603,5,80 ,19 ,512 ,0 ,0 ,21 ,2 ,3 ,7 ,2 ,35 ,0 ,88 ,13 ,101,26282 , 0 
29521.607,19,80 ,1 ,256 ,0 ,0 ,17 ,6 ,8 ,9 ,3 ,43 ,0 ,61 ,29 ,90,17516 , 0 
29521.697,17,83 ,16 ,1355 ,0 ,0 ,19 ,1 ,0 ,2 ,0 ,22 ,0 ,49 ,0 ,49,21619 , 0 
29521.772,13,80 ,1 ,256 ,0 ,0 ,16 ,4 ,0 ,8 ,0 ,28 ,0 ,47 ,2 ,49,15624 , 0 
29521.787,3,80 ,1 ,256 ,0 ,0 ,15 ,11 ,1 ,9 ,1 ,37 ,0 ,25 ,3 ,28,10856 , 0 
29640.96,8,86 ,1 ,256 ,0 ,0 ,6 ,5 ,0 ,3 ,0 ,14 ,0 ,16 ,0 ,16,12156 , 0 
29641.078,11,86 ,12 ,1518 ,0 ,0 ,15 ,6 ,1 ,5 ,1 ,28 ,0 ,29 ,6 ,35,20487 , 0 
29641.124,2,86 ,1 ,256 ,0 ,0 ,8 ,2 ,17 ,2 ,2 ,31 ,0 ,26 ,23 ,49,21465 , 0 
29641.138,6,86 ,2 ,557 ,0 ,0 ,7 ,4 ,15 ,1 ,3 ,30 ,0 ,21 ,23 ,44,27525 , 0 
29641.214,18,86 ,5 ,889 ,0 ,0 ,9 ,5 ,0 ,3 ,0 ,17 ,0 ,23 ,0 ,23,17129 , 0 
29641.236,4,86 ,19 ,586 ,0 ,0 ,7 ,5 ,0 ,2 ,1 ,15 ,0 ,12 ,1 ,13,14958 , 0 
29641.29,7,86 ,17 ,1799 ,0 ,0 ,14 ,5 ,6 ,6 ,0 ,31 ,0 ,25 ,8 ,33,24662 , 0 
29641.338,14,86 ,1 ,256 ,0 ,0 ,7 ,3 ,2 ,3 ,1 ,16 ,0 ,18 ,4 ,22,14734 , 0 
29641.35,15,86 ,7 ,1867 ,0 ,0 ,14 ,8 ,1 ,4 ,1 ,28 ,0 ,24 ,2 ,26,19120 , 0 
29641.36,20,86 ,12 ,1518 ,0 ,0 ,11 ,4 ,2 ,2 ,2 ,21 ,0 ,20 ,5 ,25,16626 , 0 
29641.361,16,86 ,6 ,768 ,0 ,0 ,13 ,4 ,8 ,4 ,3 ,32 ,0 ,25 ,12 ,37,32655 , 0 
29641.444,10,86 ,14 ,512 ,0 ,0 ,11 ,4 ,0 ,4 ,0 ,19 ,0 ,7 ,0 ,7,15295 , 0 
29641.482,12,86 ,5 ,884 ,0 ,0 ,12 ,3 ,7 ,3 ,2 ,27 ,0 ,28 ,9 ,37,18004 , 0 
29641.596,9,86 ,5 ,768 ,0 ,0 ,11 ,4 ,2 ,1 ,0 ,18 ,0 ,37 ,4 ,41,28727 , 0 
29641.603,5,86 ,19 ,586 ,0 ,0 ,8 ,3 ,11 ,2 ,2 ,26 ,0 ,33 ,13 ,46,27148 , 0 
29641.607,19,86 ,1 ,256 ,0 ,0 ,7 ,4 ,19 ,2 ,4 ,36 ,0 ,23 ,28 ,51,18010 , 0 
29641.697,17,86 ,6 ,1299 ,0 ,0 ,10 ,3 ,11 ,2 ,2 ,28 ,0 ,23 ,15 ,38,21817 , 0 
29641.771,13,86 ,1 ,256 ,0 ,0 ,7 ,5 ,0 ,2 ,0 ,14 ,0 ,20 ,0 ,20,15568 , 0 
29641.787,3,86 ,1 ,256 ,0 ,0 ,7 ,4 ,0 ,3 ,0 ,14 ,0 ,13 ,0 ,13,11082 , 0 
29760.96,8,86 ,1 ,256 ,0 ,0 ,2 ,1 ,0 ,0 ,0 ,3 ,0 ,7 ,0 ,7,12572 , 0 
29761.078,11,86 ,12 ,1368 ,0 ,0 ,2 ,1 ,0 ,1 ,0 ,4 ,0 ,5 ,0 ,5,19533 , 0 
29761.124,2,86 ,1 ,256 ,0 ,0 ,2 ,2 ,6 ,0 ,0 ,10 ,0 ,10 ,6 ,16,22955 , 0 
29761.138,6,86 ,2 ,517 ,0 ,0 ,2 ,1 ,5 ,0 ,0 ,8 ,0 ,6 ,7 ,13,31452 , 0 
29761.214,18,86 ,5 ,794 ,0 ,0 ,1 ,2 ,0 ,0 ,0 ,3 ,0 ,8 ,0 ,8,16449 , 0 
29761.236,4,86 ,19 ,541 ,0 ,0 ,2 ,2 ,0 ,0 ,0 ,4 ,0 ,4 ,0 ,4,14416 , 0 
29761.289,7,86 ,17 ,1261 ,0 ,0 ,3 ,2 ,2 ,0 ,0 ,7 ,0 ,5 ,2 ,7,24775 , 0 
29761.337,14,86 ,1 ,256 ,0 ,0 ,2 ,1 ,1 ,0 ,0 ,4 ,0 ,8 ,1 ,9,14399 , 0 
29761.35,15,86 ,7 ,1413 ,0 ,0 ,2 ,2 ,0 ,0 ,0 ,4 ,0 ,5 ,0 ,5,18377 , 0 
29761.36,20,86 ,12 ,1368 ,0 ,0 ,2 ,1 ,0 ,2 ,0 ,5 ,0 ,5 ,0 ,5,15584 , 0 
29761.36,16,86 ,6 ,768 ,0 ,0 ,4 ,0 ,0 ,1 ,0 ,5 ,0 ,5 ,0 ,5,34492 , 0 
29761.444,10,86 ,14 ,571 ,0 ,0 ,3 ,1 ,0 ,0 ,0 ,4 ,0 ,3 ,0 ,3,16254 , 0 
29761.482,12,86 ,5 ,794 ,0 ,0 ,2 ,2 ,2 ,1 ,0 ,7 ,0 ,5 ,5 ,10,17004 , 0 
29761.596,9,86 ,5 ,794 ,0 ,0 ,1 ,2 ,0 ,0 ,0 ,3 ,0 ,8 ,0 ,8,29029 , 0 
29761.603,5,86 ,19 ,541 ,0 ,0 ,4 ,2 ,8 ,1 ,0 ,15 ,0 ,10 ,9 ,19,26526 , 0 
29761.607,19,86 ,1 ,256 ,0 ,0 ,3 ,1 ,12 ,1 ,0 ,17 ,0 ,11 ,13 ,24,17645 , 0 
29761.696,17,86 ,6 ,923 ,0 ,0 ,2 ,1 ,4 ,1 ,0 ,8 ,0 ,5 ,4 ,9,21718 , 0 
29761.771,13,86 ,1 ,256 ,0 ,0 ,3 ,1 ,0 ,0 ,0 ,4 ,0 ,9 ,0 ,9,15730 , 0 
29761.787,3,86 ,1 ,256 ,0 ,0 ,2 ,1 ,0 ,0 ,0 ,3 ,0 ,2 ,0 ,2,10924 , 0 
29880.96,8,86 ,1 ,256 ,0 ,0 ,3 ,0 ,1 ,0 ,0 ,4 ,0 ,7 ,1 ,8,12234 , 0 
29881.078,11,86 ,12 ,1211 ,0 ,0 ,2 ,1 ,0 ,0 ,0 ,3 ,0 ,7 ,0 ,7,20565 , 0 
29881.123,2,86 ,1 ,256 ,0 ,0 ,2 ,0 ,6 ,0 ,0 ,8 ,0 ,3 ,6 ,9,21553 , 0 
29881.138,6,86 ,2 ,512 ,0 ,0 ,2 ,1 ,5 ,0 ,0 ,8 ,0 ,4 ,5 ,9,27639 , 0 
29881.214,18,86 ,5 ,794 ,0 ,0 ,2 ,0 ,0 ,0 ,0 ,2 ,0 ,7 ,0 ,7,17206 , 0 
29881.236,4,86 ,8 ,512 ,0 ,0 ,7 ,1 ,0 ,1 ,0 ,9 ,0 ,3 ,0 ,3,15104 , 0 
29881.289,7,86 ,17 ,1181 ,0 ,0 ,2 ,1 ,1 ,0 ,0 ,4 ,0 ,5 ,1 ,6,24735 , 0 
29881.337,14,86 ,1 ,256 ,0 ,0 ,2 ,0 ,1 ,0 ,0 ,3 ,0 ,4 ,1 ,5,14811 , 0 
29881.35,15,86 ,7 ,1335 ,0 ,0 ,2 ,1 ,0 ,0 ,0 ,3 ,0 ,3 ,0 ,3,19192 , 0 
29881.36,20,86 ,12 ,1211 ,0 ,0 ,2 ,1 ,0 ,0 ,0 ,3 ,0 ,2 ,0 ,2,16707 , 0 
29881.36,16,86 ,6 ,860 ,0 ,0 ,1 ,1 ,0 ,0 ,0 ,2 ,0 ,6 ,0 ,6,32742 , 0 
29881.444,10,86 ,14 ,559 ,0 ,0 ,1 ,1 ,0 ,0 ,0 ,2 ,0 ,2 ,0 ,2,15352 , 0 
29881.482,12,86 ,5 ,794 ,0 ,0 ,2 ,0 ,2 ,0 ,0 ,4 ,0 ,3 ,2 ,5,18089 , 0 
29881.596,9,86 ,5 ,794 ,0 ,0 ,3 ,0 ,0 ,0 ,0 ,3 ,0 ,4 ,0 ,4,28798 , 0 
29881.602,5,86 ,19 ,541 ,0 ,0 ,0 ,0 ,2 ,0 ,0 ,2 ,0 ,7 ,2 ,9,27227 , 0 
29881.606,19,86 ,1 ,256 ,0 ,0 ,1 ,0 ,2 ,1 ,1 ,5 ,0 ,9 ,3 ,12,18098 , 0 
29881.696,17,86 ,6 ,818 ,0 ,0 ,2 ,2 ,2 ,0 ,0 ,6 ,0 ,4 ,2 ,6,21914 , 0 
29881.771,13,86 ,1 ,256 ,0 ,0 ,1 ,0 ,0 ,0 ,0 ,1 ,0 ,3 ,0 ,3,15659 , 0 
29881.787,3,86 ,1 ,256 ,0 ,0 ,3 ,0 ,0 ,0 ,0 ,3 ,0 ,4 ,0 ,4,11149 , 0 
30000.96,8,86 ,1 ,256 ,0 ,0 ,1 ,1 ,0 ,0 ,0 ,2 ,0 ,4 ,0 ,4,12640 , 0 
30001.078,11,86 ,9 ,300 ,0 ,0 ,3 ,2 ,0 ,1 ,0 ,6 ,0 ,5 ,0 ,5,19670 , 0 
30001.123,2,86 ,1 ,256 ,0 ,0 ,2 ,0 ,3 ,0 ,2 ,7 ,0 ,7 ,5 ,12,23067 , 0 
30001.138,6,86 ,2 ,512 ,0 ,0 ,2 ,1 ,2 ,0 ,2 ,7 ,0 ,5 ,4 ,9,31598 , 0 
30001.236,4,86 ,8 ,512 ,0 ,0 ,2 ,0 ,0 ,0 ,0 ,2 ,0 ,0 ,0 ,0,14477 , 0 
30001.289,7,86 ,17 ,1017 ,0 ,0 ,1 ,2 ,0 ,0 ,0 ,3 ,0 ,9 ,0 ,9,24866 , 0 
30001.337,14,86 ,1 ,256 ,0 ,0 ,1 ,1 ,0 ,0 ,0 ,2 ,0 ,4 ,0 ,4,14481 , 0 
30001.35,15,86 ,7 ,1335 ,0 ,0 ,1 ,0 ,0 ,0 ,0 ,1 ,0 ,6 ,0 ,6,18480 , 0 
30001.35,18,86 ,5 ,768 ,0 ,0 ,1 ,2 ,0 ,0 ,0 ,3 ,0 ,3 ,0 ,3,16549 , 0 
30001.36,20,86 ,12 ,1166 ,0 ,0 ,2 ,1 ,0 ,0 ,0 ,3 ,0 ,5 ,0 ,5,15663 , 0 
30001.36,16,86 ,9 ,300 ,0 ,0 ,3 ,3 ,2 ,1 ,0 ,9 ,0 ,7 ,2 ,9,34677 , 0 
30001.444,10,86 ,14 ,559 ,0 ,0 ,1 ,0 ,0 ,0 ,0 ,1 ,0 ,2 ,0 ,2,16316 , 0 
30001.482,12,86 ,5 ,768 ,0 ,0 ,1 ,2 ,1 ,0 ,1 ,5 ,0 ,6 ,2 ,8,17152 , 0 
30001.596,9,86 ,5 ,596 ,0 ,0 ,3 ,1 ,3 ,1 ,0 ,8 ,0 ,7 ,6 ,13,29257 , 1 
30001.603,5,86 ,13 ,512 ,0 ,0 ,4 ,1 ,8 ,2 ,1 ,16 ,0 ,10 ,11 ,21,26771 , 0 
30001.606,19,86 ,1 ,256 ,0 ,0 ,1 ,1 ,1 ,0 ,1 ,4 ,0 ,8 ,2 ,10,17752 , 0 
30001.696,17,86 ,16 ,607 ,0 ,0 ,3 ,1 ,2 ,1 ,0 ,7 ,0 ,3 ,2 ,5,21849 , 0 
30001.771,13,86 ,1 ,256 ,0 ,0 ,2 ,0 ,8 ,0 ,0 ,10 ,0 ,4 ,8 ,12,15821 , 0 
30001.787,3,86 ,1 ,256 ,0 ,0 ,1 ,1 ,0 ,0 ,0 ,2 ,0 ,1 ,0 ,1,10982 , 0 
30120.96,8,86 ,1 ,256 ,0 ,0 ,2 ,0 ,2 ,0 ,0 ,4 ,0 ,2 ,2 ,4,12341 , 0 
30121.078,11,86 ,9 ,300 ,0 ,0 ,4 ,2 ,0 ,0 ,0 ,6 ,0 ,9 ,0 ,9,20668 , 0 
30121.123,2,86 ,1 ,256 ,0 ,0 ,0 ,0 ,0 ,2 ,0 ,2 ,0 ,7 ,2 ,9,21662 , 0 
30121.138,6,86 ,2 ,512 ,0 ,0 ,1 ,0 ,0 ,2 ,0 ,3 ,0 ,8 ,0 ,8,27730 , 0 
30121.214,18,86 ,5 ,895 ,0 ,0 ,2 ,3 ,0 ,0 ,0 ,5 ,0 ,5 ,0 ,5,17321 , 0 
30121.236,4,86 ,8 ,563 ,0 ,0 ,2 ,2 ,0 ,0 ,0 ,4 ,0 ,5 ,0 ,5,15207 , 0 
30121.289,7,86 ,16 ,695 ,0 ,0 ,4 ,3 ,4 ,1 ,0 ,12 ,0 ,9 ,4 ,13,24907 , 0 
30121.337,14,86 ,1 ,256 ,0 ,0 ,1 ,0 ,1 ,0 ,0 ,2 ,0 ,2 ,1 ,3,14896 , 0 
30121.35,15,86 ,7 ,1285 ,0 ,0 ,2 ,4 ,0 ,0 ,0 ,6 ,0 ,9 ,0 ,9,19290 , 0 
30121.36,20,86 ,12 ,1140 ,0 ,0 ,1 ,1 ,0 ,0 ,0 ,2 ,0 ,6 ,0 ,6,16772 , 0 
30121.36,16,86 ,9 ,300 ,0 ,0 ,3 ,4 ,8 ,0 ,1 ,16 ,0 ,7 ,9 ,16,32922 , 0 
30121.444,10,86 ,14 ,541 ,0 ,0 ,2 ,1 ,0 ,0 ,0 ,3 ,0 ,1 ,0 ,1,15443 , 0 
30121.482,12,86 ,5 ,895 ,0 ,0 ,2 ,3 ,1 ,1 ,0 ,7 ,0 ,7 ,1 ,8,18245 , 0 
30121.596,9,86 ,5 ,895 ,0 ,0 ,4 ,3 ,11 ,0 ,1 ,19 ,0 ,11 ,15 ,26,29074 , 1 
30121.603,5,86 ,13 ,512 ,0 ,0 ,3 ,0 ,18 ,0 ,1 ,22 ,0 ,10 ,23 ,33,27467 , 0 
30121.606,19,86 ,1 ,256 ,0 ,0 ,2 ,0 ,0 ,1 ,0 ,3 ,0 ,6 ,0 ,6,18203 , 0 
30121.697,17,86 ,16 ,695 ,0 ,0 ,4 ,2 ,3 ,0 ,1 ,10 ,0 ,6 ,4 ,10,22072 , 0 
30121.771,13,86 ,1 ,256 ,0 ,0 ,1 ,0 ,18 ,0 ,1 ,20 ,0 ,5 ,19 ,24,15753 , 0 
30121.787,3,86 ,1 ,256 ,0 ,0 ,2 ,0 ,0 ,0 ,0 ,2 ,0 ,2 ,0 ,2,11235 , 0 
30240.96,8,86 ,1 ,256 ,0 ,0 ,1 ,0 ,0 ,0 ,0 ,1 ,0 ,0 ,0 ,0,12703 , 0 
30241.078,11,86 ,9 ,300 ,0 ,0 ,2 ,2 ,2 ,0 ,0 ,6 ,0 ,8 ,2 ,10,19794 , 0 
30241.123,2,86 ,1 ,256 ,0 ,0 ,1 ,0 ,0 ,0 ,0 ,1 ,0 ,3 ,0 ,3,23140 , 0 
30241.138,6,86 ,2 ,512 ,0 ,0 ,1 ,0 ,0 ,0 ,0 ,1 ,0 ,2 ,0 ,2,31662 , 0 
30241.214,18,86 ,5 ,805 ,0 ,0 ,1 ,1 ,0 ,0 ,0 ,2 ,0 ,1 ,0 ,1,16623 , 0 
30241.236,4,86 ,8 ,563 ,0 ,0 ,0 ,0 ,0 ,0 ,0 ,0 ,0 ,1 ,0 ,1,14570 , 0 
30241.289,7,86 ,16 ,601 ,0 ,0 ,3 ,1 ,2 ,0 ,0 ,6 ,0 ,2 ,2 ,4,24961 , 0 
30241.337,14,86 ,1 ,256 ,0 ,0 ,2 ,0 ,1 ,0 ,0 ,3 ,0 ,2 ,1 ,3,14558 , 0 
30241.35,15,86 ,7 ,1221 ,0 ,0 ,1 ,2 ,0 ,0 ,0 ,3 ,0 ,5 ,0 ,5,18560 , 0 
30241.36,20,86 ,11 ,889 ,0 ,0 ,5 ,2 ,0 ,1 ,0 ,8 ,0 ,3 ,0 ,3,15784 , 0 
30241.36,16,86 ,9 ,300 ,0 ,0 ,1 ,1 ,4 ,0 ,0 ,6 ,0 ,5 ,5 ,10,34792 , 0 
30241.444,10,86 ,14 ,535 ,0 ,0 ,1 ,1 ,0 ,0 ,0 ,2 ,0 ,1 ,0 ,1,16377 , 0 
30241.482,12,86 ,5 ,805 ,0 ,0 ,1 ,1 ,0 ,0 ,1 ,3 ,0 ,8 ,1 ,9,17238 , 0 
30241.596,9,86 ,5 ,805 ,0 ,0 ,2 ,1 ,7 ,0 ,0 ,10 ,0 ,6 ,9 ,15,29407 , 1 
30241.603,5,86 ,13 ,512 ,0 ,0 ,2 ,0 ,9 ,0 ,1 ,12 ,0 ,7 ,11 ,18,26932 , 0 
30241.606,19,86 ,1 ,256 ,0 ,0 ,2 ,0 ,0 ,0 ,0 ,2 ,0 ,3 ,0 ,3,17851 , 0 
30241.696,17,86 ,16 ,601 ,0 ,0 ,2 ,1 ,0 ,1 ,0 ,4 ,0 ,3 ,0 ,3,21932 , 0 
30241.771,13,86 ,1 ,256 ,0 ,0 ,1 ,0 ,9 ,0 ,1 ,11 ,0 ,3 ,10 ,13,15930 , 0 
30241.787,3,86 ,1 ,256 ,0 ,0 ,1 ,0 ,0 ,0 ,0 ,1 ,0 ,0 ,0 ,0,11036 , 0 
30360.96,8,86 ,1 ,256 ,0 ,0 ,1 ,1 ,0 ,0 ,0 ,2 ,0 ,4 ,0 ,4,12401 , 0 
30361.078,11,86 ,12 ,1131 ,0 ,0 ,4 ,1 ,0 ,1 ,0 ,6 ,0 ,5 ,1 ,6,20782 , 0 
30361.123,2,86 ,1 ,256 ,0 ,0 ,2 ,0 ,0 ,0 ,0 ,2 ,0 ,3 ,0 ,3,21779 , 0 
30361.138,6,86 ,2 ,512 ,0 ,0 ,1 ,0 ,0 ,0 ,0 ,1 ,0 ,1 ,0 ,1,27810 , 0 
30361.214,18,86 ,5 ,805 ,0 ,0 ,1 ,0 ,0 ,0 ,0 ,1 ,0 ,3 ,0 ,3,17389 , 0 
30361.236,4,86 ,8 ,563 ,0 ,0 ,3 ,0 ,0 ,0 ,0 ,3 ,0 ,0 ,0 ,0,15279 , 0 
30361.289,7,86 ,16 ,601 ,0 ,0 ,2 ,0 ,1 ,0 ,0 ,3 ,0 ,2 ,1 ,3,24987 , 0 
30361.337,14,86 ,1 ,256 ,0 ,0 ,1 ,1 ,0 ,0 ,0 ,2 ,0 ,2 ,0 ,2,14978 , 0 
30361.35,15,86 ,7 ,1075 ,0 ,0 ,1 ,1 ,0 ,0 ,0 ,2 ,0 ,5 ,0 ,5,19368 , 0 
30361.36,20,86 ,12 ,1275 ,0 ,0 ,5 ,1 ,0 ,1 ,0 ,7 ,0 ,4 ,0 ,4,16870 , 0 
30361.36,16,86 ,9 ,300 ,0 ,0 ,0 ,0 ,1 ,0 ,0 ,1 ,0 ,2 ,1 ,3,32992 , 0 
30361.444,10,86 ,14 ,535 ,0 ,0 ,1 ,0 ,0 ,0 ,0 ,1 ,0 ,0 ,0 ,0,15499 , 0 
30361.482,12,86 ,5 ,805 ,0 ,0 ,1 ,0 ,1 ,1 ,0 ,3 ,0 ,9 ,2 ,11,18369 , 0 
30361.596,9,86 ,5 ,805 ,0 ,0 ,2 ,0 ,1 ,1 ,1 ,5 ,0 ,6 ,2 ,8,29219 , 0 
30361.603,5,86 ,13 ,512 ,0 ,0 ,1 ,0 ,2 ,1 ,1 ,5 ,0 ,10 ,5 ,15,27623 , 0 
30361.625,19,86 ,1 ,256 ,0 ,0 ,1 ,1 ,0 ,0 ,0 ,2 ,0 ,5 ,0 ,5,18283 , 0 
30361.696,17,86 ,16 ,601 ,0 ,0 ,1 ,0 ,0 ,0 ,0 ,1 ,0 ,3 ,0 ,3,22160 , 0 
30361.771,13,86 ,1 ,256 ,0 ,0 ,2 ,0 ,2 ,1 ,1 ,6 ,0 ,0 ,4 ,4,15850 , 0 
30361.787,3,86 ,1 ,256 ,0 ,0 ,1 ,0 ,0 ,0 ,0 ,1 ,0 ,0 ,0 ,0,11285 , 0 
30480.96,8,86 ,1 ,256 ,0 ,0 ,3 ,0 ,1 ,0 ,0 ,4 ,0 ,1 ,1 ,2,12790 , 0 
30481.078,11,86 ,12 ,1125 ,0 ,0 ,2 ,1 ,0 ,0 ,0 ,3 ,0 ,5 ,0 ,5,19877 , 0 
30481.124,2,86 ,1 ,256 ,0 ,0 ,0 ,0 ,10 ,0 ,0 ,10 ,0 ,6 ,10 ,16,23226 , 0 
30481.138,6,86 ,2 ,512 ,0 ,0 ,1 ,0 ,10 ,0 ,0 ,11 ,0 ,10 ,10 ,20,31799 , 0 
30481.214,18,86 ,5 ,778 ,0 ,0 ,1 ,1 ,0 ,0 ,0 ,2 ,0 ,3 ,0 ,3,16696 , 0 
30481.236,4,86 ,8 ,537 ,0 ,0 ,1 ,1 ,0 ,0 ,0 ,2 ,0 ,3 ,0 ,3,14641 , 0 
30481.29,7,86 ,17 ,1162 ,0 ,0 ,5 ,5 ,3 ,1 ,0 ,14 ,0 ,12 ,4 ,16,25118 , 0 
30481.337,14,86 ,1 ,256 ,0 ,0 ,1 ,0 ,0 ,0 ,0 ,1 ,0 ,0 ,0 ,0,14627 , 0 
30481.35,15,86 ,7 ,1405 ,0 ,0 ,2 ,3 ,0 ,0 ,0 ,5 ,0 ,8 ,0 ,8,18656 , 0 
30481.36,20,86 ,12 ,1125 ,0 ,0 ,2 ,1 ,0 ,0 ,0 ,3 ,0 ,2 ,0 ,2,15847 , 0 
30481.36,16,86 ,6 ,874 ,0 ,0 ,5 ,1 ,0 ,2 ,0 ,8 ,0 ,10 ,2 ,12,34919 , 0 
30481.444,10,86 ,14 ,535 ,0 ,0 ,0 ,0 ,0 ,0 ,0 ,0 ,0 ,1 ,0 ,1,16435 , 0 
30481.482,12,86 ,5 ,805 ,0 ,0 ,1 ,0 ,2 ,0 ,0 ,3 ,0 ,2 ,2 ,4,17313 , 0 
30481.596,9,86 ,5 ,805 ,0 ,0 ,2 ,0 ,0 ,1 ,1 ,4 ,0 ,12 ,1 ,13,29509 , 0 
30481.606,19,86 ,1 ,256 ,0 ,0 ,1 ,0 ,0 ,0 ,0 ,1 ,0 ,3 ,0 ,3,17933 , 0 
30481.608,5,86 ,13 ,512 ,0 ,0 ,1 ,0 ,3 ,1 ,1 ,6 ,0 ,6 ,5 ,11,27029 , 0 
30481.696,17,86 ,6 ,874 ,0 ,0 ,6 ,1 ,8 ,1 ,0 ,16 ,0 ,9 ,8 ,17,22079 , 0 
30481.771,13,86 ,1 ,256 ,0 ,0 ,1 ,0 ,3 ,1 ,1 ,6 ,0 ,0 ,5 ,5,16007 , 0 
30481.787,3,86 ,1 ,256 ,0 ,0 ,1 ,0 ,0 ,0 ,0 ,1 ,0 ,2 ,0 ,2,11105 , 0 
30600.96,8,86 ,1 ,256 ,0 ,0 ,0 ,0 ,0 ,0 ,0 ,0 ,0 ,2 ,0 ,2,12455 , 0 
30601.078,11,86 ,12 ,1112 ,0 ,0 ,2 ,1 ,0 ,0 ,0 ,3 ,0 ,5 ,0 ,5,20869 , 0 
30601.123,2,86 ,1 ,256 ,0 ,0 ,2 ,0 ,5 ,0 ,0 ,7 ,0 ,4 ,5 ,9,21855 , 0 
30601.138,6,86 ,2 ,516 ,0 ,0 ,2 ,1 ,4 ,0 ,0 ,7 ,0 ,4 ,4 ,8,27908 , 0 
30601.214,18,86 ,5 ,778 ,0 ,0 ,2 ,0 ,0 ,0 ,0 ,2 ,0 ,2 ,0 ,2,17457 , 0 
30601.236,4,86 ,8 ,537 ,0 ,0 ,1 ,0 ,0 ,0 ,0 ,1 ,0 ,2 ,0 ,2,15335 , 0 
30601.289,7,86 ,17 ,1084 ,0 ,0 ,2 ,2 ,1 ,0 ,0 ,5 ,0 ,3 ,1 ,4,25062 , 0 
30601.337,14,86 ,1 ,256 ,0 ,0 ,2 ,0 ,1 ,0 ,0 ,3 ,0 ,5 ,1 ,6,15059 , 0 
30601.35,15,86 ,7 ,1426 ,0 ,0 ,1 ,1 ,0 ,0 ,0 ,2 ,0 ,2 ,0 ,2,19436 , 0 
30601.36,20,86 ,12 ,1097 ,0 ,0 ,3 ,1 ,0 ,0 ,0 ,4 ,0 ,2 ,0 ,2,16960 , 0 
30601.36,16,86 ,6 ,795 ,0 ,0 ,1 ,0 ,0 ,0 ,0 ,1 ,0 ,4 ,0 ,4,33055 , 0 
30601.444,10,86 ,14 ,522 ,0 ,0 ,2 ,1 ,0 ,0 ,0 ,3 ,0 ,3 ,0 ,3,15567 , 0 
30601.482,12,86 ,5 ,805 ,0 ,0 ,2 ,0 ,2 ,0 ,0 ,4 ,0 ,4 ,2 ,6,18481 , 0 
30601.596,9,86 ,5 ,805 ,0 ,0 ,0 ,0 ,0 ,0 ,0 ,0 ,0 ,4 ,0 ,4,29277 , 0 
30601.602,5,86 ,13 ,512 ,0 ,0 ,1 ,0 ,2 ,0 ,0 ,3 ,0 ,7 ,2 ,9,27750 , 0 
30601.606,19,86 ,1 ,256 ,0 ,0 ,2 ,0 ,0 ,0 ,0 ,2 ,0 ,2 ,0 ,2,18361 , 0 
30601.696,17,86 ,6 ,790 ,0 ,0 ,2 ,1 ,3 ,0 ,0 ,6 ,0 ,4 ,3 ,7,22247 , 0 
30601.771,13,86 ,1 ,256 ,0 ,0 ,1 ,0 ,2 ,0 ,0 ,3 ,0 ,4 ,2 ,6,15934 , 0 
30601.787,3,86 ,1 ,256 ,0 ,0 ,2 ,0 ,0 ,0 ,0 ,2 ,0 ,1 ,0 ,1,11345 , 0 
30720.96,8,86 ,1 ,256 ,0 ,0 ,1 ,0 ,0 ,0 ,0 ,1 ,0 ,2 ,0 ,2,12859 , 0 
30721.078,11,86 ,12 ,1112 ,0 ,0 ,2 ,0 ,0 ,0 ,0 ,2 ,0 ,0 ,0 ,0,19954 , 0 
30721.124,2,86 ,1 ,256 ,0 ,0 ,25 ,0 ,30 ,0 ,0 ,55 ,107 ,22 ,30 ,159,23557 , 0 
30721.214,18,86 ,5 ,793 ,0 ,0 ,1 ,0 ,0 ,0 ,0 ,1 ,0 ,1 ,0 ,1,16763 , 0 
30721.236,4,86 ,8 ,537 ,0 ,0 ,1 ,0 ,0 ,0 ,0 ,1 ,0 ,1 ,0 ,1,14729 , 0 
30721.27,6,86 ,2 ,512 ,0 ,120 ,1 ,14 ,16 ,0 ,0 ,151 ,0 ,79 ,16 ,95,32823 , 1 
30721.29,7,86 ,17 ,1109 ,0 ,0 ,2 ,15 ,1 ,0 ,0 ,18 ,0 ,41 ,1 ,42,25403 , 0 
30721.337,14,86 ,1 ,256 ,0 ,0 ,0 ,0 ,1 ,0 ,0 ,1 ,0 ,38 ,1 ,39,14720 , 0 
30721.35,15,86 ,7 ,1341 ,0 ,0 ,1 ,1 ,0 ,0 ,0 ,2 ,0 ,2 ,0 ,2,18730 , 0 
30721.36,20,86 ,12 ,1097 ,0 ,0 ,1 ,0 ,0 ,0 ,0 ,1 ,0 ,1 ,0 ,1,15944 , 0 
30721.361,16,86 ,6 ,795 ,0 ,0 ,24 ,0 ,0 ,0 ,0 ,24 ,110 ,40 ,0 ,150,35260 , 0 
30721.444,10,86 ,14 ,522 ,0 ,0 ,26 ,1 ,0 ,0 ,0 ,27 ,109 ,1 ,0 ,110,16743 , 0 
30721.482,12,86 ,5 ,805 ,0 ,0 ,0 ,0 ,0 ,0 ,0 ,0 ,0 ,0 ,0 ,0,17378 , 0 
30721.596,9,86 ,5 ,805 ,0 ,0 ,1 ,0 ,0 ,0 ,0 ,1 ,0 ,25 ,0 ,25,29630 , 0 
30721.603,5,86 ,13 ,512 ,0 ,0 ,2 ,0 ,0 ,0 ,0 ,2 ,0 ,23 ,0 ,23,27207 , 0 
30721.606,19,86 ,1 ,256 ,0 ,0 ,1 ,0 ,0 ,0 ,0 ,1 ,0 ,19 ,0 ,19,18048 , 0 
30721.697,17,86 ,6 ,790 ,0 ,0 ,25 ,0 ,16 ,0 ,0 ,41 ,107 ,22 ,16 ,145,22491 , 0 
30721.771,13,86 ,1 ,256 ,0 ,0 ,1 ,0 ,0 ,0 ,0 ,1 ,0 ,17 ,0 ,17,16144 , 0 
30721.787,3,86 ,1 ,256 ,0 ,0 ,1 ,0 ,0 ,0 ,0 ,1 ,0 ,0 ,0 ,0,11166 , 0 
30840.96,8,86 ,1 ,256 ,0 ,0 ,1 ,0 ,0 ,0 ,0 ,1 ,0 ,2 ,0 ,2,12572 , 0 
30841.078,11,86 ,12 ,1093 ,0 ,0 ,1 ,0 ,0 ,0 ,0 ,1 ,0 ,4 ,0 ,4,20951 , 0 
30841.124,2,86 ,1 ,256 ,0 ,0 ,26 ,0 ,35 ,0 ,0 ,61 ,113 ,22 ,35 ,170,22189 , 0 
30841.214,18,86 ,5 ,793 ,0 ,0 ,1 ,0 ,0 ,0 ,0 ,1 ,0 ,3 ,0 ,3,17572 , 0 
30841.236,4,86 ,8 ,537 ,0 ,0 ,2 ,0 ,0 ,0 ,0 ,2 ,0 ,0 ,0 ,0,15414 , 0 
30841.27,6,86 ,2 ,512 ,0 ,120 ,1 ,16 ,19 ,0 ,0 ,156 ,0 ,86 ,19 ,105,28941 , 1 
30841.29,7,86 ,17 ,1074 ,0 ,0 ,2 ,19 ,0 ,0 ,0 ,21 ,0 ,47 ,0 ,47,25299 , 0 
30841.337,14,86 ,1 ,256 ,0 ,0 ,1 ,0 ,0 ,0 ,0 ,1 ,0 ,42 ,0 ,42,15148 , 0 
30841.35,15,86 ,7 ,1390 ,0 ,0 ,1 ,0 ,0 ,0 ,0 ,1 ,0 ,1 ,0 ,1,19521 , 0 
30841.36,20,86 ,12 ,1097 ,0 ,0 ,2 ,0 ,0 ,0 ,0 ,2 ,0 ,0 ,0 ,0,17023 , 0 
30841.361,16,86 ,6 ,795 ,0 ,0 ,25 ,0 ,0 ,0 ,0 ,25 ,110 ,40 ,0 ,150,33369 , 0 
30841.444,10,86 ,14 ,522 ,0 ,0 ,25 ,0 ,0 ,0 ,0 ,25 ,110 ,1 ,0 ,111,15830 , 0 
30841.482,12,86 ,5 ,805 ,0 ,0 ,2 ,0 ,0 ,0 ,0 ,2 ,0 ,2 ,0 ,2,18553 , 0 
30841.596,9,86 ,5 ,805 ,0 ,0 ,1 ,0 ,0 ,0 ,0 ,1 ,0 ,24 ,0 ,24,29378 , 0 
30841.603,5,86 ,13 ,512 ,0 ,0 ,1 ,0 ,0 ,0 ,0 ,1 ,0 ,22 ,0 ,22,27845 , 0 
30841.607,19,86 ,1 ,256 ,0 ,0 ,1 ,0 ,0 ,0 ,0 ,1 ,0 ,26 ,0 ,26,18476 , 0 
30841.697,17,86 ,6 ,790 ,0 ,0 ,26 ,0 ,19 ,0 ,0 ,45 ,110 ,23 ,19 ,152,22629 , 0 
30841.771,13,86 ,1 ,256 ,0 ,0 ,1 ,0 ,0 ,0 ,0 ,1 ,0 ,17 ,0 ,17,16013 , 0 
30841.787,3,86 ,1 ,256 ,0 ,0 ,0 ,0 ,0 ,0 ,0 ,0 ,0 ,1 ,0 ,1,11403 , 0 
30960.96,8,86 ,1 ,256 ,0 ,0 ,1 ,0 ,0 ,0 ,0 ,1 ,0 ,0 ,0 ,0,12915 , 0 
30961.078,11,86 ,12 ,1093 ,0 ,0 ,1 ,0 ,0 ,0 ,0 ,1 ,0 ,2 ,0 ,2,20026 , 0 
30961.124,2,86 ,1 ,256 ,0 ,0 ,24 ,0 ,33 ,0 ,0 ,57 ,109 ,22 ,33 ,164,23857 , 0 
30961.214,18,86 ,5 ,793 ,0 ,0 ,1 ,0 ,0 ,0 ,0 ,1 ,0 ,0 ,0 ,0,16821 , 0 
30961.236,4,86 ,8 ,537 ,0 ,0 ,1 ,0 ,0 ,0 ,0 ,1 ,0 ,1 ,0 ,1,14785 , 0 
30961.27,6,86 ,2 ,512 ,0 ,120 ,1 ,16 ,17 ,0 ,0 ,154 ,0 ,79 ,17 ,96,33797 , 1 
30961.29,7,86 ,17 ,1056 ,0 ,0 ,0 ,17 ,0 ,0 ,0 ,17 ,0 ,41 ,0 ,41,25620 , 0 
30961.337,14,86 ,1 ,256 ,0 ,0 ,1 ,0 ,0 ,0 ,0 ,1 ,0 ,37 ,0 ,37,14841 , 0 
30961.35,15,86 ,7 ,1390 ,0 ,0 ,1 ,0 ,0 ,0 ,0 ,1 ,0 ,0 ,0 ,0,18791 , 0 
30961.36,20,86 ,12 ,1097 ,0 ,0 ,2 ,0 ,0 ,0 ,0 ,2 ,0 ,0 ,0 ,0,16023 , 0 
30961.361,16,86 ,6 ,795 ,0 ,0 ,24 ,0 ,0 ,0 ,0 ,24 ,108 ,41 ,0 ,149,35551 , 0 
30961.444,10,86 ,14 ,519 ,0 ,0 ,25 ,0 ,0 ,0 ,0 ,25 ,109 ,1 ,0 ,110,17001 , 0 
30961.482,12,86 ,5 ,805 ,0 ,0 ,0 ,0 ,0 ,0 ,0 ,0 ,0 ,1 ,0 ,1,17471 , 0 
30961.596,9,86 ,5 ,805 ,0 ,0 ,1 ,0 ,0 ,0 ,0 ,1 ,0 ,21 ,0 ,21,29720 , 0 
30961.603,5,86 ,13 ,512 ,0 ,0 ,1 ,1 ,0 ,0 ,0 ,2 ,0 ,26 ,0 ,26,27342 , 0 
30961.607,19,86 ,1 ,256 ,0 ,0 ,1 ,0 ,0 ,0 ,0 ,1 ,0 ,22 ,0 ,22,18144 , 0 
30961.697,17,86 ,6 ,775 ,0 ,0 ,25 ,0 ,17 ,0 ,0 ,42 ,112 ,22 ,17 ,151,22840 , 0 
30961.771,13,86 ,1 ,256 ,0 ,0 ,2 ,0 ,1 ,0 ,0 ,3 ,0 ,20 ,1 ,21,16252 , 0 
30961.787,3,86 ,1 ,256 ,0 ,0 ,2 ,0 ,0 ,0 ,0 ,2 ,0 ,0 ,0 ,0,11230 , 0 
31080.96,8,86 ,1 ,256 ,0 ,0 ,1 ,0 ,1 ,0 ,0 ,2 ,0 ,2 ,1 ,3,12634 , 0 
31081.078,11,86 ,12 ,1086 ,0 ,0 ,1 ,0 ,0 ,0 ,0 ,1 ,0 ,3 ,0 ,3,21022 , 0 
31081.124,2,86 ,1 ,256 ,0 ,0 ,7 ,0 ,10 ,0 ,0 ,17 ,1 ,7 ,10 ,18,22344 , 0 
31081.138,6,86 ,2 ,512 ,0 ,0 ,1 ,5 ,5 ,0 ,0 ,11 ,0 ,19 ,5 ,24,29096 , 0 
31081.214,18,86 ,5 ,813 ,0 ,0 ,1 ,1 ,0 ,0 ,0 ,2 ,0 ,3 ,0 ,3,17652 , 0 
31081.236,4,86 ,8 ,541 ,0 ,0 ,2 ,1 ,0 ,0 ,0 ,3 ,0 ,2 ,0 ,2,15500 , 0 
31081.289,7,86 ,17 ,1042 ,0 ,0 ,1 ,5 ,0 ,0 ,0 ,6 ,0 ,9 ,0 ,9,25404 , 0 
31081.337,14,86 ,1 ,256 ,0 ,0 ,1 ,0 ,0 ,0 ,0 ,1 ,0 ,9 ,0 ,9,15228 , 0 
31081.35,15,86 ,7 ,1390 ,0 ,0 ,1 ,0 ,0 ,0 ,0 ,1 ,0 ,0 ,0 ,0,19575 , 0 
31081.36,20,86 ,12 ,1097 ,0 ,0 ,1 ,0 ,0 ,0 ,0 ,1 ,0 ,0 ,0 ,0,17108 , 0 
31081.36,16,86 ,6 ,768 ,0 ,0 ,5 ,0 ,0 ,0 ,0 ,5 ,0 ,12 ,0 ,12,33511 , 0 
31081.444,10,86 ,14 ,519 ,0 ,0 ,7 ,0 ,0 ,0 ,0 ,7 ,0 ,0 ,0 ,0,15933 , 0 
31081.481,12,86 ,5 ,805 ,0 ,0 ,2 ,0 ,0 ,0 ,0 ,2 ,0 ,0 ,0 ,0,18619 , 0 
31081.596,9,86 ,5 ,805 ,0 ,0 ,0 ,0 ,0 ,0 ,0 ,0 ,0 ,4 ,0 ,4,29438 , 0 
31081.602,5,86 ,13 ,512 ,0 ,0 ,2 ,0 ,1 ,0 ,0 ,3 ,0 ,6 ,1 ,7,27987 , 0 
31081.606,19,86 ,1 ,256 ,0 ,0 ,1 ,0 ,0 ,0 ,0 ,1 ,0 ,6 ,0 ,6,18563 , 0 
31081.696,17,86 ,6 ,775 ,0 ,0 ,6 ,0 ,5 ,0 ,0 ,11 ,0 ,4 ,5 ,9,22772 , 0 
31081.771,13,86 ,1 ,256 ,0 ,0 ,1 ,0 ,1 ,0 ,0 ,2 ,0 ,6 ,1 ,7,16106 , 0 
31081.787,3,86 ,1 ,256 ,0 ,0 ,1 ,0 ,0 ,0 ,0 ,1 ,0 ,0 ,0 ,0,11457 , 0 
31200.96,8,86 ,1 ,256 ,0 ,0 ,2 ,0 ,0 ,0 ,0 ,2 ,0 ,1 ,0 ,1,12993 , 0 
31201.078,11,86 ,12 ,1086 ,0 ,0 ,1 ,0 ,0 ,0 ,0 ,1 ,0 ,2 ,0 ,2,20089 , 0 
31201.123,2,86 ,1 ,256 ,0 ,0 ,3 ,0 ,2 ,0 ,0 ,5 ,0 ,1 ,2 ,3,23953 , 0 
31201.138,6,86 ,2 ,512 ,0 ,0 ,1 ,1 ,1 ,0 ,0 ,3 ,0 ,3 ,1 ,4,33865 , 0 
31201.214,18,86 ,5 ,813 ,0 ,0 ,2 ,0 ,0 ,0 ,0 ,2 ,0 ,1 ,0 ,1,16891 , 0 
31201.236,4,86 ,8 ,538 ,0 ,0 ,2 ,0 ,0 ,0 ,0 ,2 ,0 ,1 ,0 ,1,14854 , 0 
31201.289,7,86 ,17 ,1032 ,0 ,0 ,1 ,1 ,0 ,0 ,0 ,2 ,0 ,4 ,0 ,4,25706 , 0 
31201.337,14,86 ,1 ,256 ,0 ,0 ,1 ,0 ,0 ,0 ,0 ,1 ,0 ,5 ,0 ,5,14906 , 0 
31201.35,15,86 ,7 ,1390 ,0 ,0 ,2 ,0 ,0 ,0 ,0 ,2 ,0 ,2 ,0 ,2,18885 , 0 
31201.36,20,86 ,12 ,1097 ,0 ,0 ,2 ,0 ,0 ,0 ,0 ,2 ,0 ,0 ,0 ,0,16085 , 0 
31201.36,16,86 ,6 ,768 ,0 ,0 ,1 ,0 ,0 ,0 ,0 ,1 ,0 ,2 ,0 ,2,35613 , 0 
31201.444,10,86 ,14 ,519 ,0 ,0 ,1 ,0 ,0 ,0 ,0 ,1 ,0 ,0 ,0 ,0,17056 , 0 
31201.482,12,86 ,5 ,808 ,0 ,0 ,0 ,1 ,0 ,0 ,0 ,1 ,0 ,4 ,0 ,4,17540 , 0 
31201.596,9,86 ,5 ,805 ,0 ,0 ,1 ,0 ,0 ,0 ,0 ,1 ,0 ,4 ,0 ,4,29802 , 0 
31201.602,5,86 ,13 ,512 ,0 ,0 ,1 ,0 ,1 ,0 ,0 ,2 ,0 ,2 ,1 ,3,27411 , 0 
31201.606,19,86 ,1 ,256 ,0 ,0 ,0 ,0 ,0 ,0 ,0 ,0 ,0 ,6 ,0 ,6,18240 , 0 
31201.696,17,86 ,6 ,768 ,0 ,0 ,2 ,0 ,1 ,0 ,0 ,3 ,0 ,2 ,1 ,3,22903 , 0 
31201.771,13,86 ,1 ,256 ,0 ,0 ,0 ,0 ,1 ,0 ,0 ,1 ,0 ,1 ,1 ,2,16313 , 0 
31201.787,3,86 ,1 ,256 ,0 ,0 ,2 ,0 ,0 ,0 ,0 ,2 ,0 ,1 ,0 ,1,11295 , 0 
31320.96,8,86 ,1 ,256 ,0 ,0 ,1 ,0 ,0 ,0 ,0 ,1 ,0 ,0 ,0 ,0,12701 , 0 
31321.078,11,86 ,12 ,1079 ,0 ,0 ,2 ,1 ,0 ,0 ,0 ,3 ,0 ,3 ,0 ,3,21114 , 0 
31321.123,2,86 ,1 ,256 ,0 ,0 ,0 ,0 ,0 ,0 ,0 ,0 ,0 ,0 ,0 ,0,22418 , 0 
31321.138,6,86 ,2 ,512 ,0 ,0 ,1 ,0 ,0 ,0 ,0 ,1 ,0 ,2 ,0 ,2,29180 , 0 
31321.214,18,86 ,5 ,813 ,0 ,0 ,1 ,0 ,0 ,0 ,0 ,1 ,0 ,2 ,0 ,2,17715 , 0 
31321.236,4,86 ,8 ,538 ,0 ,0 ,0 ,0 ,0 ,0 ,0 ,0 ,0 ,1 ,0 ,1,15551 , 0 
31321.289,7,86 ,17 ,1032 ,0 ,0 ,2 ,0 ,0 ,0 ,0 ,2 ,0 ,0 ,0 ,0,25459 , 0 
31321.337,14,86 ,1 ,256 ,0 ,0 ,1 ,0 ,0 ,0 ,0 ,1 ,0 ,2 ,0 ,2,15326 , 0 
31321.35,15,86 ,7 ,1390 ,0 ,0 ,1 ,0 ,0 ,0 ,0 ,1 ,0 ,1 ,0 ,1,19645 , 0 
31321.36,20,86 ,12 ,1079 ,0 ,0 ,1 ,1 ,0 ,0 ,0 ,2 ,0 ,3 ,0 ,3,17181 , 0 
31321.36,16,86 ,6 ,768 ,0 ,0 ,1 ,0 ,0 ,0 ,0 ,1 ,0 ,2 ,0 ,2,33581 , 0 
31321.444,10,86 ,14 ,519 ,0 ,0 ,2 ,0 ,0 ,0 ,0 ,2 ,0 ,1 ,0 ,1,16023 , 0 
31321.482,12,86 ,5 ,808 ,0 ,0 ,3 ,0 ,2 ,0 ,0 ,5 ,0 ,1 ,2 ,3,18738 , 0 
31321.596,9,86 ,5 ,805 ,0 ,0 ,1 ,0 ,0 ,0 ,0 ,1 ,0 ,3 ,0 ,3,29513 , 0 
31321.602,5,86 ,13 ,512 ,0 ,0 ,1 ,0 ,2 ,0 ,0 ,3 ,0 ,4 ,2 ,6,28135 , 0 
31321.606,19,86 ,1 ,256 ,0 ,0 ,1 ,0 ,0 ,0 ,0 ,1 ,0 ,1 ,0 ,1,18643 , 0 
31321.696,17,86 ,6 ,768 ,0 ,0 ,1 ,0 ,0 ,0 ,0 ,1 ,0 ,0 ,0 ,0,22838 , 0 
31321.771,13,86 ,1 ,256 ,0 ,0 ,1 ,0 ,2 ,0 ,0 ,3 ,0 ,0 ,2 ,2,16197 , 0 
31321.787,3,86 ,1 ,256 ,0 ,0 ,1 ,0 ,0 ,0 ,0 ,1 ,0 ,2 ,0 ,2,11523 , 0 
31440.96,8,86 ,1 ,256 ,0 ,0 ,1 ,0 ,0 ,0 ,0 ,1 ,0 ,1 ,0 ,1,13058 , 0 
31441.078,11,86 ,12 ,1079 ,0 ,0 ,1 ,0 ,0 ,0 ,0 ,1 ,0 ,1 ,0 ,1,20152 , 0 
31441.123,2,86 ,1 ,256 ,0 ,0 ,4 ,0 ,3 ,0 ,0 ,7 ,0 ,4 ,3 ,7,24064 , 0 
31441.138,6,86 ,2 ,512 ,0 ,0 ,2 ,2 ,1 ,0 ,0 ,5 ,0 ,5 ,1 ,6,33958 , 0 
31441.214,18,86 ,5 ,813 ,0 ,0 ,1 ,0 ,0 ,0 ,0 ,1 ,0 ,0 ,0 ,0,16954 , 0 
31441.236,4,86 ,8 ,538 ,0 ,0 ,1 ,0 ,0 ,0 ,0 ,1 ,0 ,1 ,0 ,1,14915 , 0 
31441.289,7,86 ,17 ,1030 ,0 ,0 ,1 ,0 ,0 ,0 ,0 ,1 ,0 ,3 ,0 ,3,25772 , 0 
31441.337,14,86 ,1 ,256 ,0 ,0 ,1 ,0 ,0 ,0 ,0 ,1 ,0 ,5 ,0 ,5,14973 , 0 
31441.35,15,86 ,7 ,1324 ,0 ,0 ,1 ,0 ,0 ,0 ,0 ,1 ,0 ,2 ,0 ,2,18943 , 0 
31441.36,20,86 ,12 ,1079 ,0 ,0 ,1 ,0 ,0 ,0 ,0 ,1 ,0 ,1 ,0 ,1,16151 , 0 
31441.36,16,86 ,6 ,768 ,0 ,0 ,1 ,1 ,0 ,0 ,0 ,2 ,0 ,8 ,0 ,8,35703 , 1 
31441.444,10,86 ,14 ,519 ,0 ,0 ,2 ,0 ,0 ,0 ,0 ,2 ,0 ,1 ,0 ,1,17118 , 0 
31441.481,12,86 ,5 ,808 ,0 ,0 ,0 ,0 ,0 ,0 ,0 ,0 ,0 ,0 ,0 ,0,17591 , 0 
31441.596,9,86 ,5 ,805 ,0 ,0 ,1 ,0 ,0 ,0 ,0 ,1 ,0 ,1 ,0 ,1,29859 , 0 
31441.602,5,86 ,13 ,512 ,0 ,0 ,0 ,0 ,0 ,0 ,0 ,0 ,0 ,4 ,0 ,4,27487 , 0 
31441.606,19,86 ,1 ,256 ,0 ,0 ,1 ,0 ,0 ,0 ,0 ,1 ,0 ,4 ,0 ,4,18313 , 0 
31441.696,17,86 ,6 ,768 ,0 ,0 ,2 ,1 ,0 ,0 ,0 ,3 ,0 ,3 ,0 ,3,23000 , 0 
31441.771,13,86 ,1 ,256 ,0 ,0 ,2 ,0 ,0 ,0 ,0 ,2 ,0 ,2 ,0 ,2,16405 , 0 
31441.787,3,86 ,1 ,256 ,0 ,0 ,1 ,0 ,0 ,0 ,0 ,1 ,0 ,0 ,0 ,0,11363 , 0 
31560.96,8,86 ,1 ,256 ,0 ,0 ,0 ,0 ,0 ,0 ,0 ,0 ,0 ,2 ,0 ,2,12759 , 0 
31561.078,11,86 ,12 ,1077 ,0 ,0 ,2 ,1 ,0 ,0 ,0 ,3 ,0 ,1 ,0 ,1,21222 , 0 
31561.124,2,86 ,1 ,256 ,0 ,0 ,4 ,0 ,24 ,0 ,0 ,28 ,0 ,4 ,24 ,28,22531 , 0 
31561.138,6,86 ,2 ,512 ,0 ,0 ,5 ,4 ,20 ,0 ,0 ,29 ,0 ,8 ,20 ,28,29445 , 0 
31561.214,18,86 ,5 ,813 ,0 ,0 ,1 ,0 ,0 ,0 ,0 ,1 ,0 ,1 ,0 ,1,17785 , 0 
31561.236,4,86 ,8 ,538 ,0 ,0 ,1 ,0 ,0 ,0 ,0 ,1 ,0 ,0 ,0 ,0,15624 , 0 
31561.289,7,86 ,17 ,1050 ,0 ,0 ,6 ,5 ,5 ,0 ,0 ,16 ,0 ,6 ,5 ,11,25615 , 0 
31561.337,14,86 ,1 ,256 ,0 ,0 ,1 ,0 ,0 ,0 ,0 ,1 ,0 ,5 ,0 ,5,15383 , 0 
31561.35,15,86 ,7 ,1317 ,0 ,0 ,0 ,5 ,0 ,0 ,0 ,5 ,0 ,6 ,0 ,6,19751 , 0 
31561.36,20,86 ,12 ,1075 ,0 ,0 ,1 ,1 ,0 ,0 ,0 ,2 ,0 ,2 ,0 ,2,17260 , 0 
31561.36,16,86 ,6 ,774 ,0 ,0 ,0 ,5 ,0 ,0 ,0 ,5 ,0 ,17 ,0 ,17,33684 , 1 
31561.444,10,86 ,14 ,519 ,0 ,0 ,1 ,0 ,0 ,0 ,0 ,1 ,0 ,5 ,0 ,5,16092 , 0 
31561.481,12,86 ,5 ,808 ,0 ,0 ,2 ,0 ,2 ,0 ,0 ,4 ,0 ,1 ,2 ,3,18838 , 0 
31561.598,9,86 ,5 ,805 ,0 ,0 ,2 ,0 ,0 ,0 ,0 ,2 ,0 ,6 ,0 ,6,29607 , 0 
31561.602,5,86 ,13 ,512 ,0 ,0 ,1 ,0 ,2 ,0 ,0 ,3 ,0 ,4 ,2 ,6,28227 , 0 
31561.606,19,86 ,1 ,256 ,0 ,0 ,1 ,0 ,0 ,0 ,0 ,1 ,0 ,5 ,0 ,5,18734 , 0 
31561.697,17,86 ,6 ,774 ,0 ,0 ,6 ,4 ,10 ,0 ,0 ,20 ,0 ,8 ,10 ,18,23015 , 0 
31561.771,13,86 ,1 ,256 ,0 ,0 ,1 ,0 ,2 ,0 ,0 ,3 ,0 ,4 ,2 ,6,16264 , 0 
31561.787,3,86 ,1 ,256 ,0 ,0 ,1 ,0 ,0 ,0 ,0 ,1 ,0 ,0 ,0 ,0,11578 , 0 
31680.96,8,86 ,1 ,256 ,0 ,0 ,1 ,0 ,0 ,0 ,0 ,1 ,0 ,1 ,0 ,1,13114 , 0 
31681.078,11,86 ,12 ,1071 ,0 ,0 ,0 ,0 ,0 ,0 ,0 ,0 ,0 ,5 ,0 ,5,20215 , 0 
31681.123,2,86 ,1 ,256 ,0 ,0 ,3 ,0 ,5 ,0 ,0 ,8 ,0 ,2 ,5 ,7,24161 , 0 
31681.138,6,86 ,2 ,512 ,0 ,0 ,3 ,1 ,4 ,0 ,0 ,8 ,0 ,2 ,4 ,6,34077 , 0 
31681.214,18,86 ,5 ,813 ,0 ,0 ,2 ,0 ,0 ,0 ,0 ,2 ,0 ,1 ,0 ,1,17031 , 0 
31681.236,4,86 ,8 ,538 ,0 ,0 ,2 ,0 ,0 ,0 ,0 ,2 ,0 ,1 ,0 ,1,14996 , 0 
31681.289,7,86 ,17 ,1050 ,0 ,0 ,0 ,1 ,0 ,0 ,0 ,1 ,0 ,3 ,0 ,3,25843 , 0 
31681.337,14,86 ,1 ,256 ,0 ,0 ,2 ,0 ,0 ,0 ,0 ,2 ,0 ,3 ,0 ,3,15074 , 0 
31681.35,15,86 ,7 ,1317 ,0 ,0 ,2 ,0 ,0 ,0 ,0 ,2 ,0 ,1 ,0 ,1,19012 , 0 
31681.36,20,86 ,12 ,1075 ,0 ,0 ,0 ,0 ,0 ,0 ,0 ,0 ,0 ,0 ,0 ,0,16216 , 0 
31681.36,16,86 ,6 ,778 ,0 ,0 ,0 ,1 ,0 ,0 ,0 ,1 ,0 ,3 ,0 ,3,35776 , 1 
31681.444,10,86 ,14 ,519 ,0 ,0 ,1 ,0 ,0 ,0 ,0 ,1 ,0 ,1 ,0 ,1,17177 , 0 
31681.482,12,86 ,5 ,808 ,0 ,0 ,1 ,0 ,0 ,0 ,0 ,1 ,0 ,2 ,0 ,2,17683 , 0 
31681.596,9,86 ,5 ,805 ,0 ,0 ,2 ,0 ,0 ,0 ,0 ,2 ,0 ,0 ,0 ,0,29965 , 0 
31681.602,5,86 ,13 ,512 ,0 ,0 ,1 ,0 ,0 ,0 ,0 ,1 ,0 ,2 ,0 ,2,27588 , 0 
31681.606,19,86 ,1 ,256 ,0 ,0 ,1 ,0 ,0 ,0 ,0 ,1 ,0 ,5 ,0 ,5,18388 , 0 
31681.696,17,86 ,6 ,778 ,0 ,0 ,2 ,2 ,1 ,0 ,0 ,5 ,0 ,2 ,1 ,3,23112 , 0 
31681.771,13,86 ,1 ,256 ,0 ,0 ,0 ,0 ,0 ,0 ,0 ,0 ,0 ,2 ,0 ,2,16476 , 0 
31681.787,3,86 ,1 ,256 ,0 ,0 ,2 ,0 ,0 ,0 ,0 ,2 ,0 ,2 ,0 ,2,11434 , 0 
31800.96,8,86 ,1 ,256 ,0 ,0 ,1 ,0 ,1 ,0 ,0 ,2 ,0 ,1 ,1 ,2,12849 , 0 
31801.078,11,86 ,12 ,1071 ,0 ,0 ,1 ,0 ,0 ,0 ,0 ,1 ,0 ,1 ,0 ,1,21286 , 0 
31801.123,2,86 ,1 ,256 ,0 ,0 ,1 ,0 ,1 ,0 ,0 ,2 ,0 ,1 ,1 ,2,22611 , 0 
31801.138,6,86 ,2 ,512 ,0 ,0 ,0 ,0 ,1 ,0 ,0 ,1 ,0 ,0 ,1 ,1,29518 , 0 
31801.214,18,86 ,5 ,813 ,0 ,0 ,1 ,0 ,0 ,0 ,0 ,1 ,0 ,1 ,0 ,1,17851 , 0 
31801.236,4,86 ,8 ,528 ,0 ,0 ,1 ,1 ,0 ,0 ,0 ,2 ,0 ,2 ,0 ,2,15698 , 0 
31801.289,7,86 ,17 ,1050 ,0 ,0 ,2 ,0 ,1 ,0 ,0 ,3 ,0 ,1 ,1 ,2,25679 , 0 
31801.337,14,86 ,1 ,256 ,0 ,0 ,1 ,0 ,0 ,0 ,0 ,1 ,0 ,0 ,0 ,0,15439 , 0 
31801.35,15,86 ,7 ,1312 ,0 ,0 ,1 ,1 ,0 ,0 ,0 ,2 ,0 ,1 ,0 ,1,19816 , 0 
31801.36,20,86 ,12 ,1075 ,0 ,0 ,2 ,0 ,0 ,0 ,0 ,2 ,0 ,1 ,0 ,1,17323 , 0 
31801.36,16,86 ,6 ,778 ,0 ,0 ,0 ,0 ,0 ,0 ,0 ,0 ,0 ,3 ,0 ,3,33775 , 0 
31801.444,10,86 ,14 ,519 ,0 ,0 ,0 ,0 ,0 ,0 ,0 ,0 ,0 ,0 ,0 ,0,16141 , 0 
31801.481,12,86 ,5 ,808 ,0 ,0 ,0 ,0 ,0 ,0 ,0 ,0 ,0 ,0 ,0 ,0,18891 , 0 
31801.596,9,86 ,5 ,805 ,0 ,0 ,2 ,0 ,0 ,0 ,0 ,2 ,0 ,3 ,0 ,3,29688 , 0 
31801.602,5,86 ,13 ,512 ,0 ,0 ,1 ,0 ,0 ,0 ,0 ,1 ,0 ,2 ,0 ,2,28336 , 0 
31801.606,19,86 ,1 ,256 ,0 ,0 ,0 ,0 ,0 ,0 ,0 ,0 ,0 ,2 ,0 ,2,18817 , 0 
31801.696,17,86 ,6 ,778 ,0 ,0 ,1 ,0 ,1 ,0 ,0 ,2 ,0 ,1 ,1 ,2,23084 , 0 
31801.771,13,86 ,1 ,256 ,0 ,0 ,2 ,0 ,0 ,0 ,0 ,2 ,0 ,0 ,0 ,0,16351 , 0 
31801.787,3,86 ,1 ,256 ,0 ,0 ,1 ,0 ,0 ,0 ,0 ,1 ,0 ,0 ,0 ,0,11645 , 0 
31920.96,8,86 ,1 ,256 ,0 ,0 ,1 ,0 ,0 ,0 ,0 ,1 ,0 ,1 ,0 ,1,13179 , 0 
31921.078,11,86 ,12 ,1071 ,0 ,0 ,2 ,0 ,0 ,0 ,0 ,2 ,0 ,2 ,0 ,2,20299 , 0 
31921.123,2,86 ,1 ,256 ,0 ,0 ,2 ,0 ,3 ,0 ,0 ,5 ,0 ,2 ,3 ,5,24249 , 0 
31921.138,6,86 ,2 ,512 ,0 ,0 ,2 ,1 ,2 ,0 ,0 ,5 ,0 ,3 ,2 ,5,34171 , 0 
31921.214,18,86 ,5 ,813 ,0 ,0 ,1 ,0 ,0 ,0 ,0 ,1 ,0 ,1 ,0 ,1,17098 , 0 
31921.236,4,86 ,8 ,528 ,0 ,0 ,1 ,0 ,0 ,0 ,0 ,1 ,0 ,0 ,0 ,0,15055 , 0 
31921.289,7,86 ,17 ,1050 ,0 ,0 ,2 ,0 ,1 ,0 ,0 ,3 ,0 ,0 ,1 ,1,25915 , 0 
31921.337,14,86 ,1 ,256 ,0 ,0 ,1 ,0 ,0 ,0 ,0 ,1 ,0 ,3 ,0 ,3,15137 , 0 
31921.35,15,86 ,7 ,1311 ,0 ,0 ,1 ,1 ,0 ,0 ,0 ,2 ,0 ,3 ,0 ,3,19097 , 0 
31921.36,20,86 ,12 ,1075 ,0 ,0 ,2 ,0 ,0 ,0 ,0 ,2 ,0 ,1 ,0 ,1,16318 , 0 
31921.36,16,86 ,6 ,775 ,0 ,0 ,1 ,0 ,0 ,0 ,0 ,1 ,0 ,5 ,0 ,5,35842 , 0 
31921.444,10,86 ,14 ,519 ,0 ,0 ,3 ,0 ,0 ,0 ,0 ,3 ,0 ,2 ,0 ,2,17258 , 0 
31921.482,12,86 ,5 ,808 ,0 ,0 ,1 ,0 ,0 ,0 ,0 ,1 ,0 ,2 ,0 ,2,17782 , 0 
31921.596,9,86 ,5 ,805 ,0 ,0 ,1 ,0 ,0 ,0 ,0 ,1 ,0 ,2 ,0 ,2,30056 , 0 
31921.602,5,86 ,13 ,512 ,0 ,0 ,1 ,0 ,0 ,0 ,0 ,1 ,0 ,2 ,0 ,2,27690 , 0 
31921.606,19,86 ,1 ,256 ,0 ,0 ,2 ,0 ,0 ,0 ,0 ,2 ,0 ,3 ,0 ,3,18481 , 0 
31921.696,17,86 ,6 ,775 ,0 ,0 ,0 ,1 ,1 ,0 ,0 ,2 ,0 ,3 ,1 ,4,23178 , 0 
31921.771,13,86 ,1 ,256 ,0 ,0 ,0 ,0 ,0 ,0 ,0 ,0 ,0 ,1 ,0 ,1,16532 , 0 
31921.786,3,86 ,1 ,256 ,0 ,0 ,0 ,0 ,0 ,0 ,0 ,0 ,0 ,0 ,0 ,0,11484 , 0 
32040.96,8,86 ,1 ,256 ,0 ,0 ,1 ,0 ,0 ,0 ,0 ,1 ,0 ,0 ,0 ,0,12904 , 0 
32041.078,11,86 ,12 ,1071 ,0 ,0 ,2 ,0 ,0 ,0 ,0 ,2 ,0 ,1 ,0 ,1,21355 , 0 
32041.123,2,86 ,1 ,256 ,0 ,0 ,1 ,0 ,3 ,0 ,0 ,4 ,0 ,0 ,3 ,3,22692 , 0 
32041.138,6,86 ,2 ,512 ,0 ,0 ,1 ,0 ,3 ,0 ,0 ,4 ,0 ,2 ,3 ,5,29623 , 0 
32041.214,18,86 ,5 ,813 ,0 ,0 ,1 ,0 ,0 ,0 ,0 ,1 ,0 ,1 ,0 ,1,17917 , 0 
32041.235,4,86 ,8 ,528 ,0 ,0 ,0 ,0 ,0 ,0 ,0 ,0 ,0 ,1 ,0 ,1,15758 , 0 
32041.289,7,86 ,17 ,1031 ,0 ,0 ,2 ,1 ,1 ,0 ,0 ,4 ,0 ,2 ,1 ,3,25756 , 0 
32041.337,14,86 ,1 ,256 ,0 ,0 ,1 ,0 ,0 ,0 ,0 ,1 ,0 ,3 ,0 ,3,15541 , 0 
32041.35,15,86 ,7 ,1288 ,0 ,0 ,1 ,1 ,0 ,0 ,0 ,2 ,0 ,3 ,0 ,3,19875 , 0 
32041.36,20,86 ,12 ,1075 ,0 ,0 ,1 ,0 ,0 ,0 ,0 ,1 ,0 ,1 ,0 ,1,17381 , 0 
32041.36,16,86 ,6 ,769 ,0 ,0 ,0 ,1 ,0 ,0 ,0 ,1 ,0 ,2 ,0 ,2,33835 , 0 
32041.444,10,86 ,14 ,519 ,0 ,0 ,1 ,0 ,0 ,0 ,0 ,1 ,0 ,0 ,0 ,0,16203 , 0 
32041.481,12,86 ,5 ,808 ,0 ,0 ,1 ,0 ,0 ,0 ,0 ,1 ,0 ,1 ,0 ,1,18954 , 0 
32041.596,9,86 ,5 ,805 ,0 ,0 ,0 ,0 ,0 ,0 ,0 ,0 ,0 ,3 ,0 ,3,29751 , 0 
32041.602,5,86 ,13 ,512 ,0 ,0 ,1 ,0 ,0 ,0 ,0 ,1 ,0 ,3 ,0 ,3,28431 , 0 
32041.606,19,86 ,1 ,256 ,0 ,0 ,1 ,0 ,0 ,0 ,0 ,1 ,0 ,0 ,0 ,0,18889 , 0 
32041.696,17,86 ,6 ,775 ,0 ,0 ,2 ,0 ,2 ,0 ,0 ,4 ,0 ,0 ,2 ,2,23181 , 0 
32041.771,13,86 ,1 ,256 ,0 ,0 ,1 ,0 ,0 ,0 ,0 ,1 ,0 ,0 ,0 ,0,16432 , 0 
32041.787,3,86 ,1 ,256 ,0 ,0 ,1 ,0 ,0 ,0 ,0 ,1 ,0 ,1 ,0 ,1,11711 , 0 
32160.96,8,86 ,1 ,256 ,0 ,0 ,1 ,0 ,0 ,0 ,0 ,1 ,0 ,2 ,0 ,2,13250 , 0 
32161.078,11,86 ,12 ,1068 ,0 ,0 ,1 ,0 ,0 ,0 ,0 ,1 ,0 ,4 ,0 ,4,20368 , 0 
32161.123,2,86 ,1 ,256 ,0 ,0 ,0 ,0 ,1 ,0 ,0 ,1 ,0 ,3 ,1 ,4,24323 , 0 
32161.138,6,86 ,2 ,512 ,0 ,0 ,2 ,0 ,1 ,0 ,0 ,3 ,0 ,0 ,1 ,1,34251 , 0 
32161.214,18,86 ,5 ,813 ,0 ,0 ,0 ,0 ,0 ,0 ,0 ,0 ,0 ,0 ,0 ,0,17151 , 0 
32161.236,4,86 ,8 ,528 ,0 ,0 ,1 ,0 ,0 ,0 ,0 ,1 ,0 ,0 ,0 ,0,15118 , 0 
32161.289,7,86 ,17 ,1031 ,0 ,0 ,0 ,0 ,0 ,0 ,0 ,0 ,0 ,0 ,0 ,0,25977 , 0 
32161.337,14,86 ,1 ,256 ,0 ,0 ,1 ,0 ,0 ,0 ,0 ,1 ,0 ,1 ,0 ,1,15192 , 0 
32161.35,15,86 ,7 ,1288 ,0 ,0 ,1 ,0 ,0 ,0 ,0 ,1 ,0 ,0 ,0 ,0,19169 , 0 
32161.36,20,86 ,12 ,1075 ,0 ,0 ,2 ,0 ,0 ,0 ,0 ,2 ,0 ,0 ,0 ,0,16379 , 0 
32161.36,16,86 ,6 ,769 ,0 ,0 ,0 ,0 ,0 ,0 ,0 ,0 ,0 ,1 ,0 ,1,35903 , 1 
32161.444,10,86 ,14 ,519 ,0 ,0 ,1 ,0 ,0 ,0 ,0 ,1 ,0 ,1 ,0 ,1,17316 , 0 
32161.481,12,86 ,5 ,808 ,0 ,0 ,1 ,0 ,0 ,0 ,0 ,1 ,0 ,3 ,0 ,3,17842 , 0 
32161.596,9,86 ,5 ,805 ,0 ,0 ,1 ,0 ,0 ,0 ,0 ,1 ,0 ,0 ,0 ,0,30128 , 0 
32161.602,5,86 ,13 ,512 ,0 ,0 ,2 ,0 ,0 ,0 ,0 ,2 ,0 ,1 ,0 ,1,27764 , 0 
32161.606,19,86 ,1 ,256 ,0 ,0 ,1 ,0 ,0 ,0 ,0 ,1 ,0 ,1 ,0 ,1,18559 , 0 
32161.696,17,86 ,6 ,768 ,0 ,0 ,1 ,1 ,0 ,0 ,0 ,2 ,0 ,1 ,0 ,1,23243 , 0 
32161.771,13,86 ,1 ,256 ,0 ,0 ,1 ,0 ,0 ,0 ,0 ,1 ,0 ,0 ,0 ,0,16599 , 0 
32161.786,3,86 ,1 ,256 ,0 ,0 ,1 ,0 ,0 ,0 ,0 ,1 ,0 ,1 ,0 ,1,11548 , 0 
32280.96,8,86 ,1 ,256 ,0 ,0 ,1 ,0 ,0 ,0 ,0 ,1 ,0 ,0 ,0 ,0,12996 , 0 
32281.078,11,86 ,12 ,1068 ,0 ,0 ,1 ,0 ,0 ,0 ,0 ,1 ,0 ,1 ,0 ,1,21421 , 0 
32281.123,2,86 ,1 ,256 ,0 ,0 ,2 ,0 ,1 ,0 ,0 ,3 ,0 ,1 ,1 ,2,22777 , 0 
32281.138,6,86 ,2 ,512 ,0 ,0 ,1 ,0 ,1 ,0 ,0 ,2 ,0 ,1 ,1 ,2,29724 , 0 
32281.214,18,86 ,5 ,813 ,0 ,0 ,2 ,0 ,0 ,0 ,0 ,2 ,0 ,1 ,0 ,1,17998 , 0 
32281.236,4,86 ,8 ,528 ,0 ,0 ,1 ,0 ,0 ,0 ,0 ,1 ,0 ,2 ,0 ,2,15833 , 0 
32281.289,7,86 ,17 ,1024 ,0 ,0 ,2 ,1 ,0 ,0 ,0 ,3 ,0 ,2 ,0 ,2,25852 , 0 
32281.337,14,86 ,1 ,256 ,0 ,0 ,0 ,0 ,0 ,0 ,0 ,0 ,0 ,2 ,0 ,2,15598 , 0 
32281.35,15,86 ,7 ,1288 ,0 ,0 ,0 ,0 ,0 ,0 ,0 ,0 ,0 ,0 ,0 ,0,19929 , 0 
32281.36,20,86 ,12 ,1075 ,0 ,0 ,1 ,0 ,0 ,0 ,0 ,1 ,0 ,2 ,0 ,2,17501 , 0 
32281.36,16,86 ,6 ,769 ,0 ,0 ,0 ,0 ,0 ,0 ,0 ,0 ,0 ,4 ,0 ,4,33940 , 1 
32281.444,10,86 ,14 ,519 ,0 ,0 ,1 ,0 ,0 ,0 ,0 ,1 ,0 ,1 ,0 ,1,16264 , 0 
32281.481,12,86 ,5 ,808 ,0 ,0 ,1 ,0 ,0 ,0 ,0 ,1 ,0 ,1 ,0 ,1,19051 , 0 
32281.596,9,86 ,5 ,805 ,0 ,0 ,1 ,0 ,0 ,0 ,0 ,1 ,0 ,1 ,0 ,1,29850 , 0 
32281.602,5,86 ,13 ,512 ,0 ,0 ,1 ,0 ,0 ,0 ,0 ,1 ,0 ,4 ,0 ,4,28553 , 0 
32281.606,19,86 ,1 ,256 ,0 ,0 ,1 ,0 ,0 ,0 ,0 ,1 ,0 ,4 ,0 ,4,18998 , 0 
32281.696,17,86 ,6 ,768 ,0 ,0 ,2 ,0 ,1 ,0 ,0 ,3 ,0 ,0 ,1 ,1,23258 , 0 
32281.771,13,86 ,1 ,256 ,0 ,0 ,2 ,0 ,0 ,0 ,0 ,2 ,0 ,0 ,0 ,0,16520 , 0 
32281.787,3,86 ,1 ,256 ,0 ,0 ,1 ,0 ,0 ,0 ,0 ,1 ,0 ,0 ,0 ,0,11761 , 0 
32400.96,8,86 ,1 ,256 ,0 ,0 ,2 ,0 ,0 ,0 ,0 ,2 ,0 ,2 ,0 ,2,13330 , 0 
32401.078,11,86 ,12 ,1065 ,0 ,0 ,1 ,0 ,0 ,0 ,0 ,1 ,0 ,3 ,0 ,3,20438 , 0 
32401.123,2,86 ,1 ,256 ,0 ,0 ,0 ,0 ,2 ,0 ,0 ,2 ,0 ,1 ,2 ,3,24395 , 0 
32401.138,6,86 ,2 ,512 ,0 ,0 ,1 ,0 ,2 ,0 ,0 ,3 ,0 ,0 ,2 ,2,34336 , 0 
32401.214,18,86 ,5 ,813 ,0 ,0 ,1 ,0 ,0 ,0 ,0 ,1 ,0 ,2 ,0 ,2,17226 , 0 
32401.236,4,86 ,8 ,519 ,0 ,0 ,1 ,0 ,0 ,0 ,0 ,1 ,0 ,3 ,0 ,3,15192 , 0 
32401.289,7,86 ,17 ,1024 ,0 ,0 ,2 ,0 ,2 ,0 ,0 ,4 ,0 ,1 ,2 ,3,26061 , 0 
32401.337,14,86 ,1 ,256 ,0 ,0 ,1 ,0 ,0 ,0 ,0 ,1 ,0 ,2 ,0 ,2,15283 , 0 
32401.35,15,86 ,7 ,1297 ,0 ,0 ,1 ,2 ,0 ,0 ,0 ,3 ,0 ,2 ,0 ,2,19255 , 0 
32401.36,20,86 ,12 ,1065 ,0 ,0 ,1 ,0 ,0 ,0 ,0 ,1 ,0 ,1 ,0 ,1,16433 , 0 
32401.36,16,86 ,6 ,768 ,0 ,0 ,0 ,0 ,0 ,0 ,0 ,0 ,0 ,3 ,0 ,3,35987 , 1 
32401.444,10,86 ,14 ,519 ,0 ,0 ,0 ,0 ,0 ,0 ,0 ,0 ,0 ,1 ,0 ,1,17371 , 0 
32401.482,12,86 ,5 ,808 ,0 ,0 ,2 ,0 ,0 ,0 ,0 ,2 ,0 ,1 ,0 ,1,17920 , 0 
32401.596,9,86 ,5 ,805 ,0 ,0 ,1 ,0 ,0 ,0 ,0 ,1 ,0 ,3 ,0 ,3,30209 , 0 
32401.602,5,86 ,13 ,512 ,0 ,0 ,1 ,0 ,0 ,0 ,0 ,1 ,0 ,1 ,0 ,1,27878 , 0 
32401.606,19,86 ,1 ,256 ,0 ,0 ,1 ,0 ,0 ,0 ,0 ,1 ,0 ,1 ,0 ,1,18626 , 0 
32401.696,17,86 ,6 ,768 ,0 ,0 ,1 ,0 ,2 ,0 ,0 ,3 ,0 ,2 ,2 ,4,23331 , 0 
32401.771,13,86 ,1 ,256 ,0 ,0 ,1 ,0 ,0 ,0 ,0 ,1 ,0 ,1 ,0 ,1,16675 , 0 
32401.787,3,86 ,1 ,256 ,0 ,0 ,2 ,0 ,0 ,0 ,0 ,2 ,0 ,1 ,0 ,1,11616 , 0 
32520.96,8,86 ,1 ,256 ,0 ,0 ,1 ,0 ,0 ,0 ,0 ,1 ,0 ,1 ,0 ,1,13064 , 0 
32521.078,11,86 ,12 ,1065 ,0 ,0 ,1 ,1 ,0 ,0 ,0 ,2 ,0 ,4 ,0 ,4,21514 , 0 
32521.123,2,86 ,1 ,256 ,0 ,0 ,2 ,0 ,3 ,0 ,0 ,5 ,0 ,3 ,3 ,6,22873 , 0 
32521.138,6,86 ,2 ,512 ,0 ,0 ,2 ,1 ,2 ,0 ,0 ,5 ,0 ,2 ,2 ,4,29805 , 0 
32521.214,18,86 ,5 ,813 ,0 ,0 ,1 ,0 ,0 ,0 ,0 ,1 ,0 ,2 ,0 ,2,18067 , 0 
32521.236,4,86 ,8 ,519 ,0 ,0 ,1 ,0 ,0 ,0 ,0 ,1 ,0 ,2 ,0 ,2,15901 , 0 
32521.289,7,86 ,17 ,1024 ,0 ,0 ,1 ,1 ,0 ,0 ,0 ,2 ,0 ,2 ,0 ,2,25920 , 0 
32521.337,14,86 ,1 ,256 ,0 ,0 ,2 ,0 ,0 ,0 ,0 ,2 ,0 ,2 ,0 ,2,15662 , 0 
32521.35,15,86 ,7 ,1297 ,0 ,0 ,2 ,0 ,0 ,0 ,0 ,2 ,0 ,1 ,0 ,1,20013 , 0 
32521.36,20,86 ,12 ,1065 ,0 ,0 ,1 ,0 ,0 ,0 ,0 ,1 ,0 ,0 ,0 ,0,17570 , 0 
32521.36,16,86 ,6 ,768 ,0 ,0 ,0 ,0 ,0 ,0 ,0 ,0 ,0 ,2 ,0 ,2,33997 , 0 
32521.444,10,86 ,14 ,519 ,0 ,0 ,1 ,0 ,0 ,0 ,0 ,1 ,0 ,1 ,0 ,1,16321 , 0 
32521.482,12,86 ,5 ,808 ,0 ,0 ,1 ,0 ,1 ,0 ,0 ,2 ,0 ,0 ,1 ,1,19125 , 0 
32521.596,9,86 ,5 ,805 ,0 ,0 ,1 ,0 ,0 ,0 ,0 ,1 ,0 ,1 ,0 ,1,29920 , 0 
32521.602,5,86 ,13 ,512 ,0 ,0 ,1 ,0 ,1 ,0 ,0 ,2 ,0 ,3 ,1 ,4,28630 , 0 
32521.606,19,86 ,1 ,256 ,0 ,0 ,2 ,0 ,0 ,0 ,0 ,2 ,0 ,2 ,0 ,2,19085 , 0 
32521.696,17,86 ,6 ,768 ,0 ,0 ,1 ,1 ,1 ,0 ,0 ,3 ,0 ,1 ,1 ,2,23325 , 0 
32521.771,13,86 ,1 ,256 ,0 ,0 ,0 ,0 ,1 ,0 ,0 ,1 ,0 ,2 ,1 ,3,16577 , 0 
32521.786,3,86 ,1 ,256 ,0 ,0 ,0 ,0 ,0 ,0 ,0 ,0 ,0 ,1 ,0 ,1,11821 , 0 
32640.96,8,86 ,1 ,256 ,0 ,0 ,1 ,0 ,0 ,0 ,0 ,1 ,0 ,1 ,0 ,1,13392 , 0 
32641.078,11,86 ,12 ,1065 ,0 ,0 ,0 ,0 ,0 ,0 ,0 ,0 ,0 ,4 ,0 ,4,20501 , 0 
32641.123,2,86 ,1 ,256 ,0 ,0 ,1 ,0 ,1 ,0 ,0 ,2 ,0 ,1 ,1 ,2,24487 , 0 
32641.138,6,86 ,2 ,512 ,0 ,0 ,1 ,0 ,1 ,0 ,0 ,2 ,0 ,0 ,1 ,1,34423 , 0 
32641.214,18,86 ,5 ,813 ,0 ,0 ,1 ,0 ,0 ,0 ,0 ,1 ,0 ,1 ,0 ,1,17296 , 0 
32641.236,4,86 ,8 ,519 ,0 ,0 ,2 ,0 ,0 ,0 ,0 ,2 ,0 ,0 ,0 ,0,15260 , 0 
32641.289,7,86 ,17 ,1024 ,0 ,0 ,1 ,0 ,0 ,0 ,0 ,1 ,0 ,0 ,0 ,0,26120 , 0 
32641.337,14,86 ,1 ,256 ,0 ,0 ,1 ,0 ,0 ,0 ,0 ,1 ,0 ,1 ,0 ,1,15354 , 0 
32641.35,15,86 ,7 ,1297 ,0 ,0 ,1 ,0 ,0 ,0 ,0 ,1 ,0 ,0 ,0 ,0,19307 , 0 
32641.36,20,86 ,5 ,804 ,0 ,0 ,4 ,2 ,0 ,1 ,0 ,7 ,0 ,2 ,0 ,2,16553 , 0 
32641.36,16,86 ,6 ,768 ,0 ,0 ,0 ,1 ,0 ,0 ,0 ,1 ,0 ,3 ,0 ,3,36045 , 0 
32641.444,10,86 ,14 ,512 ,0 ,0 ,1 ,0 ,0 ,0 ,0 ,1 ,0 ,1 ,0 ,1,17435 , 0 
32641.482,12,86 ,5 ,808 ,0 ,0 ,2 ,0 ,1 ,0 ,1 ,4 ,0 ,3 ,2 ,5,18035 , 0 
32641.596,9,86 ,5 ,805 ,0 ,0 ,1 ,0 ,0 ,0 ,0 ,1 ,0 ,2 ,0 ,2,30281 , 0 
32641.602,5,86 ,13 ,512 ,0 ,0 ,1 ,0 ,2 ,0 ,1 ,4 ,0 ,4 ,3 ,7,28007 , 0 
32641.606,19,86 ,1 ,256 ,0 ,0 ,1 ,0 ,0 ,0 ,0 ,1 ,0 ,3 ,0 ,3,18725 , 0 
32641.696,17,86 ,6 ,768 ,0 ,0 ,1 ,0 ,0 ,0 ,0 ,1 ,0 ,0 ,0 ,0,23410 , 0 
32641.771,13,86 ,1 ,256 ,0 ,0 ,1 ,0 ,2 ,0 ,1 ,4 ,0 ,1 ,3 ,4,16771 , 0 
32641.787,3,86 ,1 ,256 ,0 ,0 ,1 ,0 ,0 ,0 ,0 ,1 ,0 ,0 ,0 ,0,11667 , 0 
32760.96,8,86 ,1 ,256 ,0 ,0 ,1 ,0 ,1 ,0 ,0 ,2 ,0 ,0 ,1 ,1,13127 , 0 
32761.078,11,86 ,12 ,1112 ,0 ,0 ,1 ,0 ,0 ,0 ,0 ,1 ,0 ,5 ,0 ,5,21585 , 0 
32761.123,2,86 ,1 ,256 ,0 ,0 ,1 ,0 ,1 ,0 ,0 ,2 ,0 ,1 ,1 ,2,22945 , 0 
32761.138,6,86 ,2 ,512 ,0 ,0 ,1 ,0 ,1 ,0 ,0 ,2 ,0 ,3 ,1 ,4,29892 , 0 
32761.214,18,86 ,5 ,813 ,0 ,0 ,1 ,0 ,0 ,0 ,0 ,1 ,0 ,0 ,0 ,0,18147 , 0 
32761.236,4,86 ,8 ,517 ,0 ,0 ,0 ,1 ,0 ,0 ,0 ,1 ,0 ,1 ,0 ,1,15968 , 0 
32761.289,7,86 ,17 ,1024 ,0 ,0 ,2 ,0 ,1 ,0 ,0 ,3 ,0 ,2 ,1 ,3,26003 , 0 
32761.337,14,86 ,1 ,256 ,0 ,0 ,1 ,0 ,0 ,0 ,0 ,1 ,0 ,3 ,0 ,3,15742 , 0 
32761.35,15,86 ,7 ,1289 ,0 ,0 ,1 ,1 ,0 ,0 ,0 ,2 ,0 ,2 ,0 ,2,20084 , 0 
32761.36,20,86 ,5 ,804 ,0 ,0 ,3 ,0 ,0 ,0 ,0 ,3 ,0 ,0 ,0 ,0,17649 , 0 
32761.36,16,86 ,6 ,768 ,0 ,0 ,1 ,0 ,0 ,0 ,0 ,1 ,0 ,3 ,0 ,3,34095 , 0 
32761.444,10,86 ,14 ,512 ,0 ,0 ,2 ,0 ,0 ,0 ,0 ,2 ,0 ,1 ,0 ,1,16396 , 0 
32761.482,12,86 ,5 ,808 ,0 ,0 ,1 ,0 ,0 ,1 ,0 ,2 ,0 ,3 ,0 ,3,19206 , 0 
32761.596,9,86 ,5 ,805 ,0 ,0 ,2 ,0 ,0 ,0 ,0 ,2 ,0 ,1 ,0 ,1,30006 , 0 
32761.602,5,86 ,13 ,512 ,0 ,0 ,1 ,0 ,0 ,0 ,0 ,1 ,0 ,4 ,1 ,5,28733 , 0 
32761.606,19,86 ,1 ,256 ,0 ,0 ,1 ,0 ,0 ,0 ,0 ,1 ,0 ,1 ,0 ,1,19152 , 0 
32761.696,17,86 ,6 ,768 ,0 ,0 ,1 ,0 ,1 ,0 ,0 ,2 ,0 ,1 ,1 ,2,23391 , 0 
32761.771,13,86 ,1 ,256 ,0 ,0 ,1 ,0 ,0 ,0 ,0 ,1 ,0 ,0 ,0 ,0,16649 , 0 
32761.787,3,86 ,1 ,256 ,0 ,0 ,1 ,0 ,0 ,0 ,0 ,1 ,0 ,1 ,0 ,1,11882 , 0 
32880.96,8,86 ,1 ,256 ,0 ,0 ,2 ,0 ,0 ,0 ,0 ,2 ,0 ,2 ,0 ,2,13464 , 0 
32881.078,11,86 ,15 ,1542 ,0 ,0 ,1 ,0 ,0 ,1 ,0 ,2 ,0 ,5 ,0 ,5,20580 , 0 
32881.138,6,86 ,0 ,0 ,0 ,0 ,1 ,0 ,1 ,1 ,3 ,6 ,0 ,1 ,4 ,5,34554 , 0 
32881.214,18,86 ,5 ,813 ,0 ,0 ,1 ,0 ,0 ,0 ,0 ,1 ,0 ,2 ,0 ,2,17363 , 0 
32881.236,4,86 ,8 ,517 ,0 ,0 ,2 ,0 ,0 ,0 ,0 ,2 ,0 ,1 ,0 ,1,15336 , 0 
32881.267,2,88 ,16 ,1474 ,0 ,0 ,1 ,0 ,1 ,1 ,4 ,7 ,0 ,4 ,5 ,9,24612 , 0 
32881.289,7,91 ,17 ,65535 ,0 ,0 ,3 ,1 ,0 ,1 ,1 ,6 ,0 ,6 ,6 ,12,26220 , 1 
32881.337,14,86 ,1 ,256 ,0 ,0 ,1 ,0 ,0 ,0 ,0 ,1 ,0 ,1 ,0 ,1,15429 , 0 
32881.35,15,88 ,7 ,1286 ,0 ,0 ,4 ,2 ,0 ,3 ,0 ,9 ,0 ,3 ,0 ,3,19435 , 0 
32881.36,20,86 ,5 ,804 ,0 ,0 ,2 ,0 ,0 ,0 ,0 ,2 ,0 ,1 ,0 ,1,16631 , 0 
32881.36,16,88 ,7 ,1286 ,0 ,0 ,2 ,1 ,0 ,2 ,0 ,5 ,0 ,5 ,0 ,5,36154 , 0 
32881.444,10,86 ,14 ,512 ,0 ,0 ,1 ,0 ,0 ,0 ,0 ,1 ,0 ,0 ,0 ,0,17491 , 0 
32881.482,12,86 ,5 ,790 ,0 ,0 ,1 ,0 ,0 ,0 ,1 ,2 ,0 ,3 ,1 ,4,18153 , 0 
32881.596,9,88 ,7 ,1286 ,0 ,0 ,3 ,1 ,1 ,2 ,1 ,8 ,0 ,8 ,2 ,10,30453 , 0 
32881.602,5,86 ,13 ,512 ,0 ,0 ,1 ,0 ,1 ,0 ,1 ,3 ,0 ,3 ,2 ,5,28088 , 0 
32881.606,19,86 ,1 ,256 ,0 ,0 ,1 ,0 ,0 ,0 ,0 ,1 ,0 ,2 ,0 ,2,18797 , 0 
32881.696,17,88 ,7 ,65535 ,0 ,0 ,3 ,1 ,1 ,2 ,1 ,8 ,0 ,4 ,3 ,7,23507 , 0 
32881.771,13,86 ,1 ,256 ,0 ,0 ,1 ,0 ,1 ,0 ,1 ,3 ,0 ,0 ,2 ,2,16835 , 0 
32881.787,3,86 ,1 ,256 ,0 ,0 ,2 ,0 ,0 ,0 ,0 ,2 ,0 ,1 ,0 ,1,11729 , 0 
33000.961,8,119 ,1 ,256 ,0 ,0 ,14 ,11 ,3 ,10 ,3 ,41 ,0 ,40 ,8 ,48,13523 , 0 
33001.078,11,126 ,5 ,781 ,0 ,0 ,22 ,1 ,0 ,2 ,0 ,25 ,0 ,57 ,3 ,60,21924 , 0 
33001.124,2,124 ,1 ,256 ,0 ,0 ,19 ,6 ,5 ,11 ,1 ,42 ,0 ,61 ,19 ,80,23596 , 0 
33001.139,6,124 ,2 ,719 ,0 ,0 ,18 ,5 ,4 ,6 ,2 ,35 ,0 ,53 ,10 ,63,30529 , 0 
33001.214,18,124 ,19 ,512 ,0 ,0 ,18 ,7 ,0 ,9 ,0 ,34 ,0 ,42 ,4 ,46,18613 , 0 
33001.236,4,118 ,8 ,512 ,0 ,0 ,16 ,9 ,0 ,11 ,0 ,36 ,0 ,36 ,1 ,37,16546 , 0 
33001.29,7,129 ,17 ,65535 ,0 ,0 ,19 ,0 ,0 ,0 ,0 ,19 ,0 ,41 ,3 ,44,26224 , 1 
33001.338,14,124 ,1 ,256 ,0 ,0 ,16 ,9 ,7 ,13 ,4 ,49 ,0 ,58 ,19 ,77,16223 , 0 
33001.35,15,126 ,7 ,1286 ,0 ,0 ,20 ,0 ,0 ,0 ,0 ,20 ,0 ,41 ,2 ,43,20410 , 0 
33001.36,20,124 ,5 ,781 ,0 ,0 ,18 ,1 ,0 ,4 ,0 ,23 ,0 ,39 ,0 ,39,17963 , 0 
33001.361,16,124 ,2 ,719 ,0 ,0 ,18 ,2 ,0 ,2 ,0 ,22 ,0 ,48 ,6 ,54,34433 , 0 
33001.445,10,124 ,14 ,1070 ,0 ,0 ,19 ,7 ,0 ,11 ,0 ,37 ,0 ,27 ,1 ,28,16992 , 0 
33001.482,12,118 ,5 ,781 ,0 ,0 ,18 ,1 ,1 ,3 ,0 ,23 ,0 ,48 ,3 ,51,19573 , 0 
33001.596,9,126 ,7 ,1286 ,0 ,0 ,21 ,0 ,0 ,0 ,0 ,21 ,0 ,56 ,0 ,56,30253 , 0 
33001.603,5,126 ,19 ,512 ,0 ,0 ,20 ,2 ,1 ,8 ,2 ,33 ,0 ,76 ,7 ,83,29291 , 0 
33001.607,19,124 ,1 ,256 ,0 ,0 ,17 ,5 ,10 ,9 ,4 ,45 ,0 ,70 ,32 ,102,19597 , 0 
33001.697,17,128 ,6 ,1673 ,0 ,0 ,18 ,1 ,0 ,1 ,0 ,20 ,0 ,32 ,0 ,32,23697 , 0 
33001.772,13,124 ,0 ,0 ,0 ,0 ,18 ,7 ,1 ,15 ,2 ,43 ,0 ,52 ,5 ,57,17154 , 0 
33001.787,3,125 ,1 ,256 ,0 ,0 ,17 ,9 ,1 ,10 ,1 ,38 ,0 ,33 ,2 ,35,12207 , 0 
33120.961,8,161 ,1 ,256 ,0 ,0 ,17 ,12 ,11 ,10 ,7 ,57 ,0 ,48 ,22 ,70,13873 , 0 
33121.078,11,164 ,5 ,1310 ,0 ,0 ,21 ,2 ,0 ,3 ,0 ,26 ,0 ,62 ,2 ,64,20963 , 0 
33121.124,2,164 ,1 ,256 ,0 ,0 ,18 ,6 ,7 ,9 ,4 ,44 ,0 ,66 ,25 ,91,24988 , 0 
33121.138,6,164 ,2 ,512 ,0 ,0 ,21 ,3 ,1 ,6 ,1 ,32 ,0 ,50 ,2 ,52,34963 , 0 
33121.214,18,161 ,19 ,512 ,0 ,0 ,17 ,6 ,2 ,8 ,2 ,35 ,0 ,44 ,6 ,50,17839 , 0 
33121.236,4,161 ,8 ,512 ,0 ,0 ,20 ,8 ,1 ,12 ,1 ,42 ,0 ,29 ,3 ,32,15896 , 0 
33121.29,7,169 ,17 ,65535 ,0 ,0 ,20 ,0 ,0 ,0 ,0 ,20 ,0 ,38 ,0 ,38,26430 , 1 
33121.338,14,161 ,1 ,256 ,0 ,0 ,18 ,8 ,5 ,12 ,0 ,43 ,0 ,56 ,12 ,68,15861 , 0 
33121.351,15,164 ,11 ,1784 ,0 ,0 ,20 ,0 ,0 ,1 ,0 ,21 ,0 ,41 ,0 ,41,19650 , 0 
33121.36,20,161 ,12 ,1254 ,0 ,0 ,19 ,3 ,0 ,4 ,0 ,26 ,0 ,37 ,0 ,37,16954 , 0 
33121.361,16,160 ,2 ,537 ,0 ,0 ,17 ,2 ,0 ,2 ,0 ,21 ,0 ,41 ,0 ,41,36422 , 0 
33121.444,10,164 ,14 ,512 ,0 ,0 ,16 ,3 ,0 ,5 ,0 ,24 ,0 ,29 ,0 ,29,17809 , 0 
33121.482,12,161 ,5 ,998 ,0 ,0 ,20 ,5 ,1 ,4 ,1 ,31 ,0 ,49 ,3 ,52,18517 , 0 
33121.596,9,166 ,5 ,1310 ,0 ,0 ,20 ,0 ,0 ,2 ,0 ,22 ,0 ,56 ,0 ,56,30784 , 0 
33121.607,5,161 ,19 ,512 ,0 ,0 ,21 ,4 ,10 ,12 ,3 ,50 ,0 ,67 ,20 ,87,28826 , 0 
33121.607,19,161 ,1 ,256 ,0 ,0 ,19 ,7 ,14 ,11 ,6 ,57 ,0 ,76 ,31 ,107,19241 , 0 
33121.697,17,164 ,6 ,1673 ,0 ,0 ,19 ,0 ,0 ,0 ,0 ,19 ,0 ,37 ,0 ,37,23710 , 0 
33121.772,13,161 ,2 ,512 ,0 ,0 ,19 ,11 ,0 ,12 ,0 ,42 ,0 ,54 ,0 ,54,17304 , 0 
33121.787,3,161 ,14 ,512 ,0 ,0 ,17 ,13 ,0 ,9 ,0 ,39 ,0 ,33 ,3 ,36,12063 , 0 
33240.96,8,171 ,1 ,256 ,0 ,0 ,9 ,4 ,2 ,7 ,2 ,24 ,0 ,25 ,6 ,31,13827 , 0 
33241.078,11,171 ,5 ,858 ,0 ,0 ,15 ,2 ,3 ,3 ,2 ,25 ,0 ,50 ,6 ,56,22259 , 0 
33241.138,6,171 ,2 ,512 ,0 ,0 ,12 ,4 ,0 ,1 ,0 ,17 ,0 ,28 ,1 ,29,30774 , 0 
33241.146,2,171 ,1 ,256 ,0 ,0 ,11 ,2 ,20 ,4 ,7 ,44 ,0 ,38 ,28 ,66,23942 , 0 
33241.214,18,171 ,19 ,531 ,0 ,0 ,14 ,6 ,2 ,9 ,1 ,32 ,0 ,28 ,4 ,32,19082 , 0 
33241.236,4,171 ,8 ,537 ,0 ,0 ,13 ,7 ,1 ,9 ,1 ,31 ,0 ,18 ,3 ,21,17017 , 0 
33241.29,7,171 ,16 ,856 ,0 ,0 ,18 ,2 ,1 ,3 ,2 ,26 ,0 ,37 ,4 ,41,26622 , 0 
33241.338,14,171 ,1 ,256 ,0 ,0 ,11 ,6 ,5 ,5 ,2 ,29 ,0 ,22 ,8 ,30,16444 , 0 
33241.35,15,171 ,9 ,2106 ,0 ,0 ,16 ,5 ,0 ,4 ,0 ,25 ,0 ,38 ,1 ,39,20869 , 0 
33241.36,20,171 ,5 ,858 ,0 ,0 ,12 ,5 ,0 ,3 ,0 ,20 ,0 ,28 ,1 ,29,18315 , 0 
33241.361,16,171 ,2 ,512 ,0 ,0 ,15 ,3 ,3 ,1 ,2 ,24 ,0 ,30 ,6 ,36,34793 , 0 
33241.444,10,171 ,14 ,512 ,0 ,0 ,9 ,5 ,0 ,3 ,0 ,17 ,0 ,16 ,0 ,16,17264 , 0 
33241.482,12,171 ,18 ,770 ,0 ,0 ,14 ,3 ,2 ,7 ,1 ,27 ,0 ,33 ,6 ,39,20068 , 0 
33241.596,9,171 ,16 ,856 ,0 ,0 ,16 ,5 ,3 ,7 ,1 ,32 ,0 ,45 ,7 ,52,30747 , 0 
33241.603,5,171 ,2 ,512 ,0 ,0 ,14 ,5 ,14 ,6 ,7 ,46 ,0 ,51 ,28 ,79,30023 , 0 
33241.607,19,171 ,1 ,256 ,0 ,0 ,12 ,4 ,14 ,6 ,10 ,46 ,0 ,39 ,30 ,69,19904 , 0 
33241.697,17,171 ,16 ,856 ,0 ,0 ,14 ,1 ,2 ,0 ,3 ,20 ,0 ,25 ,6 ,31,24032 , 0 
33241.772,13,171 ,1 ,256 ,0 ,0 ,11 ,5 ,0 ,4 ,0 ,20 ,0 ,33 ,1 ,34,17454 , 0 
33241.787,3,171 ,1 ,256 ,0 ,0 ,9 ,8 ,0 ,5 ,1 ,23 ,0 ,22 ,3 ,25,12525 , 0 
33360.96,8,171 ,1 ,256 ,0 ,0 ,2 ,2 ,1 ,0 ,0 ,5 ,0 ,4 ,1 ,5,13944 , 0 
33361.078,11,171 ,5 ,867 ,0 ,0 ,2 ,2 ,0 ,1 ,0 ,5 ,0 ,12 ,0 ,12,21092 , 0 
33361.124,2,171 ,1 ,256 ,0 ,0 ,2 ,2 ,19 ,2 ,3 ,28 ,0 ,6 ,25 ,31,25129 , 0 
33361.138,6,171 ,2 ,512 ,0 ,0 ,2 ,1 ,2 ,1 ,1 ,7 ,0 ,9 ,4 ,13,35119 , 0 
33361.214,18,171 ,19 ,525 ,0 ,0 ,2 ,1 ,1 ,0 ,0 ,4 ,0 ,5 ,1 ,6,17925 , 0 
33361.236,4,171 ,8 ,537 ,0 ,0 ,2 ,1 ,0 ,0 ,0 ,3 ,0 ,2 ,0 ,2,15974 , 0 
33361.29,7,171 ,9 ,1123 ,0 ,0 ,5 ,5 ,0 ,3 ,0 ,13 ,0 ,12 ,0 ,12,26602 , 0 
33361.337,14,171 ,1 ,256 ,0 ,0 ,1 ,1 ,1 ,0 ,0 ,3 ,0 ,5 ,1 ,6,15937 , 0 
33361.35,15,171 ,9 ,1123 ,0 ,0 ,4 ,4 ,0 ,0 ,0 ,8 ,0 ,10 ,0 ,10,19767 , 0 
33361.36,20,171 ,5 ,867 ,0 ,0 ,2 ,2 ,0 ,0 ,0 ,4 ,0 ,3 ,0 ,3,17094 , 0 
33361.361,16,171 ,2 ,512 ,0 ,0 ,2 ,1 ,11 ,1 ,2 ,17 ,0 ,14 ,13 ,27,36682 , 0 
33361.444,10,171 ,14 ,512 ,0 ,0 ,4 ,1 ,0 ,0 ,0 ,5 ,0 ,2 ,0 ,2,17886 , 0 
33361.482,12,171 ,18 ,944 ,0 ,0 ,3 ,1 ,0 ,0 ,0 ,4 ,0 ,5 ,0 ,5,18614 , 0 
33361.596,9,171 ,16 ,856 ,0 ,0 ,7 ,1 ,8 ,0 ,0 ,16 ,0 ,11 ,10 ,21,31004 , 0 
33361.603,5,171 ,2 ,512 ,0 ,0 ,2 ,1 ,3 ,1 ,0 ,7 ,0 ,14 ,4 ,18,29002 , 0 
33361.607,19,171 ,1 ,256 ,0 ,0 ,2 ,1 ,2 ,1 ,0 ,6 ,0 ,8 ,2 ,10,19363 , 0 
33361.696,17,171 ,6 ,811 ,0 ,0 ,5 ,3 ,0 ,3 ,0 ,11 ,0 ,8 ,0 ,8,23867 , 0 
33361.771,13,171 ,1 ,256 ,0 ,0 ,2 ,1 ,0 ,0 ,0 ,3 ,0 ,4 ,0 ,4,17398 , 0 
33361.787,3,171 ,1 ,256 ,0 ,0 ,2 ,1 ,0 ,0 ,0 ,3 ,0 ,3 ,0 ,3,12133 , 0 
33480.96,8,171 ,1 ,256 ,0 ,0 ,2 ,1 ,1 ,0 ,0 ,4 ,0 ,5 ,1 ,6,13898 , 0 
33481.078,11,171 ,5 ,793 ,0 ,0 ,2 ,4 ,2 ,0 ,0 ,8 ,0 ,15 ,2 ,17,22368 , 0 
33481.124,2,171 ,1 ,256 ,0 ,0 ,1 ,1 ,10 ,0 ,2 ,14 ,0 ,11 ,12 ,23,24044 , 0 
33481.138,6,171 ,2 ,512 ,0 ,0 ,2 ,1 ,1 ,0 ,0 ,4 ,0 ,4 ,1 ,5,30864 , 0 
33481.214,18,171 ,19 ,525 ,0 ,0 ,2 ,0 ,2 ,0 ,0 ,4 ,0 ,9 ,2 ,11,19201 , 0 
33481.236,4,171 ,8 ,527 ,0 ,0 ,2 ,1 ,0 ,0 ,0 ,3 ,0 ,3 ,0 ,3,17111 , 0 
33481.289,7,171 ,9 ,1107 ,0 ,0 ,4 ,2 ,0 ,0 ,0 ,6 ,0 ,6 ,0 ,6,26711 , 0 
33481.337,14,171 ,1 ,256 ,0 ,0 ,2 ,1 ,1 ,0 ,0 ,4 ,0 ,6 ,1 ,7,16512 , 0 
33481.35,15,171 ,9 ,1109 ,0 ,0 ,2 ,1 ,0 ,0 ,0 ,3 ,0 ,6 ,0 ,6,20974 , 0 
33481.36,20,171 ,11 ,1171 ,0 ,0 ,7 ,2 ,0 ,1 ,0 ,10 ,0 ,6 ,0 ,6,18436 , 0 
33481.36,16,171 ,2 ,512 ,0 ,0 ,2 ,1 ,4 ,0 ,0 ,7 ,0 ,7 ,4 ,11,34936 , 0 
33481.444,10,171 ,14 ,512 ,0 ,0 ,2 ,1 ,0 ,0 ,0 ,3 ,0 ,2 ,0 ,2,17351 , 0 
33481.482,12,171 ,18 ,938 ,0 ,0 ,1 ,2 ,0 ,0 ,0 ,3 ,0 ,12 ,0 ,12,20149 , 0 
33481.596,9,171 ,16 ,846 ,0 ,0 ,2 ,1 ,3 ,0 ,0 ,6 ,0 ,10 ,3 ,13,30856 , 0 
33481.603,5,171 ,13 ,512 ,0 ,0 ,6 ,2 ,6 ,1 ,1 ,16 ,0 ,13 ,7 ,20,30215 , 0 
33481.607,19,171 ,1 ,256 ,0 ,0 ,2 ,0 ,2 ,0 ,0 ,4 ,0 ,10 ,2 ,12,19992 , 0 
33481.696,17,171 ,6 ,798 ,0 ,0 ,2 ,1 ,0 ,0 ,0 ,3 ,0 ,6 ,0 ,6,24104 , 0 
33481.771,13,171 ,1 ,256 ,0 ,0 ,2 ,1 ,5 ,0 ,0 ,8 ,0 ,11 ,5 ,16,17555 , 0 
33481.787,3,171 ,1 ,256 ,0 ,0 ,2 ,1 ,0 ,0 ,0 ,3 ,0 ,4 ,0 ,4,12586 , 0 
33600.96,8,171 ,1 ,256 ,0 ,0 ,2 ,1 ,1 ,0 ,0 ,4 ,0 ,1 ,1 ,2,14027 , 0 
33601.078,11,171 ,5 ,606 ,0 ,0 ,2 ,5 ,0 ,1 ,1 ,9 ,0 ,10 ,1 ,11,21196 , 0 
33601.124,2,171 ,1 ,256 ,0 ,0 ,2 ,1 ,9 ,1 ,0 ,13 ,0 ,6 ,9 ,15,25235 , 0 
33601.138,6,171 ,2 ,512 ,0 ,0 ,1 ,1 ,0 ,0 ,0 ,2 ,0 ,4 ,0 ,4,35207 , 0 
33601.214,18,171 ,19 ,516 ,0 ,0 ,0 ,1 ,0 ,0 ,0 ,1 ,0 ,5 ,0 ,5,17992 , 0 
33601.236,4,171 ,8 ,523 ,0 ,0 ,1 ,1 ,0 ,0 ,0 ,2 ,0 ,1 ,0 ,1,16069 , 0 
33601.289,7,171 ,9 ,1107 ,0 ,0 ,1 ,0 ,0 ,0 ,0 ,1 ,0 ,1 ,0 ,1,26703 , 0 
33601.337,14,171 ,1 ,256 ,0 ,0 ,1 ,1 ,0 ,0 ,0 ,2 ,0 ,5 ,0 ,5,16032 , 0 
33601.35,15,171 ,9 ,1109 ,0 ,0 ,1 ,0 ,0 ,0 ,0 ,1 ,0 ,1 ,0 ,1,19870 , 0 
33601.36,20,171 ,5 ,606 ,0 ,0 ,5 ,3 ,0 ,1 ,0 ,9 ,0 ,6 ,0 ,6,17193 , 0 
33601.36,16,171 ,2 ,512 ,0 ,0 ,1 ,2 ,6 ,0 ,0 ,9 ,0 ,5 ,6 ,11,36835 , 0 
33601.444,10,171 ,14 ,512 ,0 ,0 ,2 ,0 ,0 ,0 ,0 ,2 ,0 ,1 ,0 ,1,17964 , 0 
33601.482,12,171 ,18 ,938 ,0 ,0 ,1 ,0 ,0 ,0 ,0 ,1 ,0 ,10 ,0 ,10,18690 , 0 
33601.596,9,171 ,16 ,849 ,0 ,0 ,1 ,1 ,5 ,0 ,0 ,7 ,0 ,7 ,8 ,15,31178 , 1 
33601.603,5,171 ,9 ,300 ,0 ,0 ,6 ,1 ,8 ,1 ,1 ,17 ,0 ,8 ,10 ,18,29216 , 0 
33601.606,19,171 ,1 ,256 ,0 ,0 ,1 ,1 ,1 ,0 ,0 ,3 ,0 ,9 ,1 ,10,19460 , 0 
33601.696,17,171 ,6 ,798 ,0 ,0 ,3 ,0 ,0 ,0 ,0 ,3 ,0 ,0 ,0 ,0,23943 , 0 
33601.771,13,171 ,1 ,256 ,0 ,0 ,2 ,1 ,2 ,1 ,1 ,7 ,0 ,7 ,3 ,10,17491 , 0 
33601.787,3,171 ,1 ,256 ,0 ,0 ,2 ,1 ,0 ,0 ,0 ,3 ,0 ,1 ,0 ,1,12224 , 0 
33720.96,8,171 ,1 ,256 ,0 ,0 ,2 ,0 ,1 ,0 ,0 ,3 ,0 ,3 ,1 ,4,13983 , 0 
33721.078,11,171 ,5 ,596 ,0 ,0 ,1 ,2 ,0 ,0 ,0 ,3 ,0 ,12 ,0 ,12,22478 , 0 
33721.124,2,171 ,1 ,256 ,0 ,0 ,1 ,0 ,9 ,0 ,4 ,14 ,0 ,10 ,13 ,23,24190 , 0 
33721.138,6,171 ,2 ,512 ,0 ,0 ,2 ,0 ,1 ,0 ,0 ,3 ,0 ,8 ,1 ,9,30955 , 0 
33721.214,18,171 ,19 ,516 ,0 ,0 ,2 ,0 ,1 ,0 ,0 ,3 ,0 ,5 ,1 ,6,19306 , 0 
33721.236,4,171 ,8 ,518 ,0 ,0 ,3 ,1 ,0 ,0 ,0 ,4 ,0 ,5 ,0 ,5,17229 , 0 
33721.289,7,171 ,9 ,300 ,0 ,0 ,1 ,4 ,0 ,0 ,0 ,5 ,0 ,13 ,0 ,13,26876 , 0 
33721.337,14,171 ,1 ,256 ,0 ,0 ,3 ,0 ,1 ,0 ,0 ,4 ,0 ,1 ,1 ,2,16597 , 0 
33721.35,15,171 ,9 ,300 ,0 ,0 ,2 ,4 ,0 ,0 ,0 ,6 ,0 ,5 ,0 ,5,21079 , 0 
33721.36,20,171 ,5 ,596 ,0 ,0 ,2 ,2 ,0 ,0 ,0 ,4 ,0 ,4 ,0 ,4,18594 , 0 
33721.361,16,171 ,9 ,300 ,0 ,0 ,7 ,5 ,5 ,8 ,0 ,25 ,0 ,8 ,12 ,20,35211 , 0 
33721.444,10,171 ,14 ,512 ,0 ,0 ,2 ,1 ,0 ,0 ,0 ,3 ,0 ,2 ,0 ,2,17454 , 0 
33721.482,12,171 ,18 ,873 ,0 ,0 ,3 ,1 ,0 ,0 ,0 ,4 ,0 ,4 ,0 ,4,20284 , 0 
33721.596,9,171 ,16 ,556 ,0 ,0 ,6 ,2 ,6 ,4 ,0 ,18 ,0 ,8 ,22 ,30,31117 , 1 
33721.603,5,171 ,9 ,300 ,0 ,0 ,3 ,4 ,4 ,0 ,0 ,11 ,0 ,9 ,4 ,13,30429 , 0 
33721.606,19,171 ,1 ,256 ,0 ,0 ,2 ,0 ,1 ,0 ,0 ,3 ,0 ,6 ,1 ,7,20097 , 0 
33721.696,17,171 ,6 ,784 ,0 ,0 ,1 ,1 ,0 ,0 ,0 ,2 ,0 ,7 ,0 ,7,24218 , 0 
33721.771,13,171 ,1 ,256 ,0 ,0 ,1 ,0 ,0 ,0 ,0 ,1 ,0 ,4 ,0 ,4,17634 , 0 
33721.787,3,171 ,1 ,256 ,0 ,0 ,1 ,0 ,0 ,0 ,0 ,1 ,0 ,2 ,0 ,2,12659 , 0 
33840.96,8,171 ,1 ,256 ,0 ,0 ,0 ,0 ,0 ,0 ,0 ,0 ,0 ,0 ,0 ,0,14086 , 0 
33841.108,11,171 ,5 ,596 ,0 ,0 ,1 ,0 ,221 ,1 ,2 ,225 ,0 ,7 ,228 ,235,22174 , 0 
33841.124,2,171 ,1 ,256 ,0 ,0 ,6 ,0 ,2 ,2 ,2 ,12 ,0 ,5 ,5 ,10,25397 , 0 
33841.138,6,171 ,16 ,624 ,0 ,0 ,7 ,5 ,2 ,1 ,0 ,15 ,0 ,9 ,2 ,11,35427 , 0 
33841.214,18,171 ,19 ,516 ,0 ,0 ,1 ,0 ,0 ,0 ,0 ,1 ,0 ,0 ,0 ,0,18197 , 0 
33841.236,4,171 ,8 ,518 ,0 ,0 ,1 ,0 ,0 ,0 ,0 ,1 ,0 ,0 ,0 ,0,16153 , 0 
33841.289,7,171 ,9 ,300 ,0 ,0 ,6 ,5 ,0 ,0 ,0 ,11 ,0 ,15 ,0 ,15,26885 , 0 
33841.337,14,171 ,1 ,256 ,0 ,0 ,0 ,0 ,0 ,0 ,0 ,0 ,0 ,6 ,0 ,6,16093 , 0 
33841.35,15,171 ,9 ,300 ,0 ,0 ,2 ,5 ,0 ,0 ,0 ,7 ,0 ,11 ,0 ,11,20125 , 0 
33841.36,20,171 ,5 ,596 ,0 ,0 ,2 ,0 ,0 ,0 ,0 ,2 ,0 ,0 ,0 ,0,17274 , 0 
33841.361,16,171 ,9 ,300 ,0 ,0 ,10 ,3 ,4 ,5 ,0 ,22 ,0 ,15 ,13 ,28,37158 , 0 
33841.444,10,171 ,14 ,512 ,0 ,0 ,1 ,0 ,0 ,0 ,0 ,1 ,0 ,5 ,0 ,5,18025 , 0 
33841.482,12,171 ,18 ,873 ,0 ,0 ,0 ,0 ,0 ,0 ,0 ,0 ,0 ,1 ,0 ,1,18788 , 0 
33841.597,9,171 ,11 ,856 ,0 ,0 ,9 ,2 ,234 ,4 ,1 ,250 ,0 ,5 ,245 ,250,32592 , 1 
33841.606,19,171 ,1 ,256 ,0 ,0 ,1 ,0 ,0 ,0 ,0 ,1 ,0 ,5 ,0 ,5,19622 , 0 
33841.697,17,171 ,6 ,812 ,0 ,0 ,8 ,2 ,0 ,0 ,0 ,10 ,0 ,10 ,0 ,10,24071 , 0 
33841.727,5,171 ,9 ,300 ,0 ,0 ,1 ,5 ,221 ,1 ,1 ,229 ,0 ,7 ,224 ,231,30610 , 0 
33841.771,13,171 ,1 ,256 ,0 ,0 ,1 ,0 ,0 ,0 ,0 ,1 ,0 ,2 ,0 ,2,17638 , 0 
33841.787,3,171 ,1 ,256 ,0 ,0 ,1 ,0 ,0 ,0 ,0 ,1 ,0 ,0 ,0 ,0,12277 , 0 
33960.96,8,171 ,1 ,256 ,0 ,0 ,2 ,0 ,0 ,0 ,0 ,2 ,0 ,2 ,0 ,2,14048 , 0 
33961.078,11,171 ,5 ,824 ,0 ,0 ,8 ,3 ,16 ,4 ,3 ,34 ,0 ,12 ,20 ,32,22734 , 0 
33961.124,2,171 ,1 ,256 ,0 ,0 ,4 ,0 ,11 ,0 ,1 ,16 ,0 ,12 ,15 ,27,24332 , 0 
33961.138,6,171 ,2 ,512 ,0 ,0 ,6 ,2 ,0 ,2 ,1 ,11 ,0 ,12 ,1 ,13,31112 , 0 
33961.214,18,171 ,19 ,516 ,0 ,0 ,1 ,0 ,0 ,0 ,0 ,1 ,0 ,3 ,0 ,3,19373 , 0 
33961.236,4,171 ,8 ,518 ,0 ,0 ,1 ,0 ,0 ,0 ,0 ,1 ,0 ,0 ,0 ,0,17287 , 0 
33961.289,7,171 ,15 ,693 ,0 ,0 ,6 ,1 ,0 ,1 ,0 ,8 ,0 ,12 ,1 ,13,27022 , 0 
33961.337,14,171 ,1 ,256 ,0 ,0 ,1 ,0 ,0 ,0 ,0 ,1 ,0 ,3 ,0 ,3,16694 , 0 
33961.35,15,171 ,9 ,1110 ,0 ,0 ,1 ,4 ,4 ,1 ,1 ,11 ,0 ,14 ,13 ,27,21293 , 0 
33961.36,20,171 ,5 ,824 ,0 ,0 ,2 ,4 ,0 ,0 ,0 ,6 ,0 ,10 ,0 ,10,18682 , 0 
33961.361,16,171 ,2 ,512 ,0 ,0 ,4 ,2 ,7 ,2 ,1 ,16 ,0 ,19 ,8 ,27,35455 , 0 
33961.444,10,171 ,14 ,512 ,0 ,0 ,1 ,0 ,0 ,0 ,0 ,1 ,0 ,5 ,0 ,5,17514 , 0 
33961.573,12,171 ,18 ,873 ,0 ,0 ,1 ,0 ,0 ,0 ,0 ,1 ,0 ,13 ,0 ,13,20358 , 0 
33961.596,9,171 ,16 ,824 ,0 ,0 ,5 ,4 ,14 ,3 ,1 ,27 ,0 ,16 ,19 ,35,31412 , 0 
33961.603,5,171 ,13 ,512 ,0 ,0 ,6 ,1 ,15 ,3 ,2 ,27 ,0 ,12 ,18 ,30,30677 , 0 
33961.606,19,171 ,1 ,256 ,0 ,0 ,1 ,0 ,0 ,0 ,0 ,1 ,0 ,7 ,0 ,7,20190 , 0 
33961.697,17,171 ,16 ,824 ,0 ,0 ,5 ,3 ,0 ,2 ,0 ,10 ,0 ,14 ,0 ,14,24338 , 0 
33961.772,13,171 ,1 ,256 ,0 ,0 ,1 ,0 ,10 ,1 ,2 ,14 ,0 ,7 ,14 ,21,17766 , 0 
33961.787,3,171 ,1 ,256 ,0 ,0 ,1 ,0 ,0 ,0 ,0 ,1 ,0 ,1 ,0 ,1,12711 , 0 
34080.96,8,171 ,1 ,256 ,0 ,0 ,1 ,0 ,0 ,0 ,0 ,1 ,0 ,3 ,0 ,3,14165 , 0 
34081.078,11,171 ,5 ,804 ,0 ,0 ,3 ,1 ,0 ,1 ,0 ,5 ,0 ,5 ,0 ,5,22273 , 0 
34081.124,2,171 ,1 ,256 ,0 ,0 ,1 ,0 ,8 ,0 ,0 ,9 ,0 ,8 ,8 ,16,25502 , 0 
34081.138,6,171 ,2 ,512 ,0 ,0 ,2 ,0 ,0 ,0 ,0 ,2 ,0 ,5 ,0 ,5,35518 , 0 
34081.214,18,171 ,19 ,516 ,0 ,0 ,3 ,0 ,1 ,0 ,0 ,4 ,0 ,2 ,1 ,3,18295 , 0 
34081.236,4,171 ,8 ,518 ,0 ,0 ,2 ,0 ,0 ,0 ,0 ,2 ,0 ,3 ,0 ,3,16244 , 0 
34081.289,7,171 ,9 ,1085 ,0 ,0 ,5 ,2 ,0 ,1 ,0 ,8 ,0 ,8 ,0 ,8,26999 , 0 
34081.337,14,171 ,1 ,256 ,0 ,0 ,2 ,0 ,1 ,0 ,0 ,3 ,0 ,2 ,1 ,3,16163 , 0 
34081.35,15,171 ,9 ,1059 ,0 ,0 ,2 ,2 ,0 ,0 ,0 ,4 ,0 ,9 ,1 ,10,20218 , 0 
34081.36,20,171 ,5 ,804 ,0 ,0 ,0 ,0 ,0 ,0 ,0 ,0 ,0 ,4 ,0 ,4,17350 , 0 
34081.36,16,171 ,2 ,512 ,0 ,0 ,3 ,0 ,8 ,0 ,0 ,11 ,0 ,9 ,8 ,17,37330 , 0 
34081.444,10,171 ,14 ,512 ,0 ,0 ,1 ,1 ,0 ,0 ,0 ,2 ,0 ,3 ,0 ,3,18097 , 0 
34081.482,12,171 ,18 ,829 ,0 ,0 ,1 ,1 ,0 ,0 ,0 ,2 ,0 ,5 ,0 ,5,18870 , 0 
34081.596,9,171 ,16 ,789 ,0 ,0 ,4 ,2 ,4 ,0 ,0 ,10 ,0 ,11 ,4 ,15,32764 , 0 
34081.603,5,171 ,13 ,512 ,0 ,0 ,2 ,1 ,1 ,0 ,0 ,4 ,0 ,8 ,2 ,10,30744 , 0 
34081.606,19,171 ,1 ,256 ,0 ,0 ,1 ,0 ,1 ,0 ,0 ,2 ,0 ,4 ,1 ,5,19701 , 0 
34081.696,17,171 ,16 ,789 ,0 ,0 ,2 ,2 ,0 ,0 ,0 ,4 ,0 ,7 ,0 ,7,24173 , 0 
34081.771,13,171 ,1 ,256 ,0 ,0 ,2 ,0 ,2 ,1 ,0 ,5 ,0 ,2 ,2 ,4,17724 , 0 
34081.787,3,171 ,1 ,256 ,0 ,0 ,2 ,0 ,0 ,0 ,0 ,2 ,0 ,2 ,0 ,2,12351 , 0 
34200.96,8,171 ,1 ,256 ,0 ,0 ,1 ,0 ,1 ,0 ,0 ,2 ,0 ,1 ,1 ,2,14110 , 0 
34201.078,11,171 ,5 ,804 ,0 ,0 ,3 ,1 ,0 ,0 ,0 ,4 ,0 ,3 ,0 ,3,22830 , 0 
34201.123,2,171 ,1 ,256 ,0 ,0 ,2 ,0 ,6 ,0 ,0 ,8 ,0 ,2 ,6 ,8,24436 , 0 
34201.138,6,171 ,2 ,512 ,0 ,0 ,1 ,1 ,0 ,0 ,0 ,2 ,0 ,3 ,0 ,3,31187 , 0 
34201.214,18,171 ,19 ,516 ,0 ,0 ,0 ,0 ,0 ,0 ,0 ,0 ,0 ,1 ,0 ,1,19430 , 0 
34201.236,4,171 ,8 ,514 ,0 ,0 ,1 ,1 ,0 ,0 ,0 ,2 ,0 ,2 ,0 ,2,17353 , 0 
34201.289,7,171 ,9 ,1068 ,0 ,0 ,2 ,2 ,0 ,0 ,0 ,4 ,0 ,4 ,0 ,4,27109 , 0 
34201.337,14,171 ,1 ,256 ,0 ,0 ,1 ,0 ,0 ,0 ,0 ,1 ,0 ,2 ,0 ,2,16769 , 0 
34201.35,15,171 ,9 ,1055 ,0 ,0 ,2 ,1 ,0 ,0 ,0 ,3 ,0 ,5 ,0 ,5,21398 , 0 
34201.36,20,171 ,5 ,804 ,0 ,0 ,1 ,1 ,0 ,0 ,0 ,2 ,0 ,2 ,0 ,2,18785 , 0 
34201.36,16,171 ,2 ,512 ,0 ,0 ,1 ,1 ,4 ,0 ,0 ,6 ,0 ,5 ,4 ,9,35578 , 0 
34201.444,10,171 ,14 ,512 ,0 ,0 ,2 ,0 ,0 ,0 ,0 ,2 ,0 ,0 ,0 ,0,17577 , 0 
34201.482,12,171 ,18 ,829 ,0 ,0 ,2 ,0 ,0 ,0 ,0 ,2 ,0 ,2 ,0 ,2,20431 , 0 
34201.596,9,171 ,16 ,804 ,0 ,0 ,2 ,1 ,3 ,0 ,0 ,6 ,0 ,3 ,3 ,6,31525 , 0 
34201.603,5,171 ,13 ,512 ,0 ,0 ,1 ,0 ,1 ,0 ,0 ,2 ,0 ,6 ,1 ,7,30774 , 0 
34201.606,19,171 ,1 ,256 ,0 ,0 ,2 ,0 ,0 ,0 ,0 ,2 ,0 ,5 ,0 ,5,20274 , 0 
34201.697,17,171 ,16 ,789 ,0 ,0 ,1 ,0 ,0 ,0 ,0 ,1 ,0 ,1 ,0 ,1,24411 , 0 
34201.771,13,171 ,1 ,256 ,0 ,0 ,1 ,0 ,1 ,0 ,0 ,2 ,0 ,2 ,1 ,3,17829 , 0 
34201.787,3,171 ,1 ,256 ,0 ,0 ,1 ,0 ,0 ,0 ,0 ,1 ,0 ,2 ,0 ,2,12771 , 0 
34320.96,8,171 ,1 ,256 ,0 ,0 ,1 ,0 ,0 ,0 ,0 ,1 ,0 ,2 ,0 ,2,14240 , 0 
34321.078,11,171 ,5 ,804 ,0 ,0 ,2 ,0 ,0 ,0 ,0 ,2 ,0 ,2 ,0 ,2,22359 , 0 
34321.124,2,171 ,1 ,256 ,0 ,0 ,26 ,0 ,63 ,0 ,0 ,89 ,106 ,22 ,63 ,191,25853 , 0 
34321.214,18,171 ,19 ,516 ,0 ,0 ,1 ,0 ,0 ,0 ,0 ,1 ,0 ,1 ,0 ,1,18367 , 0 
34321.236,4,171 ,8 ,514 ,0 ,0 ,1 ,0 ,0 ,0 ,0 ,1 ,0 ,0 ,0 ,0,16303 , 0 
34321.27,6,171 ,2 ,512 ,0 ,120 ,2 ,15 ,0 ,0 ,0 ,137 ,0 ,76 ,0 ,76,36412 , 1 
34321.289,7,171 ,9 ,1068 ,0 ,0 ,2 ,0 ,0 ,0 ,0 ,2 ,0 ,37 ,0 ,37,27124 , 0 
34321.338,14,171 ,1 ,256 ,0 ,0 ,1 ,0 ,0 ,0 ,0 ,1 ,0 ,34 ,0 ,34,16273 , 0 
34321.35,15,171 ,9 ,1055 ,0 ,0 ,1 ,0 ,0 ,0 ,0 ,1 ,0 ,2 ,0 ,2,20316 , 0 
34321.36,20,171 ,5 ,796 ,0 ,0 ,1 ,1 ,0 ,0 ,0 ,2 ,0 ,2 ,0 ,2,17462 , 0 
34321.361,16,171 ,2 ,512 ,0 ,0 ,25 ,15 ,33 ,0 ,0 ,73 ,106 ,36 ,33 ,175,38023 , 0 
34321.445,10,171 ,14 ,512 ,0 ,0 ,27 ,0 ,0 ,0 ,0 ,27 ,115 ,1 ,0 ,116,18363 , 0 
34321.482,12,171 ,18 ,829 ,0 ,0 ,1 ,0 ,0 ,0 ,0 ,1 ,0 ,2 ,0 ,2,18928 , 0 
34321.596,9,171 ,16 ,782 ,0 ,0 ,1 ,17 ,0 ,0 ,0 ,18 ,0 ,26 ,0 ,26,33084 , 0 
34321.603,5,171 ,13 ,512 ,0 ,0 ,1 ,0 ,1 ,0 ,0 ,2 ,0 ,23 ,1 ,24,30850 , 0 
34321.607,19,171 ,1 ,256 ,0 ,0 ,1 ,0 ,0 ,0 ,0 ,1 ,0 ,22 ,0 ,22,19796 , 0 
34321.77,17,171 ,16 ,782 ,0 ,0 ,25 ,18 ,0 ,0 ,0 ,43 ,108 ,27 ,0 ,135,24559 , 0 
34321.771,13,171 ,1 ,256 ,0 ,0 ,0 ,0 ,1 ,0 ,0 ,1 ,0 ,20 ,1 ,21,17824 , 0 
34321.787,3,171 ,1 ,256 ,0 ,0 ,1 ,0 ,0 ,0 ,0 ,1 ,0 ,0 ,0 ,0,12405 , 0 
34440.96,8,171 ,1 ,256 ,0 ,0 ,1 ,0 ,0 ,0 ,0 ,1 ,0 ,0 ,0 ,0,14193 , 0 
34441.078,11,171 ,5 ,804 ,0 ,0 ,1 ,0 ,0 ,0 ,0 ,1 ,0 ,3 ,0 ,3,22913 , 0 
34441.124,2,171 ,1 ,256 ,0 ,0 ,25 ,0 ,65 ,0 ,0 ,90 ,106 ,23 ,65 ,194,24803 , 0 
34441.15,6,171 ,2 ,512 ,0 ,120 ,1 ,16 ,0 ,0 ,0 ,137 ,0 ,86 ,0 ,86,32086 , 1 
34441.214,18,171 ,19 ,516 ,0 ,0 ,1 ,0 ,1 ,0 ,0 ,2 ,0 ,0 ,1 ,1,19562 , 0 
34441.236,4,171 ,8 ,514 ,0 ,0 ,1 ,0 ,0 ,0 ,0 ,1 ,0 ,0 ,0 ,0,17475 , 0 
34441.289,7,171 ,9 ,1068 ,0 ,0 ,2 ,0 ,0 ,0 ,0 ,2 ,0 ,47 ,0 ,47,27229 , 0 
34441.338,14,171 ,1 ,256 ,0 ,0 ,2 ,0 ,0 ,0 ,0 ,2 ,0 ,40 ,0 ,40,16861 , 0 
34441.35,15,171 ,9 ,1224 ,0 ,0 ,1 ,0 ,0 ,0 ,0 ,1 ,0 ,1 ,0 ,1,21461 , 0 
34441.36,20,171 ,5 ,796 ,0 ,0 ,2 ,0 ,0 ,0 ,0 ,2 ,0 ,1 ,0 ,1,18850 , 0 
34441.362,16,171 ,2 ,512 ,0 ,0 ,27 ,13 ,36 ,0 ,0 ,76 ,108 ,41 ,36 ,185,36319 , 0 
34441.445,10,171 ,14 ,512 ,0 ,0 ,25 ,0 ,0 ,0 ,0 ,25 ,107 ,0 ,0 ,107,17846 , 0 
34441.482,12,171 ,18 ,817 ,0 ,0 ,0 ,1 ,0 ,0 ,0 ,1 ,0 ,2 ,0 ,2,20536 , 0 
34441.596,9,171 ,16 ,792 ,0 ,0 ,1 ,17 ,0 ,0 ,0 ,18 ,0 ,23 ,0 ,23,31810 , 0 
34441.603,5,171 ,13 ,512 ,0 ,0 ,1 ,0 ,0 ,0 ,0 ,1 ,0 ,23 ,0 ,23,30902 , 0 
34441.607,19,171 ,1 ,256 ,0 ,0 ,1 ,0 ,1 ,0 ,0 ,2 ,0 ,24 ,1 ,25,20391 , 0 
34441.771,13,171 ,1 ,256 ,0 ,0 ,1 ,0 ,0 ,0 ,0 ,1 ,0 ,20 ,0 ,20,17958 , 0 
34441.787,3,171 ,1 ,256 ,0 ,0 ,1 ,0 ,0 ,0 ,0 ,1 ,0 ,2 ,0 ,2,12858 , 0 
34441.811,17,171 ,16 ,792 ,0 ,0 ,25 ,18 ,0 ,0 ,0 ,43 ,107 ,24 ,0 ,131,24832 , 0 
34560.96,8,171 ,1 ,256 ,0 ,0 ,1 ,0 ,0 ,0 ,0 ,1 ,0 ,0 ,0 ,0,14307 , 0 
34561.078,11,171 ,5 ,892 ,0 ,0 ,1 ,3 ,0 ,0 ,0 ,4 ,0 ,4 ,0 ,4,22472 , 0 
34561.125,2,171 ,1 ,256 ,0 ,0 ,25 ,0 ,76 ,0 ,1 ,102 ,107 ,22 ,77 ,206,26248 , 0 
34561.214,18,171 ,19 ,516 ,0 ,0 ,1 ,0 ,0 ,0 ,0 ,1 ,0 ,2 ,0 ,2,18439 , 0 
34561.236,4,171 ,8 ,514 ,0 ,0 ,1 ,0 ,0 ,0 ,0 ,1 ,0 ,1 ,0 ,1,16392 , 0 
34561.27,6,171 ,2 ,514 ,0 ,120 ,1 ,15 ,1 ,0 ,0 ,137 ,0 ,83 ,1 ,84,37335 , 1 
34561.289,7,171 ,9 ,1068 ,0 ,0 ,1 ,0 ,0 ,0 ,0 ,1 ,0 ,42 ,0 ,42,27269 , 0 
34561.338,14,171 ,1 ,256 ,0 ,0 ,1 ,0 ,0 ,0 ,0 ,1 ,0 ,41 ,0 ,41,16378 , 0 
34561.35,15,171 ,9 ,1224 ,0 ,0 ,1 ,0 ,0 ,0 ,0 ,1 ,0 ,2 ,0 ,2,20440 , 0 
34561.36,20,171 ,5 ,892 ,0 ,0 ,1 ,2 ,0 ,0 ,0 ,3 ,0 ,3 ,0 ,3,17555 , 0 
34561.361,16,171 ,2 ,514 ,0 ,0 ,25 ,17 ,33 ,0 ,1 ,76 ,108 ,40 ,34 ,182,38852 , 0 
34561.445,10,171 ,14 ,512 ,0 ,0 ,25 ,0 ,0 ,0 ,0 ,25 ,108 ,1 ,0 ,109,18621 , 0 
34561.482,12,171 ,18 ,817 ,0 ,0 ,1 ,0 ,0 ,0 ,0 ,1 ,0 ,2 ,0 ,2,19049 , 0 
34561.596,9,171 ,16 ,879 ,0 ,0 ,1 ,23 ,0 ,0 ,0 ,24 ,0 ,26 ,0 ,26,33415 , 0 
34561.603,5,171 ,2 ,514 ,0 ,0 ,5 ,7 ,5 ,1 ,0 ,18 ,0 ,26 ,5 ,31,31173 , 0 
34561.607,19,171 ,1 ,256 ,0 ,0 ,1 ,0 ,0 ,0 ,0 ,1 ,0 ,26 ,0 ,26,19904 , 0 
34561.697,17,171 ,6 ,887 ,0 ,0 ,25 ,11 ,0 ,1 ,0 ,37 ,106 ,22 ,0 ,128,24909 , 0 
34561.771,13,171 ,1 ,256 ,0 ,0 ,1 ,0 ,1 ,0 ,1 ,3 ,0 ,23 ,2 ,25,17933 , 0 
34561.787,3,171 ,1 ,256 ,0 ,0 ,2 ,0 ,0 ,0 ,0 ,2 ,0 ,0 ,0 ,0,12518 , 0 
34680.96,8,171 ,1 ,256 ,0 ,0 ,1 ,0 ,0 ,0 ,0 ,1 ,0 ,1 ,0 ,1,14249 , 0 
34681.078,11,171 ,5 ,813 ,0 ,0 ,1 ,1 ,0 ,0 ,0 ,2 ,0 ,3 ,0 ,3,22996 , 0 
34681.124,2,171 ,1 ,256 ,0 ,0 ,5 ,0 ,18 ,0 ,0 ,23 ,1 ,7 ,19 ,27,24946 , 0 
34681.138,6,171 ,2 ,512 ,0 ,0 ,0 ,5 ,0 ,0 ,0 ,5 ,0 ,17 ,0 ,17,32187 , 0 
34681.214,18,171 ,19 ,516 ,0 ,0 ,2 ,0 ,0 ,0 ,0 ,2 ,0 ,1 ,0 ,1,19637 , 0 
34681.236,4,171 ,8 ,514 ,0 ,0 ,1 ,0 ,0 ,0 ,0 ,1 ,0 ,1 ,0 ,1,17531 , 0 
34681.289,7,171 ,9 ,1068 ,0 ,0 ,1 ,0 ,0 ,0 ,0 ,1 ,0 ,10 ,0 ,10,27303 , 0 
34681.337,14,171 ,1 ,256 ,0 ,0 ,1 ,0 ,1 ,0 ,0 ,2 ,0 ,9 ,1 ,10,16999 , 0 
34681.35,15,171 ,9 ,1356 ,0 ,0 ,0 ,0 ,0 ,0 ,0 ,0 ,0 ,1 ,0 ,1,21517 , 0 
34681.36,20,171 ,5 ,813 ,0 ,0 ,1 ,1 ,0 ,0 ,0 ,2 ,0 ,1 ,0 ,1,18932 , 0 
34681.361,16,171 ,2 ,512 ,0 ,0 ,5 ,3 ,4 ,1 ,0 ,13 ,0 ,8 ,4 ,12,36500 , 0 
34681.444,10,171 ,14 ,512 ,0 ,0 ,5 ,1 ,0 ,0 ,0 ,6 ,0 ,1 ,0 ,1,17937 , 0 
34681.482,12,171 ,18 ,844 ,0 ,0 ,1 ,0 ,0 ,0 ,0 ,1 ,0 ,3 ,0 ,3,20597 , 0 
34681.596,9,171 ,16 ,854 ,0 ,0 ,2 ,5 ,0 ,0 ,0 ,7 ,0 ,6 ,0 ,6,31945 , 0 
34681.602,5,171 ,2 ,512 ,0 ,0 ,2 ,4 ,2 ,0 ,0 ,8 ,0 ,6 ,2 ,8,31058 , 0 
34681.606,19,171 ,1 ,256 ,0 ,0 ,2 ,0 ,0 ,0 ,0 ,2 ,0 ,7 ,0 ,7,20539 , 0 
34681.696,17,171 ,6 ,887 ,0 ,0 ,5 ,0 ,0 ,0 ,0 ,5 ,0 ,5 ,0 ,5,24934 , 0 
34681.771,13,171 ,1 ,256 ,0 ,0 ,2 ,0 ,0 ,1 ,0 ,3 ,0 ,6 ,0 ,6,18047 , 0 
34681.787,3,171 ,1 ,256 ,0 ,0 ,0 ,0 ,0 ,0 ,0 ,0 ,0 ,0 ,0 ,0,12913 , 0 
34800.96,8,171 ,1 ,256 ,0 ,0 ,2 ,0 ,0 ,0 ,0 ,2 ,0 ,2 ,0 ,2,14392 , 0 
34801.078,11,171 ,5 ,800 ,0 ,0 ,1 ,1 ,0 ,0 ,0 ,2 ,0 ,3 ,0 ,3,22541 , 0 
34801.124,2,171 ,1 ,256 ,0 ,0 ,3 ,0 ,8 ,0 ,0 ,11 ,0 ,3 ,8 ,11,26362 , 0 
34801.138,6,171 ,2 ,512 ,0 ,0 ,2 ,2 ,0 ,0 ,0 ,4 ,0 ,8 ,0 ,8,37409 , 0 
34801.214,18,171 ,19 ,516 ,0 ,0 ,0 ,0 ,0 ,0 ,0 ,0 ,0 ,3 ,0 ,3,18509 , 0 
34801.236,4,171 ,8 ,512 ,0 ,0 ,1 ,0 ,0 ,0 ,0 ,1 ,0 ,1 ,0 ,1,16468 , 0 
34801.337,14,171 ,1 ,256 ,0 ,0 ,1 ,0 ,0 ,0 ,0 ,1 ,0 ,5 ,0 ,5,16448 , 0 
34801.349,7,171 ,16 ,830 ,0 ,0 ,1 ,0 ,0 ,1 ,0 ,2 ,0 ,4 ,0 ,4,27353 , 0 
34801.35,15,171 ,9 ,1356 ,0 ,0 ,1 ,0 ,0 ,0 ,0 ,1 ,0 ,0 ,0 ,0,20523 , 0 
34801.36,20,171 ,5 ,800 ,0 ,0 ,1 ,1 ,0 ,0 ,0 ,2 ,0 ,2 ,0 ,2,17614 , 0 
34801.36,16,171 ,2 ,512 ,0 ,0 ,3 ,2 ,0 ,0 ,0 ,5 ,0 ,5 ,0 ,5,38959 , 0 
34801.444,10,171 ,14 ,512 ,0 ,0 ,3 ,0 ,0 ,0 ,0 ,3 ,0 ,0 ,0 ,0,18687 , 0 
34801.482,12,171 ,18 ,844 ,0 ,0 ,1 ,0 ,0 ,0 ,0 ,1 ,0 ,2 ,0 ,2,19119 , 0 
34801.596,9,171 ,16 ,830 ,0 ,0 ,1 ,0 ,0 ,0 ,1 ,2 ,0 ,4 ,1 ,5,33492 , 0 
34801.602,5,171 ,2 ,512 ,0 ,0 ,2 ,2 ,2 ,0 ,0 ,6 ,0 ,3 ,2 ,5,31279 , 0 
34801.606,19,171 ,1 ,256 ,0 ,0 ,1 ,0 ,0 ,0 ,0 ,1 ,0 ,4 ,0 ,4,19968 , 0 
34801.696,17,171 ,6 ,792 ,0 ,0 ,3 ,0 ,0 ,0 ,0 ,3 ,0 ,3 ,0 ,3,24989 , 0 
34801.771,13,171 ,1 ,256 ,0 ,0 ,1 ,0 ,0 ,0 ,0 ,1 ,0 ,4 ,0 ,4,18011 , 0 
34801.787,3,171 ,1 ,256 ,0 ,0 ,2 ,0 ,0 ,0 ,0 ,2 ,0 ,2 ,0 ,2,12585 , 0 
34920.96,8,171 ,1 ,256 ,0 ,0 ,1 ,0 ,1 ,0 ,0 ,2 ,0 ,0 ,1 ,1,14317 , 0 
34921.078,11,171 ,5 ,800 ,0 ,0 ,2 ,0 ,0 ,0 ,0 ,2 ,0 ,2 ,0 ,2,23065 , 0 
34921.123,2,171 ,1 ,256 ,0 ,0 ,2 ,0 ,5 ,0 ,1 ,8 ,0 ,0 ,6 ,6,25034 , 0 
34921.138,6,171 ,2 ,512 ,0 ,0 ,1 ,1 ,0 ,0 ,0 ,2 ,0 ,3 ,0 ,3,32279 , 0 
34921.214,18,171 ,19 ,516 ,0 ,0 ,1 ,0 ,0 ,0 ,0 ,1 ,0 ,0 ,0 ,0,19699 , 0 
34921.236,4,171 ,8 ,512 ,0 ,0 ,0 ,1 ,0 ,0 ,0 ,1 ,0 ,0 ,0 ,0,17596 , 0 
34921.289,7,171 ,16 ,830 ,0 ,0 ,5 ,1 ,0 ,0 ,0 ,6 ,0 ,4 ,0 ,4,27403 , 0 
34921.337,14,171 ,1 ,256 ,0 ,0 ,1 ,0 ,0 ,0 ,0 ,1 ,0 ,2 ,0 ,2,17071 , 0 
34921.35,15,171 ,9 ,1269 ,0 ,0 ,1 ,1 ,0 ,0 ,0 ,2 ,0 ,7 ,0 ,7,21596 , 0 
34921.36,20,171 ,5 ,800 ,0 ,0 ,1 ,0 ,0 ,0 ,0 ,1 ,0 ,2 ,0 ,2,18990 , 0 
34921.36,16,171 ,2 ,512 ,0 ,0 ,1 ,1 ,3 ,0 ,1 ,6 ,0 ,6 ,5 ,11,36634 , 0 
34921.444,10,171 ,14 ,512 ,0 ,0 ,1 ,0 ,0 ,0 ,0 ,1 ,0 ,1 ,0 ,1,18007 , 0 
34921.482,12,171 ,18 ,844 ,0 ,0 ,1 ,0 ,0 ,0 ,0 ,1 ,0 ,1 ,0 ,1,20673 , 0 
34921.596,9,171 ,16 ,830 ,0 ,0 ,2 ,1 ,1 ,1 ,0 ,5 ,0 ,6 ,1 ,7,32058 , 0 
34921.602,5,171 ,2 ,512 ,0 ,0 ,1 ,0 ,0 ,0 ,0 ,1 ,0 ,3 ,0 ,3,31149 , 0 
34921.606,19,171 ,1 ,256 ,0 ,0 ,1 ,0 ,0 ,0 ,0 ,1 ,0 ,3 ,0 ,3,20625 , 0 
34921.696,17,171 ,6 ,792 ,0 ,0 ,1 ,0 ,0 ,0 ,0 ,1 ,0 ,4 ,0 ,4,25002 , 0 
34921.771,13,171 ,1 ,256 ,0 ,0 ,2 ,0 ,0 ,0 ,0 ,2 ,0 ,1 ,0 ,1,18116 , 0 
34921.787,3,171 ,1 ,256 ,0 ,0 ,2 ,0 ,0 ,0 ,0 ,2 ,0 ,1 ,0 ,1,12969 , 0 
35040.96,8,171 ,1 ,256 ,0 ,0 ,1 ,0 ,1 ,0 ,0 ,2 ,0 ,0 ,1 ,1,14470 , 0 
35041.078,11,171 ,5 ,785 ,0 ,0 ,1 ,1 ,0 ,0 ,0 ,2 ,0 ,4 ,0 ,4,22667 , 0 
35041.124,2,171 ,1 ,256 ,0 ,0 ,2 ,0 ,4 ,0 ,1 ,7 ,0 ,5 ,5 ,10,26459 , 0 
35041.138,6,171 ,2 ,512 ,0 ,0 ,4 ,0 ,2 ,0 ,0 ,6 ,0 ,8 ,2 ,10,37528 , 0 
35041.214,18,171 ,19 ,516 ,0 ,0 ,1 ,0 ,0 ,0 ,0 ,1 ,0 ,2 ,0 ,2,18585 , 0 
35041.236,4,171 ,8 ,512 ,0 ,0 ,2 ,1 ,0 ,0 ,0 ,3 ,0 ,1 ,0 ,1,16568 , 0 
35041.289,7,171 ,16 ,65535 ,0 ,0 ,4 ,0 ,0 ,1 ,0 ,5 ,0 ,7 ,0 ,7,27439 , 0 
35041.337,14,171 ,1 ,256 ,0 ,0 ,1 ,0 ,0 ,0 ,0 ,1 ,0 ,1 ,0 ,1,16527 , 0 
35041.35,15,171 ,9 ,1269 ,0 ,0 ,2 ,0 ,0 ,0 ,0 ,2 ,0 ,2 ,0 ,2,20591 , 0 
35041.36,20,171 ,5 ,785 ,0 ,0 ,1 ,1 ,0 ,0 ,0 ,2 ,0 ,2 ,0 ,2,17730 , 0 
35041.361,16,171 ,2 ,512 ,0 ,0 ,3 ,0 ,0 ,0 ,1 ,4 ,0 ,10 ,1 ,11,39063 , 1 
35041.444,10,171 ,14 ,512 ,0 ,0 ,1 ,0 ,0 ,0 ,0 ,1 ,0 ,2 ,0 ,2,18746 , 0 
35041.482,12,171 ,18 ,823 ,0 ,0 ,1 ,0 ,0 ,0 ,0 ,1 ,0 ,3 ,0 ,3,19215 , 0 
35041.596,9,171 ,16 ,830 ,0 ,0 ,1 ,0 ,0 ,0 ,0 ,1 ,0 ,4 ,0 ,4,33579 , 0 
35041.602,5,171 ,2 ,512 ,0 ,0 ,2 ,0 ,2 ,0 ,0 ,4 ,0 ,0 ,2 ,2,31408 , 0 
35041.606,19,171 ,1 ,256 ,0 ,0 ,0 ,0 ,0 ,0 ,0 ,0 ,0 ,3 ,0 ,3,20055 , 0 
35041.696,17,171 ,6 ,830 ,0 ,0 ,6 ,2 ,0 ,0 ,0 ,8 ,0 ,9 ,0 ,9,25102 , 0 
35041.771,13,171 ,1 ,256 ,0 ,0 ,1 ,0 ,0 ,0 ,0 ,1 ,0 ,2 ,0 ,2,18107 , 0 
35041.787,3,171 ,1 ,256 ,0 ,0 ,0 ,0 ,0 ,0 ,0 ,0 ,0 ,0 ,0 ,0,12644 , 0 
35160.96,8,171 ,1 ,256 ,0 ,0 ,2 ,0 ,0 ,0 ,0 ,2 ,0 ,2 ,0 ,2,14380 , 0 
35161.078,11,171 ,5 ,785 ,0 ,0 ,2 ,0 ,0 ,0 ,0 ,2 ,0 ,3 ,0 ,3,23141 , 0 
35161.123,2,171 ,1 ,256 ,0 ,0 ,1 ,0 ,5 ,0 ,1 ,7 ,0 ,3 ,6 ,9,25118 , 0 
35161.138,6,171 ,2 ,512 ,0 ,0 ,4 ,0 ,3 ,0 ,0 ,7 ,0 ,8 ,3 ,11,32382 , 0 
35161.214,18,171 ,19 ,516 ,0 ,0 ,2 ,0 ,0 ,0 ,0 ,2 ,0 ,3 ,0 ,3,19783 , 0 
35161.236,4,171 ,8 ,512 ,0 ,0 ,2 ,0 ,0 ,0 ,0 ,2 ,0 ,2 ,0 ,2,17669 , 0 
35161.29,7,171 ,17 ,1074 ,0 ,0 ,7 ,1 ,0 ,1 ,0 ,9 ,0 ,10 ,0 ,10,27524 , 0 
35161.337,14,171 ,1 ,256 ,0 ,0 ,0 ,0 ,0 ,0 ,0 ,0 ,0 ,5 ,0 ,5,17128 , 0 
35161.35,15,171 ,9 ,65535 ,0 ,0 ,2 ,0 ,0 ,1 ,0 ,3 ,0 ,8 ,0 ,8,21697 , 0 
35161.36,20,171 ,5 ,785 ,0 ,0 ,0 ,0 ,0 ,0 ,0 ,0 ,0 ,1 ,0 ,1,19041 , 0 
35161.361,16,171 ,2 ,512 ,0 ,0 ,2 ,0 ,1 ,0 ,1 ,4 ,0 ,15 ,2 ,17,36733 , 1 
35161.444,10,171 ,14 ,512 ,0 ,0 ,2 ,0 ,0 ,0 ,0 ,2 ,0 ,4 ,0 ,4,18066 , 0 
35161.482,12,171 ,18 ,823 ,0 ,0 ,1 ,0 ,0 ,0 ,0 ,1 ,0 ,1 ,0 ,1,20734 , 0 
35161.596,9,171 ,16 ,65535 ,0 ,0 ,2 ,0 ,1 ,1 ,0 ,4 ,0 ,6 ,3 ,9,32166 , 0 
35161.602,5,171 ,2 ,512 ,0 ,0 ,2 ,1 ,0 ,0 ,0 ,3 ,0 ,6 ,0 ,6,31259 , 0 
35161.606,19,171 ,1 ,256 ,0 ,0 ,1 ,0 ,0 ,0 ,0 ,1 ,0 ,5 ,0 ,5,20702 , 0 
35161.696,17,171 ,6 ,812 ,0 ,0 ,7 ,3 ,0 ,0 ,0 ,10 ,0 ,9 ,0 ,9,25125 , 0 
35161.771,13,171 ,1 ,256 ,0 ,0 ,1 ,0 ,0 ,0 ,0 ,1 ,0 ,1 ,0 ,1,18174 , 0 
35161.787,3,171 ,1 ,256 ,0 ,0 ,2 ,0 ,0 ,0 ,0 ,2 ,0 ,1 ,0 ,1,13031 , 0 
35280.96,8,171 ,1 ,256 ,0 ,0 ,0 ,0 ,0 ,0 ,0 ,0 ,0 ,2 ,0 ,2,14526 , 0 
35281.078,11,171 ,5 ,858 ,0 ,0 ,5 ,4 ,9 ,0 ,0 ,18 ,0 ,21 ,9 ,30,22805 , 0 
35281.124,2,171 ,1 ,256 ,0 ,0 ,10 ,0 ,45 ,0 ,0 ,55 ,0 ,14 ,46 ,60,26670 , 0 
35281.139,6,171 ,2 ,512 ,0 ,0 ,11 ,4 ,16 ,0 ,0 ,31 ,0 ,16 ,16 ,32,37811 , 0 
35281.214,18,171 ,19 ,516 ,0 ,0 ,1 ,0 ,1 ,0 ,0 ,2 ,0 ,4 ,1 ,5,18672 , 0 
35281.236,4,171 ,8 ,512 ,0 ,0 ,0 ,0 ,0 ,0 ,0 ,0 ,0 ,0 ,0 ,0,16620 , 0 
35281.29,7,171 ,17 ,1049 ,0 ,0 ,11 ,7 ,0 ,0 ,0 ,18 ,0 ,26 ,0 ,26,27634 , 0 
35281.337,14,171 ,1 ,256 ,0 ,0 ,2 ,0 ,0 ,0 ,0 ,2 ,0 ,8 ,0 ,8,16607 , 0 
35281.35,15,171 ,11 ,1115 ,0 ,0 ,7 ,5 ,0 ,0 ,0 ,12 ,0 ,22 ,0 ,22,20730 , 0 
35281.36,20,171 ,5 ,858 ,0 ,0 ,2 ,4 ,0 ,0 ,0 ,6 ,0 ,9 ,0 ,9,17830 , 0 
35281.361,16,171 ,2 ,512 ,0 ,0 ,5 ,4 ,0 ,1 ,0 ,10 ,0 ,39 ,0 ,39,39238 , 1 
35281.444,10,171 ,14 ,512 ,0 ,0 ,1 ,0 ,0 ,0 ,0 ,1 ,0 ,12 ,0 ,12,18822 , 0 
35281.482,12,171 ,18 ,812 ,0 ,0 ,1 ,1 ,0 ,0 ,0 ,2 ,0 ,10 ,0 ,10,19306 , 0 
35281.596,9,171 ,11 ,1220 ,0 ,0 ,11 ,4 ,0 ,0 ,0 ,15 ,0 ,24 ,0 ,24,33772 , 0 
35281.603,5,171 ,2 ,512 ,0 ,0 ,5 ,5 ,17 ,0 ,0 ,27 ,0 ,18 ,17 ,35,31731 , 0 
35281.607,19,171 ,1 ,256 ,0 ,0 ,1 ,0 ,1 ,0 ,0 ,2 ,0 ,12 ,1 ,13,20156 , 0 
35281.697,17,171 ,6 ,774 ,0 ,0 ,12 ,9 ,7 ,0 ,0 ,28 ,0 ,22 ,7 ,29,25336 , 0 
35281.771,13,171 ,1 ,256 ,0 ,0 ,1 ,0 ,0 ,0 ,0 ,1 ,0 ,9 ,0 ,9,18203 , 0 
35281.787,3,171 ,1 ,256 ,0 ,0 ,2 ,0 ,0 ,0 ,0 ,2 ,0 ,0 ,0 ,0,12702 , 0 
35400.96,8,171 ,1 ,256 ,0 ,0 ,1 ,0 ,0 ,0 ,0 ,1 ,0 ,2 ,0 ,2,14461 , 0 
35401.078,11,171 ,5 ,811 ,0 ,0 ,3 ,1 ,1 ,1 ,1 ,7 ,0 ,8 ,2 ,10,23235 , 0 
35401.124,2,171 ,1 ,256 ,0 ,0 ,4 ,0 ,26 ,0 ,1 ,31 ,0 ,5 ,27 ,32,25240 , 0 
35401.138,6,171 ,2 ,512 ,0 ,0 ,5 ,4 ,9 ,0 ,0 ,18 ,0 ,9 ,9 ,18,32596 , 0 
35401.214,18,171 ,19 ,516 ,0 ,0 ,1 ,0 ,0 ,0 ,0 ,1 ,0 ,2 ,0 ,2,19849 , 0 
35401.236,4,171 ,8 ,527 ,0 ,0 ,2 ,0 ,0 ,0 ,0 ,2 ,0 ,1 ,0 ,1,17738 , 0 
35401.29,7,171 ,17 ,1088 ,0 ,0 ,5 ,4 ,0 ,0 ,0 ,9 ,0 ,11 ,0 ,11,27641 , 0 
35401.337,14,171 ,1 ,256 ,0 ,0 ,1 ,0 ,0 ,0 ,0 ,1 ,0 ,4 ,0 ,4,17203 , 0 
35401.35,15,171 ,11 ,1114 ,0 ,0 ,0 ,1 ,0 ,0 ,0 ,1 ,0 ,11 ,0 ,11,21761 , 0 
35401.36,20,171 ,5 ,811 ,0 ,0 ,1 ,1 ,0 ,0 ,0 ,2 ,0 ,3 ,0 ,3,19133 , 0 
35401.361,16,171 ,2 ,512 ,0 ,0 ,1 ,4 ,0 ,0 ,0 ,5 ,0 ,22 ,0 ,22,36855 , 0 
35401.444,10,171 ,14 ,512 ,0 ,0 ,1 ,0 ,0 ,0 ,0 ,1 ,0 ,4 ,0 ,4,18139 , 0 
35401.482,12,171 ,18 ,812 ,0 ,0 ,1 ,0 ,0 ,0 ,0 ,1 ,0 ,4 ,0 ,4,20819 , 0 
35401.596,9,171 ,5 ,811 ,0 ,0 ,7 ,2 ,0 ,1 ,0 ,10 ,0 ,9 ,0 ,9,32311 , 0 
35401.603,5,171 ,2 ,512 ,0 ,0 ,3 ,4 ,5 ,0 ,1 ,13 ,0 ,14 ,7 ,21,31462 , 0 
35401.606,19,171 ,1 ,256 ,0 ,0 ,1 ,0 ,0 ,0 ,0 ,1 ,0 ,5 ,0 ,5,20787 , 0 
35401.697,17,171 ,6 ,777 ,0 ,0 ,4 ,5 ,4 ,0 ,0 ,13 ,0 ,9 ,4 ,13,25284 , 0 
35401.771,13,171 ,1 ,256 ,0 ,0 ,1 ,0 ,0 ,0 ,0 ,1 ,0 ,7 ,0 ,7,18285 , 0 
35401.787,3,171 ,1 ,256 ,0 ,0 ,1 ,0 ,0 ,0 ,0 ,1 ,0 ,1 ,0 ,1,13119 , 0 
35520.96,8,171 ,1 ,256 ,0 ,0 ,2 ,0 ,0 ,0 ,0 ,2 ,0 ,0 ,0 ,0,14597 , 0 
35521.078,11,171 ,5 ,811 ,0 ,0 ,1 ,0 ,0 ,0 ,0 ,1 ,0 ,6 ,0 ,6,22883 , 0 
35521.123,2,171 ,1 ,256 ,0 ,0 ,2 ,0 ,6 ,0 ,1 ,9 ,0 ,2 ,7 ,9,26788 , 0 
35521.138,6,171 ,2 ,531 ,0 ,0 ,2 ,1 ,2 ,0 ,0 ,5 ,0 ,3 ,2 ,5,37901 , 0 
35521.214,18,171 ,19 ,516 ,0 ,0 ,0 ,0 ,0 ,0 ,0 ,0 ,0 ,0 ,0 ,0,18727 , 0 
35521.236,4,171 ,8 ,527 ,0 ,0 ,0 ,0 ,0 ,0 ,0 ,0 ,0 ,1 ,0 ,1,16681 , 0 
35521.289,7,171 ,17 ,1111 ,0 ,0 ,3 ,1 ,0 ,0 ,0 ,4 ,0 ,7 ,0 ,7,27709 , 0 
35521.337,14,171 ,1 ,256 ,0 ,0 ,1 ,0 ,0 ,0 ,0 ,1 ,0 ,4 ,0 ,4,16679 , 0 
35521.35,15,171 ,11 ,1114 ,0 ,0 ,2 ,0 ,0 ,0 ,0 ,2 ,0 ,7 ,0 ,7,20825 , 0 
35521.36,20,171 ,5 ,811 ,0 ,0 ,1 ,0 ,0 ,0 ,0 ,1 ,0 ,1 ,0 ,1,17907 , 0 
35521.361,16,171 ,2 ,531 ,0 ,0 ,1 ,1 ,1 ,0 ,0 ,3 ,0 ,11 ,1 ,12,39355 , 0 
35521.444,10,171 ,14 ,512 ,0 ,0 ,2 ,0 ,0 ,0 ,0 ,2 ,0 ,1 ,0 ,1,18882 , 0 
35521.482,12,171 ,18 ,812 ,0 ,0 ,1 ,0 ,0 ,0 ,0 ,1 ,0 ,1 ,0 ,1,19396 , 0 
35521.596,9,171 ,16 ,813 ,0 ,0 ,6 ,1 ,0 ,1 ,0 ,8 ,0 ,4 ,0 ,4,33889 , 0 
35521.602,5,171 ,2 ,531 ,0 ,0 ,0 ,1 ,0 ,0 ,1 ,2 ,0 ,7 ,1 ,8,31814 , 0 
35521.606,19,171 ,1 ,256 ,0 ,0 ,1 ,0 ,0 ,0 ,0 ,1 ,0 ,2 ,0 ,2,20237 , 0 
35521.696,17,171 ,6 ,774 ,0 ,0 ,2 ,1 ,1 ,0 ,0 ,4 ,0 ,3 ,1 ,4,25439 , 0 
35521.771,13,171 ,1 ,256 ,0 ,0 ,1 ,0 ,0 ,0 ,0 ,1 ,0 ,2 ,0 ,2,18281 , 0 
35521.787,3,171 ,1 ,256 ,0 ,0 ,1 ,0 ,0 ,0 ,0 ,1 ,0 ,0 ,0 ,0,12753 , 0 
35640.96,8,171 ,1 ,256 ,0 ,0 ,0 ,0 ,0 ,0 ,0 ,0 ,0 ,3 ,0 ,3,14520 , 0 
35641.078,11,171 ,5 ,801 ,0 ,0 ,1 ,1 ,0 ,0 ,0 ,2 ,0 ,4 ,0 ,4,23305 , 0 
35641.123,2,171 ,1 ,256 ,0 ,0 ,1 ,0 ,4 ,0 ,1 ,6 ,0 ,2 ,6 ,8,25333 , 0 
35641.138,6,171 ,2 ,531 ,0 ,0 ,2 ,0 ,1 ,0 ,1 ,4 ,0 ,2 ,2 ,4,32691 , 0 
35641.214,18,171 ,19 ,516 ,0 ,0 ,2 ,0 ,0 ,0 ,0 ,2 ,0 ,1 ,0 ,1,19922 , 0 
35641.236,4,171 ,8 ,527 ,0 ,0 ,1 ,0 ,0 ,0 ,0 ,1 ,0 ,1 ,0 ,1,17812 , 0 
35641.289,7,171 ,16 ,815 ,0 ,0 ,2 ,2 ,0 ,1 ,0 ,5 ,0 ,6 ,0 ,6,27729 , 0 
35641.337,14,171 ,1 ,256 ,0 ,0 ,1 ,0 ,0 ,0 ,0 ,1 ,0 ,0 ,0 ,0,17274 , 0 
35641.35,15,171 ,11 ,1114 ,0 ,0 ,2 ,0 ,0 ,0 ,0 ,2 ,0 ,2 ,0 ,2,21828 , 0 
35641.36,20,171 ,5 ,801 ,0 ,0 ,1 ,1 ,0 ,0 ,0 ,2 ,0 ,1 ,0 ,1,19208 , 0 
35641.36,16,171 ,2 ,531 ,0 ,0 ,1 ,0 ,1 ,0 ,0 ,2 ,0 ,5 ,1 ,6,36942 , 0 
35641.444,10,171 ,14 ,512 ,0 ,0 ,2 ,0 ,0 ,0 ,0 ,2 ,0 ,2 ,0 ,2,18199 , 0 
35641.482,12,171 ,18 ,842 ,0 ,0 ,1 ,0 ,0 ,0 ,0 ,1 ,0 ,3 ,0 ,3,20883 , 0 
35641.596,9,171 ,16 ,813 ,0 ,0 ,2 ,0 ,0 ,0 ,0 ,2 ,0 ,3 ,0 ,3,32401 , 0 
35641.602,5,171 ,2 ,531 ,0 ,0 ,2 ,0 ,2 ,1 ,0 ,5 ,0 ,2 ,2 ,4,31581 , 0 
35641.606,19,171 ,1 ,256 ,0 ,0 ,2 ,0 ,0 ,0 ,0 ,2 ,0 ,2 ,0 ,2,20883 , 0 
35641.696,17,171 ,6 ,774 ,0 ,0 ,2 ,0 ,1 ,0 ,1 ,4 ,0 ,1 ,2 ,3,25355 , 0 
35641.771,13,171 ,1 ,256 ,0 ,0 ,0 ,0 ,0 ,0 ,0 ,0 ,0 ,2 ,0 ,2,18357 , 0 
35641.787,3,171 ,1 ,256 ,0 ,0 ,1 ,0 ,0 ,0 ,0 ,1 ,0 ,0 ,0 ,0,13173 , 0 
35760.96,8,171 ,1 ,256 ,0 ,0 ,1 ,0 ,0 ,0 ,0 ,1 ,0 ,0 ,0 ,0,14665 , 0 
35761.078,11,171 ,5 ,801 ,0 ,0 ,2 ,0 ,1 ,0 ,0 ,3 ,0 ,9 ,1 ,10,22990 , 0 
35761.124,2,171 ,1 ,256 ,0 ,0 ,2 ,0 ,11 ,0 ,2 ,15 ,0 ,6 ,15 ,21,26902 , 0 
35761.138,6,171 ,2 ,512 ,0 ,0 ,2 ,1 ,6 ,0 ,0 ,9 ,0 ,10 ,6 ,16,38029 , 0 
35761.214,18,171 ,19 ,516 ,0 ,0 ,1 ,0 ,0 ,0 ,0 ,1 ,0 ,2 ,0 ,2,18801 , 0 
35761.236,4,171 ,8 ,527 ,0 ,0 ,2 ,0 ,0 ,0 ,0 ,2 ,0 ,1 ,0 ,1,16754 , 0 
35761.29,7,171 ,17 ,1079 ,0 ,0 ,8 ,4 ,0 ,1 ,0 ,13 ,0 ,15 ,0 ,15,27874 , 0 
35761.337,14,171 ,1 ,256 ,0 ,0 ,1 ,0 ,0 ,0 ,0 ,1 ,0 ,3 ,0 ,3,16746 , 0 
35761.35,15,171 ,11 ,1057 ,0 ,0 ,5 ,1 ,0 ,0 ,0 ,6 ,0 ,12 ,0 ,12,20931 , 0 
35761.36,20,171 ,5 ,801 ,0 ,0 ,1 ,0 ,0 ,0 ,0 ,1 ,0 ,1 ,0 ,1,17964 , 0 
35761.361,16,171 ,2 ,512 ,0 ,0 ,6 ,1 ,0 ,2 ,2 ,11 ,0 ,14 ,2 ,16,39518 , 1 
35761.444,10,171 ,14 ,512 ,0 ,0 ,0 ,0 ,0 ,0 ,0 ,0 ,0 ,1 ,0 ,1,18933 , 0 
35761.482,12,171 ,18 ,842 ,0 ,0 ,1 ,0 ,0 ,0 ,0 ,1 ,0 ,2 ,0 ,2,19477 , 0 
35761.596,9,171 ,5 ,801 ,0 ,0 ,6 ,1 ,0 ,1 ,0 ,8 ,0 ,17 ,0 ,17,34033 , 0 
35761.602,5,171 ,2 ,512 ,0 ,0 ,1 ,1 ,2 ,0 ,0 ,4 ,0 ,7 ,2 ,9,31959 , 0 
35761.606,19,171 ,1 ,256 ,0 ,0 ,1 ,0 ,0 ,0 ,0 ,1 ,0 ,3 ,0 ,3,20319 , 0 
35761.697,17,171 ,6 ,768 ,0 ,0 ,5 ,2 ,4 ,0 ,0 ,11 ,0 ,13 ,4 ,17,25567 , 0 
35761.771,13,171 ,1 ,256 ,0 ,0 ,1 ,0 ,0 ,0 ,0 ,1 ,0 ,2 ,0 ,2,18362 , 0 
35761.787,3,171 ,1 ,256 ,0 ,0 ,1 ,0 ,0 ,0 ,0 ,1 ,0 ,2 ,0 ,2,12817 , 0 
35880.96,8,171 ,1 ,256 ,0 ,0 ,1 ,0 ,0 ,0 ,0 ,1 ,0 ,3 ,0 ,3,14579 , 0 
35881.078,11,171 ,5 ,801 ,0 ,0 ,0 ,0 ,0 ,0 ,0 ,0 ,0 ,4 ,0 ,4,23378 , 0 
35881.123,2,171 ,1 ,256 ,0 ,0 ,1 ,0 ,1 ,0 ,0 ,2 ,0 ,3 ,1 ,4,25440 , 0 
35881.138,6,171 ,2 ,512 ,0 ,0 ,2 ,0 ,1 ,0 ,0 ,3 ,0 ,1 ,1 ,2,32790 , 0 
35881.214,18,171 ,19 ,512 ,0 ,0 ,1 ,1 ,0 ,0 ,0 ,2 ,0 ,1 ,0 ,1,19981 , 0 
35881.236,4,171 ,8 ,527 ,0 ,0 ,1 ,0 ,0 ,0 ,0 ,1 ,0 ,2 ,0 ,2,17881 , 0 
35881.289,7,171 ,17 ,1052 ,0 ,0 ,2 ,1 ,0 ,0 ,0 ,3 ,0 ,4 ,0 ,4,27804 , 0 
35881.337,14,171 ,1 ,256 ,0 ,0 ,1 ,0 ,0 ,0 ,0 ,1 ,0 ,4 ,0 ,4,17367 , 0 
35881.35,15,171 ,11 ,1057 ,0 ,0 ,3 ,0 ,0 ,0 ,0 ,3 ,0 ,2 ,0 ,2,21916 , 0 
35881.36,20,171 ,5 ,801 ,0 ,0 ,1 ,0 ,0 ,0 ,0 ,1 ,0 ,1 ,0 ,1,19281 , 0 
35881.36,16,171 ,2 ,512 ,0 ,0 ,2 ,0 ,0 ,0 ,0 ,2 ,0 ,4 ,0 ,4,37030 , 1 
35881.444,10,171 ,14 ,512 ,0 ,0 ,2 ,0 ,0 ,0 ,0 ,2 ,0 ,1 ,0 ,1,18267 , 0 
35881.482,12,171 ,18 ,842 ,0 ,0 ,1 ,0 ,0 ,0 ,0 ,1 ,0 ,0 ,0 ,0,20944 , 0 
35881.596,9,171 ,5 ,801 ,0 ,0 ,2 ,0 ,0 ,0 ,0 ,2 ,0 ,5 ,0 ,5,32482 , 0 
35881.602,5,171 ,2 ,512 ,0 ,0 ,2 ,0 ,0 ,0 ,0 ,2 ,0 ,2 ,0 ,2,31663 , 0 
35881.606,19,171 ,1 ,256 ,0 ,0 ,2 ,0 ,1 ,0 ,0 ,3 ,0 ,3 ,1 ,4,20963 , 0 
35881.696,17,171 ,6 ,768 ,0 ,0 ,3 ,0 ,1 ,0 ,0 ,4 ,0 ,3 ,1 ,4,25455 , 0 
35881.771,13,171 ,1 ,256 ,0 ,0 ,1 ,0 ,0 ,0 ,0 ,1 ,0 ,3 ,0 ,3,18446 , 0 
35881.787,3,171 ,1 ,256 ,0 ,0 ,2 ,0 ,0 ,0 ,0 ,2 ,0 ,0 ,0 ,0,13234 , 0 
36000.96,8,171 ,1 ,256 ,0 ,0 ,1 ,0 ,0 ,0 ,0 ,1 ,0 ,2 ,0 ,2,14756 , 0 
36001.078,11,171 ,5 ,791 ,0 ,0 ,2 ,1 ,0 ,0 ,0 ,3 ,0 ,5 ,0 ,5,23075 , 0 
36001.123,2,171 ,1 ,256 ,0 ,0 ,1 ,0 ,3 ,0 ,0 ,4 ,0 ,2 ,3 ,5,27002 , 0 
36001.138,6,171 ,2 ,512 ,0 ,0 ,1 ,0 ,0 ,0 ,0 ,1 ,0 ,2 ,0 ,2,38092 , 0 
36001.214,18,171 ,19 ,512 ,0 ,0 ,2 ,0 ,1 ,0 ,0 ,3 ,0 ,2 ,1 ,3,18885 , 0 
36001.236,4,171 ,8 ,519 ,0 ,0 ,0 ,0 ,0 ,0 ,0 ,0 ,0 ,2 ,0 ,2,16821 , 0 
36001.289,7,171 ,17 ,1043 ,0 ,0 ,2 ,0 ,0 ,0 ,0 ,2 ,0 ,6 ,0 ,6,27948 , 0 
36001.337,14,171 ,1 ,256 ,0 ,0 ,1 ,0 ,0 ,0 ,0 ,1 ,0 ,0 ,0 ,0,16817 , 0 
36001.35,15,171 ,11 ,1057 ,0 ,0 ,2 ,0 ,0 ,0 ,0 ,2 ,0 ,2 ,0 ,2,20993 , 0 
36001.36,20,171 ,5 ,791 ,0 ,0 ,1 ,1 ,0 ,0 ,0 ,2 ,0 ,2 ,0 ,2,18049 , 0 
36001.36,16,171 ,2 ,512 ,0 ,0 ,2 ,0 ,0 ,0 ,0 ,2 ,0 ,4 ,0 ,4,39604 , 1 
36001.444,10,171 ,14 ,512 ,0 ,0 ,0 ,0 ,0 ,0 ,0 ,0 ,0 ,1 ,0 ,1,18984 , 0 
36001.482,12,171 ,18 ,824 ,0 ,0 ,2 ,1 ,0 ,0 ,0 ,3 ,0 ,3 ,0 ,3,19573 , 0 
36001.596,9,171 ,5 ,791 ,0 ,0 ,2 ,1 ,0 ,0 ,0 ,3 ,0 ,6 ,0 ,6,34112 , 0 
36001.602,5,171 ,2 ,512 ,0 ,0 ,1 ,0 ,3 ,0 ,0 ,4 ,0 ,7 ,3 ,10,32088 , 0 
36001.606,19,171 ,1 ,256 ,0 ,0 ,2 ,0 ,1 ,0 ,0 ,3 ,0 ,4 ,1 ,5,20439 , 0 
36001.696,17,171 ,6 ,768 ,0 ,0 ,2 ,0 ,0 ,0 ,0 ,2 ,0 ,2 ,0 ,2,25629 , 0 
36001.771,13,171 ,1 ,256 ,0 ,0 ,2 ,0 ,0 ,0 ,0 ,2 ,0 ,1 ,0 ,1,18428 , 0 
36001.787,3,171 ,1 ,256 ,0 ,0 ,1 ,0 ,0 ,0 ,0 ,1 ,0 ,1 ,0 ,1,12877 , 0 
36120.96,8,171 ,1 ,256 ,0 ,0 ,1 ,0 ,0 ,0 ,0 ,1 ,0 ,0 ,0 ,0,14638 , 0 
36121.078,11,171 ,5 ,791 ,0 ,0 ,2 ,0 ,1 ,0 ,0 ,3 ,0 ,3 ,1 ,4,23457 , 0 
36121.123,2,171 ,1 ,256 ,0 ,0 ,1 ,0 ,7 ,0 ,0 ,8 ,0 ,0 ,7 ,7,25524 , 0 
36121.138,6,171 ,2 ,512 ,0 ,0 ,1 ,1 ,3 ,0 ,0 ,5 ,0 ,4 ,3 ,7,32883 , 0 
36121.236,4,171 ,8 ,519 ,0 ,0 ,1 ,0 ,0 ,0 ,0 ,1 ,0 ,0 ,0 ,0,17949 , 0 
36121.289,7,171 ,17 ,1064 ,0 ,0 ,2 ,2 ,0 ,0 ,0 ,4 ,0 ,2 ,0 ,2,27887 , 0 
36121.337,14,171 ,1 ,256 ,0 ,0 ,1 ,0 ,0 ,0 ,0 ,1 ,0 ,3 ,0 ,3,17424 , 0 
36121.35,15,171 ,11 ,1062 ,0 ,0 ,1 ,1 ,0 ,0 ,0 ,2 ,0 ,5 ,0 ,5,21995 , 0 
36121.352,18,171 ,19 ,512 ,0 ,0 ,2 ,0 ,1 ,0 ,0 ,3 ,0 ,2 ,1 ,3,20072 , 0 
36121.36,20,171 ,5 ,791 ,0 ,0 ,2 ,0 ,0 ,0 ,0 ,2 ,0 ,2 ,0 ,2,19342 , 0 
36121.36,16,171 ,2 ,512 ,0 ,0 ,1 ,1 ,0 ,0 ,0 ,2 ,0 ,4 ,0 ,4,37103 , 0 
36121.444,10,171 ,14 ,512 ,0 ,0 ,2 ,0 ,0 ,0 ,0 ,2 ,0 ,0 ,0 ,0,18336 , 0 
36121.482,12,171 ,18 ,804 ,0 ,0 ,1 ,1 ,0 ,0 ,0 ,2 ,0 ,3 ,0 ,3,21017 , 0 
36121.596,9,171 ,5 ,791 ,0 ,0 ,2 ,0 ,0 ,0 ,0 ,2 ,0 ,3 ,0 ,3,32585 , 0 
36121.602,5,171 ,2 ,512 ,0 ,0 ,1 ,1 ,1 ,0 ,0 ,3 ,0 ,2 ,1 ,3,31763 , 0 
36121.606,19,171 ,1 ,256 ,0 ,0 ,1 ,0 ,1 ,0 ,0 ,2 ,0 ,2 ,1 ,3,21034 , 0 
36121.696,17,171 ,6 ,768 ,0 ,0 ,1 ,1 ,2 ,0 ,0 ,4 ,0 ,2 ,2 ,4,25553 , 0 
36121.771,13,171 ,1 ,256 ,0 ,0 ,0 ,0 ,0 ,0 ,0 ,0 ,0 ,2 ,0 ,2,18515 , 0 
36121.787,3,171 ,1 ,256 ,0 ,0 ,1 ,0 ,0 ,0 ,0 ,1 ,0 ,1 ,0 ,1,13293 , 0 
36240.96,8,171 ,1 ,256 ,0 ,0 ,1 ,0 ,0 ,0 ,0 ,1 ,0 ,1 ,0 ,1,14822 , 0 
36241.078,11,171 ,5 ,791 ,0 ,0 ,1 ,0 ,0 ,0 ,0 ,1 ,0 ,1 ,0 ,1,23145 , 0 
36241.123,2,171 ,1 ,256 ,0 ,0 ,2 ,0 ,1 ,0 ,1 ,4 ,0 ,2 ,3 ,5,27105 , 0 
36241.138,6,171 ,2 ,512 ,0 ,0 ,2 ,0 ,0 ,1 ,1 ,4 ,0 ,1 ,2 ,3,38216 , 0 
36241.214,18,171 ,19 ,512 ,0 ,0 ,0 ,0 ,0 ,0 ,0 ,0 ,0 ,1 ,0 ,1,18943 , 0 
36241.236,4,171 ,8 ,519 ,0 ,0 ,2 ,0 ,0 ,0 ,0 ,2 ,0 ,2 ,0 ,2,16892 , 0 
36241.289,7,171 ,16 ,776 ,0 ,0 ,5 ,1 ,0 ,1 ,0 ,7 ,0 ,4 ,0 ,4,28067 , 0 
36241.337,14,171 ,1 ,256 ,0 ,0 ,1 ,0 ,0 ,0 ,0 ,1 ,0 ,2 ,0 ,2,16905 , 0 
36241.35,15,171 ,11 ,1062 ,0 ,0 ,2 ,0 ,0 ,0 ,0 ,2 ,0 ,5 ,0 ,5,21100 , 0 
36241.36,20,171 ,5 ,791 ,0 ,0 ,0 ,0 ,0 ,0 ,0 ,0 ,0 ,1 ,0 ,1,18108 , 0 
36241.36,16,171 ,2 ,512 ,0 ,0 ,2 ,0 ,1 ,0 ,0 ,3 ,0 ,5 ,1 ,6,39707 , 0 
36241.444,10,171 ,14 ,512 ,0 ,0 ,0 ,0 ,0 ,0 ,0 ,0 ,0 ,2 ,0 ,2,19049 , 0 
36241.482,12,171 ,18 ,804 ,0 ,0 ,0 ,0 ,0 ,0 ,0 ,0 ,0 ,1 ,0 ,1,19635 , 0 
36241.596,9,171 ,5 ,791 ,0 ,0 ,1 ,0 ,0 ,0 ,0 ,1 ,0 ,7 ,0 ,7,34205 , 0 
36241.602,5,171 ,2 ,512 ,0 ,0 ,1 ,0 ,0 ,0 ,0 ,1 ,0 ,1 ,0 ,1,32182 , 0 
36241.606,19,171 ,1 ,256 ,0 ,0 ,1 ,0 ,0 ,0 ,0 ,1 ,0 ,1 ,0 ,1,20529 , 0 
36241.696,17,171 ,6 ,768 ,0 ,0 ,1 ,0 ,0 ,1 ,1 ,3 ,0 ,6 ,1 ,7,25721 , 0 
36241.771,13,171 ,1 ,256 ,0 ,0 ,2 ,0 ,0 ,0 ,0 ,2 ,0 ,2 ,0 ,2,18526 , 0 
36241.787,3,171 ,1 ,256 ,0 ,0 ,1 ,0 ,0 ,0 ,0 ,1 ,0 ,1 ,0 ,1,12936 , 0 
36360.96,8,171 ,1 ,256 ,0 ,0 ,1 ,0 ,0 ,0 ,0 ,1 ,0 ,1 ,0 ,1,14698 , 0 
36361.078,11,171 ,5 ,791 ,0 ,0 ,1 ,0 ,0 ,0 ,0 ,1 ,0 ,3 ,0 ,3,23534 , 0 
36361.123,2,171 ,1 ,256 ,0 ,0 ,1 ,0 ,1 ,0 ,0 ,2 ,0 ,0 ,1 ,1,25598 , 0 
36361.138,6,171 ,2 ,512 ,0 ,0 ,2 ,0 ,1 ,0 ,0 ,3 ,0 ,1 ,1 ,2,32953 , 0 
36361.214,18,171 ,19 ,512 ,0 ,0 ,1 ,0 ,0 ,0 ,0 ,1 ,0 ,2 ,0 ,2,20138 , 0 
36361.236,4,171 ,8 ,519 ,0 ,0 ,1 ,0 ,0 ,0 ,0 ,1 ,0 ,0 ,0 ,0,18018 , 0 
36361.289,7,171 ,16 ,776 ,0 ,0 ,2 ,0 ,0 ,0 ,0 ,2 ,0 ,0 ,0 ,0,27955 , 0 
36361.337,14,171 ,1 ,256 ,0 ,0 ,1 ,0 ,0 ,0 ,0 ,1 ,0 ,1 ,0 ,1,17491 , 0 
36361.35,15,171 ,11 ,1062 ,0 ,0 ,1 ,0 ,0 ,0 ,0 ,1 ,0 ,1 ,0 ,1,22055 , 0 
36361.36,20,171 ,5 ,791 ,0 ,0 ,2 ,0 ,0 ,0 ,0 ,2 ,0 ,0 ,0 ,0,19432 , 0 
36361.36,16,171 ,2 ,512 ,0 ,0 ,1 ,0 ,0 ,0 ,0 ,1 ,0 ,3 ,0 ,3,37180 , 0 
36361.444,10,171 ,14 ,512 ,0 ,0 ,1 ,0 ,0 ,0 ,0 ,1 ,0 ,0 ,0 ,0,18388 , 0 
36361.482,12,171 ,18 ,804 ,0 ,0 ,2 ,0 ,0 ,0 ,0 ,2 ,0 ,2 ,0 ,2,21118 , 0 
36361.596,9,171 ,5 ,791 ,0 ,0 ,0 ,0 ,0 ,0 ,0 ,0 ,0 ,2 ,0 ,2,32669 , 0 
36361.602,5,171 ,2 ,512 ,0 ,0 ,1 ,0 ,0 ,0 ,0 ,1 ,0 ,5 ,0 ,5,31893 , 0 
36361.606,19,171 ,1 ,256 ,0 ,0 ,1 ,0 ,0 ,0 ,0 ,1 ,0 ,2 ,0 ,2,21108 , 0 
36361.696,17,171 ,6 ,785 ,0 ,0 ,1 ,1 ,0 ,0 ,0 ,2 ,0 ,3 ,0 ,3,25616 , 0 
36361.771,13,171 ,1 ,256 ,0 ,0 ,0 ,0 ,0 ,0 ,0 ,0 ,0 ,0 ,0 ,0,18573 , 0 
36361.787,3,171 ,1 ,256 ,0 ,0 ,1 ,0 ,0 ,0 ,0 ,1 ,0 ,0 ,0 ,0,13354 , 0 
36480.961,8,196 ,1 ,256 ,0 ,0 ,14 ,7 ,3 ,8 ,2 ,34 ,0 ,37 ,8 ,45,15115 , 0 
36481.078,11,201 ,9 ,1356 ,0 ,0 ,15 ,2 ,2 ,2 ,1 ,22 ,0 ,45 ,12 ,57,23420 , 0 
36481.124,2,197 ,1 ,256 ,0 ,0 ,13 ,4 ,0 ,9 ,4 ,30 ,0 ,58 ,10 ,68,27362 , 0 
36481.138,6,201 ,2 ,512 ,0 ,0 ,14 ,1 ,1 ,4 ,1 ,21 ,0 ,43 ,5 ,48,38472 , 0 
36481.214,18,197 ,4 ,1254 ,0 ,0 ,16 ,4 ,3 ,8 ,3 ,34 ,0 ,36 ,9 ,45,19389 , 0 
36481.236,4,197 ,8 ,698 ,0 ,0 ,14 ,7 ,1 ,9 ,1 ,32 ,0 ,29 ,5 ,34,17272 , 0 
36481.29,7,204 ,16 ,65535 ,0 ,0 ,17 ,0 ,3 ,1 ,0 ,21 ,0 ,38 ,15 ,53,28307 , 1 
36481.338,14,196 ,14 ,0 ,0 ,0 ,12 ,6 ,1 ,8 ,2 ,29 ,0 ,42 ,8 ,50,17142 , 0 
36481.35,15,201 ,7 ,1057 ,0 ,0 ,14 ,1 ,0 ,2 ,0 ,17 ,0 ,36 ,0 ,36,21292 , 0 
36481.361,16,201 ,9 ,1356 ,0 ,0 ,17 ,0 ,0 ,3 ,0 ,20 ,0 ,46 ,4 ,50,39948 , 0 
36481.444,10,199 ,6 ,807 ,0 ,0 ,12 ,4 ,0 ,8 ,0 ,24 ,0 ,20 ,0 ,20,19343 , 0 
36481.472,20,201 ,5 ,1044 ,0 ,0 ,12 ,2 ,0 ,3 ,0 ,17 ,0 ,31 ,0 ,31,18315 , 0 
36481.482,12,201 ,18 ,768 ,0 ,0 ,13 ,1 ,4 ,5 ,3 ,26 ,0 ,37 ,7 ,44,19932 , 0 
36481.596,9,201 ,7 ,1057 ,0 ,0 ,17 ,1 ,6 ,2 ,2 ,28 ,0 ,40 ,10 ,50,34514 , 0 
36481.603,5,201 ,19 ,512 ,0 ,0 ,16 ,3 ,1 ,4 ,4 ,28 ,0 ,66 ,7 ,73,32567 , 0 
36481.607,19,197 ,1 ,256 ,0 ,0 ,14 ,6 ,6 ,10 ,3 ,39 ,0 ,67 ,20 ,87,20882 , 0 
36481.697,17,201 ,7 ,1057 ,0 ,0 ,16 ,1 ,0 ,2 ,0 ,19 ,0 ,35 ,0 ,35,26000 , 0 
36481.772,13,197 ,1 ,256 ,0 ,0 ,13 ,5 ,0 ,8 ,0 ,26 ,0 ,36 ,1 ,37,18763 , 0 
36481.787,3,198 ,1 ,256 ,0 ,0 ,12 ,10 ,0 ,9 ,0 ,31 ,0 ,27 ,0 ,27,13169 , 0 
36600.961,8,238 ,1 ,256 ,0 ,0 ,16 ,11 ,2 ,11 ,2 ,42 ,0 ,48 ,10 ,58,15044 , 0 
36601.078,11,241 ,9 ,1356 ,0 ,0 ,19 ,0 ,0 ,0 ,0 ,19 ,0 ,60 ,0 ,60,23749 , 0 
36601.124,2,239 ,14 ,512 ,0 ,0 ,19 ,6 ,2 ,9 ,1 ,37 ,0 ,68 ,8 ,76,26029 , 0 
36601.138,6,243 ,2 ,768 ,0 ,0 ,20 ,3 ,0 ,6 ,0 ,29 ,0 ,54 ,2 ,56,33294 , 0 
36601.214,18,241 ,19 ,512 ,0 ,0 ,20 ,2 ,0 ,6 ,0 ,28 ,0 ,50 ,1 ,51,20505 , 0 
36601.236,4,241 ,8 ,512 ,0 ,0 ,17 ,3 ,1 ,11 ,1 ,33 ,0 ,36 ,2 ,38,18448 , 0 
36601.29,7,244 ,16 ,65535 ,0 ,0 ,20 ,0 ,0 ,0 ,0 ,20 ,0 ,46 ,0 ,46,28165 , 1 
36601.338,14,239 ,1 ,256 ,0 ,0 ,18 ,9 ,10 ,13 ,7 ,57 ,0 ,59 ,21 ,80,17968 , 0 
36601.35,15,243 ,7 ,1057 ,0 ,0 ,18 ,0 ,0 ,0 ,0 ,18 ,0 ,45 ,0 ,45,22244 , 0 
36601.36,20,241 ,12 ,1306 ,0 ,0 ,16 ,0 ,0 ,1 ,0 ,17 ,0 ,39 ,0 ,39,19628 , 0 
36601.361,16,243 ,2 ,512 ,0 ,0 ,19 ,0 ,0 ,1 ,0 ,20 ,0 ,49 ,1 ,50,37468 , 0 
36601.444,10,239 ,14 ,512 ,0 ,0 ,19 ,7 ,1 ,8 ,1 ,36 ,0 ,27 ,3 ,30,18832 , 0 
36601.482,12,241 ,18 ,1024 ,0 ,0 ,19 ,0 ,0 ,1 ,0 ,20 ,0 ,48 ,1 ,49,21351 , 0 
36601.596,9,243 ,7 ,1057 ,0 ,0 ,19 ,0 ,0 ,0 ,0 ,19 ,0 ,62 ,0 ,62,32887 , 0 
36601.613,19,239 ,1 ,256 ,0 ,0 ,19 ,6 ,5 ,11 ,1 ,42 ,0 ,81 ,17 ,98,21498 , 0 
36601.697,17,243 ,16 ,773 ,0 ,0 ,19 ,0 ,0 ,1 ,0 ,20 ,0 ,38 ,0 ,38,25864 , 0 
36601.716,5,243 ,13 ,768 ,0 ,0 ,22 ,1 ,0 ,6 ,0 ,29 ,0 ,82 ,0 ,82,32298 , 0 
36601.787,3,238 ,0 ,0 ,0 ,0 ,17 ,14 ,0 ,12 ,0 ,43 ,0 ,35 ,2 ,37,13677 , 0 
36601.908,13,241 ,14 ,512 ,0 ,0 ,19 ,6 ,1 ,10 ,1 ,37 ,0 ,63 ,3 ,66,18998 , 0 
36720.961,8,26 ,1 ,256 ,0 ,0 ,18 ,12 ,4 ,11 ,1 ,46 ,0 ,55 ,12 ,67,15433 , 0 
36721.082,11,25 ,5 ,768 ,0 ,0 ,20 ,1 ,0 ,1 ,0 ,22 ,0 ,74 ,0 ,74,23680 , 0 
36721.124,2,26 ,1 ,256 ,0 ,0 ,22 ,4 ,0 ,8 ,0 ,34 ,0 ,80 ,1 ,81,27707 , 0 
36721.138,6,25 ,0 ,0 ,0 ,0 ,19 ,1 ,1 ,2 ,1 ,24 ,0 ,49 ,2 ,51,38752 , 0 
36721.214,18,26 ,0 ,0 ,0 ,0 ,20 ,2 ,0 ,1 ,0 ,23 ,0 ,58 ,0 ,58,19682 , 0 
36721.236,4,25 ,19 ,512 ,0 ,0 ,17 ,4 ,0 ,8 ,0 ,29 ,0 ,45 ,0 ,45,17612 , 0 
36721.29,7,28 ,16 ,65535 ,0 ,0 ,20 ,0 ,0 ,0 ,0 ,20 ,0 ,39 ,0 ,39,28511 , 1 
36721.338,14,26 ,1 ,256 ,0 ,0 ,18 ,9 ,8 ,17 ,6 ,58 ,0 ,63 ,19 ,82,17501 , 0 
36721.35,15,25 ,7 ,1057 ,0 ,0 ,21 ,0 ,0 ,0 ,0 ,21 ,0 ,47 ,0 ,47,21502 , 0 
36721.36,20,25 ,5 ,768 ,0 ,0 ,19 ,1 ,0 ,1 ,0 ,21 ,0 ,46 ,0 ,46,18576 , 0 
36721.36,16,25 ,0 ,0 ,0 ,0 ,20 ,1 ,0 ,2 ,0 ,23 ,0 ,50 ,0 ,50,40216 , 0 
36721.444,10,25 ,14 ,512 ,0 ,0 ,16 ,5 ,2 ,4 ,2 ,29 ,0 ,26 ,4 ,30,19676 , 0 
36721.482,12,25 ,5 ,768 ,0 ,0 ,22 ,1 ,0 ,1 ,0 ,24 ,0 ,61 ,0 ,61,20207 , 0 
36721.596,9,25 ,7 ,1057 ,0 ,0 ,21 ,0 ,0 ,0 ,0 ,21 ,0 ,68 ,0 ,68,34746 , 0 
36721.603,5,25 ,13 ,512 ,0 ,0 ,22 ,2 ,1 ,1 ,0 ,26 ,0 ,95 ,6 ,101,32935 , 0 
36721.607,19,26 ,1 ,256 ,0 ,0 ,21 ,3 ,4 ,7 ,2 ,37 ,0 ,90 ,6 ,96,21229 , 0 
36721.697,17,25 ,16 ,773 ,0 ,0 ,19 ,0 ,0 ,0 ,0 ,19 ,0 ,43 ,0 ,43,26199 , 0 
36721.772,13,26 ,1 ,256 ,0 ,0 ,19 ,7 ,3 ,9 ,1 ,39 ,0 ,72 ,4 ,76,19094 , 0 
36721.787,3,26 ,1 ,256 ,0 ,0 ,18 ,13 ,0 ,12 ,0 ,43 ,0 ,42 ,1 ,43,13469 , 0 
36840.96,8,30 ,1 ,256 ,0 ,0 ,7 ,2 ,3 ,2 ,2 ,16 ,0 ,15 ,6 ,21,15273 , 0 
36841.078,11,30 ,12 ,1521 ,0 ,0 ,13 ,7 ,7 ,7 ,3 ,37 ,0 ,26 ,14 ,40,24609 , 0 
36841.127,2,30 ,1 ,256 ,0 ,0 ,13 ,4 ,21 ,3 ,9 ,50 ,0 ,23 ,32 ,55,26750 , 0 
36841.139,6,30 ,10 ,1304 ,0 ,0 ,14 ,9 ,7 ,5 ,4 ,39 ,0 ,26 ,15 ,41,34148 , 0 
36841.214,18,30 ,12 ,1521 ,0 ,0 ,13 ,10 ,0 ,8 ,0 ,31 ,0 ,15 ,0 ,15,21094 , 0 
36841.236,4,30 ,8 ,537 ,0 ,0 ,10 ,4 ,1 ,3 ,1 ,19 ,0 ,10 ,3 ,13,18808 , 0 
36841.29,7,30 ,9 ,1786 ,0 ,0 ,17 ,9 ,4 ,8 ,0 ,38 ,0 ,19 ,5 ,24,29023 , 0 
36841.35,15,30 ,11 ,1820 ,0 ,0 ,14 ,8 ,1 ,5 ,1 ,29 ,0 ,23 ,5 ,28,22799 , 0 
36841.36,20,30 ,5 ,919 ,0 ,0 ,12 ,9 ,0 ,5 ,0 ,26 ,0 ,19 ,0 ,19,20244 , 0 
36841.361,16,30 ,6 ,1535 ,0 ,0 ,15 ,6 ,5 ,5 ,1 ,32 ,0 ,23 ,7 ,30,38196 , 0 
36841.444,10,30 ,14 ,1023 ,0 ,0 ,13 ,8 ,3 ,4 ,1 ,29 ,0 ,12 ,4 ,16,19220 , 0 
36841.456,14,30 ,13 ,512 ,0 ,0 ,10 ,5 ,5 ,5 ,2 ,27 ,0 ,16 ,7 ,23,18391 , 0 
36841.482,12,30 ,5 ,919 ,0 ,0 ,11 ,9 ,5 ,3 ,1 ,29 ,0 ,17 ,6 ,23,22126 , 0 
36841.597,9,30 ,5 ,919 ,0 ,0 ,14 ,6 ,11 ,3 ,6 ,40 ,0 ,30 ,21 ,51,33975 , 0 
36841.61,19,30 ,1 ,256 ,0 ,0 ,8 ,3 ,19 ,2 ,5 ,37 ,0 ,25 ,26 ,51,21959 , 0 
36841.612,5,30 ,19 ,512 ,0 ,0 ,10 ,3 ,27 ,3 ,6 ,49 ,0 ,23 ,37 ,60,33060 , 0 
36841.697,17,30 ,7 ,2398 ,0 ,0 ,15 ,7 ,0 ,5 ,0 ,27 ,0 ,24 ,5 ,29,26519 , 0 
36841.772,13,30 ,1 ,256 ,0 ,0 ,8 ,2 ,9 ,4 ,3 ,26 ,0 ,13 ,12 ,25,19253 , 0 
36841.82,3,30 ,1 ,256 ,0 ,0 ,8 ,3 ,5 ,1 ,1 ,18 ,0 ,8 ,7 ,15,13872 , 0 
36960.96,8,30 ,1 ,256 ,0 ,0 ,4 ,2 ,3 ,0 ,0 ,9 ,0 ,5 ,3 ,8,15528 , 0 
36961.078,11,30 ,12 ,1191 ,0 ,0 ,8 ,3 ,7 ,5 ,0 ,23 ,0 ,11 ,8 ,19,23930 , 0 
36961.124,2,30 ,1 ,256 ,0 ,0 ,2 ,2 ,0 ,5 ,0 ,9 ,0 ,15 ,0 ,15,27817 , 0 
36961.138,6,30 ,10 ,661 ,0 ,0 ,4 ,3 ,4 ,3 ,0 ,14 ,0 ,12 ,5 ,17,38920 , 0 
36961.214,18,30 ,12 ,1316 ,0 ,0 ,4 ,2 ,0 ,0 ,0 ,6 ,0 ,9 ,0 ,9,19790 , 0 
36961.236,4,30 ,8 ,523 ,0 ,0 ,2 ,3 ,0 ,0 ,0 ,5 ,0 ,8 ,0 ,8,17705 , 0 
36961.289,7,30 ,16 ,1244 ,0 ,0 ,6 ,2 ,5 ,1 ,0 ,14 ,0 ,9 ,5 ,14,28710 , 0 
36961.338,14,30 ,1 ,256 ,0 ,0 ,6 ,3 ,11 ,2 ,0 ,22 ,0 ,7 ,14 ,21,17675 , 0 
36961.35,15,30 ,11 ,1461 ,0 ,0 ,2 ,7 ,0 ,1 ,0 ,10 ,0 ,14 ,0 ,14,21627 , 0 
36961.36,20,30 ,5 ,768 ,0 ,0 ,3 ,3 ,0 ,0 ,0 ,6 ,0 ,14 ,0 ,14,18672 , 0 
36961.36,16,30 ,6 ,988 ,0 ,0 ,5 ,2 ,2 ,1 ,0 ,10 ,0 ,11 ,2 ,13,40356 , 0 
36961.444,10,30 ,14 ,359 ,0 ,0 ,3 ,4 ,7 ,2 ,1 ,17 ,0 ,7 ,10 ,17,19894 , 0 
36961.482,12,30 ,5 ,768 ,0 ,0 ,4 ,3 ,7 ,2 ,1 ,17 ,0 ,16 ,11 ,27,20462 , 0 
36961.596,9,30 ,5 ,768 ,0 ,0 ,2 ,2 ,10 ,3 ,2 ,19 ,0 ,19 ,12 ,31,34979 , 0 
36961.607,19,30 ,1 ,256 ,0 ,0 ,3 ,1 ,13 ,0 ,2 ,19 ,0 ,10 ,15 ,25,21342 , 0 
36961.607,5,30 ,13 ,512 ,0 ,0 ,6 ,2 ,25 ,1 ,3 ,37 ,0 ,18 ,33 ,51,33293 , 0 
36961.697,17,30 ,7 ,1423 ,0 ,0 ,3 ,5 ,0 ,0 ,0 ,8 ,0 ,12 ,0 ,12,26324 , 0 
36961.772,13,30 ,1 ,256 ,0 ,0 ,1 ,1 ,14 ,1 ,3 ,20 ,0 ,11 ,17 ,28,19216 , 0 
36961.787,3,30 ,1 ,256 ,0 ,0 ,1 ,2 ,0 ,2 ,1 ,6 ,0 ,8 ,1 ,9,13534 , 0 
37080.96,8,30 ,1 ,256 ,0 ,0 ,1 ,0 ,0 ,0 ,0 ,1 ,0 ,2 ,0 ,2,15343 , 0 
37081.078,11,30 ,12 ,1130 ,0 ,0 ,5 ,1 ,4 ,0 ,0 ,10 ,0 ,7 ,4 ,11,24722 , 0 
37081.123,2,30 ,1 ,256 ,0 ,0 ,2 ,0 ,0 ,0 ,0 ,2 ,0 ,8 ,0 ,8,26879 , 0 
37081.138,6,30 ,10 ,790 ,0 ,0 ,2 ,2 ,3 ,1 ,1 ,9 ,0 ,4 ,5 ,9,34262 , 0 
37081.214,18,30 ,12 ,1109 ,0 ,0 ,2 ,2 ,0 ,0 ,0 ,4 ,0 ,5 ,0 ,5,21205 , 0 
37081.236,4,30 ,8 ,523 ,0 ,0 ,2 ,0 ,0 ,0 ,0 ,2 ,0 ,1 ,0 ,1,18880 , 0 
37081.289,7,30 ,9 ,1114 ,0 ,0 ,7 ,1 ,5 ,1 ,0 ,14 ,0 ,3 ,5 ,8,29153 , 0 
37081.338,14,30 ,1 ,256 ,0 ,0 ,3 ,0 ,7 ,1 ,1 ,12 ,0 ,4 ,9 ,13,18495 , 0 
37081.35,15,30 ,11 ,1393 ,0 ,0 ,2 ,4 ,0 ,0 ,0 ,6 ,0 ,11 ,0 ,11,22936 , 0 
37081.36,20,30 ,5 ,808 ,0 ,0 ,2 ,2 ,0 ,0 ,0 ,4 ,0 ,6 ,0 ,6,20327 , 0 
37081.36,16,30 ,6 ,1074 ,0 ,0 ,2 ,1 ,2 ,1 ,1 ,7 ,0 ,10 ,3 ,13,38281 , 0 
37081.444,10,30 ,14 ,474 ,0 ,0 ,2 ,2 ,5 ,1 ,1 ,11 ,0 ,3 ,7 ,10,19360 , 0 
37081.482,12,30 ,5 ,768 ,0 ,0 ,2 ,0 ,7 ,0 ,0 ,9 ,0 ,6 ,7 ,13,22255 , 0 
37081.596,9,30 ,5 ,808 ,0 ,0 ,2 ,1 ,4 ,1 ,0 ,8 ,0 ,10 ,4 ,14,34141 , 0 
37081.603,5,30 ,13 ,512 ,0 ,0 ,2 ,1 ,14 ,0 ,0 ,17 ,0 ,13 ,15 ,28,33250 , 0 
37081.606,19,30 ,1 ,256 ,0 ,0 ,2 ,0 ,0 ,1 ,0 ,3 ,0 ,7 ,0 ,7,22045 , 0 
37081.696,17,30 ,7 ,1375 ,0 ,0 ,2 ,5 ,0 ,0 ,0 ,7 ,0 ,6 ,0 ,6,26630 , 0 
37081.772,13,30 ,1 ,256 ,0 ,0 ,2 ,0 ,15 ,0 ,0 ,17 ,0 ,3 ,15 ,18,19343 , 0 
37081.787,3,30 ,1 ,256 ,0 ,0 ,1 ,0 ,0 ,0 ,0 ,1 ,0 ,3 ,0 ,3,13952 , 0 
37200.96,8,30 ,1 ,256 ,0 ,0 ,0 ,1 ,0 ,0 ,0 ,1 ,0 ,2 ,0 ,2,15593 , 0 
37201.078,11,30 ,9 ,300 ,0 ,0 ,10 ,5 ,32 ,7 ,3 ,57 ,0 ,25 ,50 ,75,24616 , 0 
37201.124,2,30 ,1 ,256 ,0 ,0 ,1 ,0 ,4 ,1 ,5 ,11 ,0 ,6 ,12 ,18,27989 , 0 
37201.138,6,30 ,10 ,773 ,0 ,0 ,5 ,2 ,1 ,2 ,2 ,12 ,0 ,9 ,3 ,12,39236 , 0 
37201.214,18,30 ,12 ,1056 ,0 ,0 ,6 ,5 ,0 ,4 ,0 ,15 ,0 ,15 ,0 ,15,20050 , 0 
37201.236,4,30 ,8 ,523 ,0 ,0 ,2 ,0 ,0 ,0 ,0 ,2 ,0 ,4 ,0 ,4,17796 , 0 
37201.29,7,30 ,9 ,300 ,0 ,0 ,10 ,5 ,4 ,6 ,1 ,26 ,0 ,14 ,13 ,27,29227 , 0 
37201.337,14,30 ,1 ,256 ,0 ,0 ,1 ,0 ,2 ,1 ,2 ,6 ,0 ,1 ,5 ,6,17783 , 0 
37201.35,15,30 ,11 ,371 ,0 ,0 ,9 ,6 ,10 ,4 ,3 ,32 ,0 ,14 ,14 ,28,22242 , 0 
37201.36,20,30 ,11 ,469 ,0 ,0 ,10 ,6 ,0 ,5 ,0 ,21 ,0 ,20 ,4 ,24,19183 , 0 
37201.361,16,30 ,9 ,300 ,0 ,0 ,7 ,3 ,1 ,3 ,1 ,15 ,0 ,10 ,4 ,14,40684 , 0 
37201.444,10,30 ,14 ,542 ,0 ,0 ,2 ,1 ,2 ,0 ,3 ,8 ,0 ,6 ,5 ,11,20093 , 0 
37201.482,12,30 ,11 ,469 ,0 ,0 ,11 ,8 ,4 ,8 ,2 ,33 ,0 ,16 ,14 ,30,21123 , 0 
37201.597,9,30 ,5 ,640 ,0 ,0 ,12 ,8 ,33 ,12 ,5 ,70 ,0 ,17 ,55 ,72,35907 , 1 
37201.604,5,30 ,11 ,371 ,0 ,0 ,9 ,5 ,19 ,8 ,8 ,49 ,0 ,21 ,34 ,55,33951 , 0 
37201.606,19,30 ,1 ,256 ,0 ,0 ,1 ,0 ,1 ,0 ,1 ,3 ,0 ,9 ,3 ,12,21498 , 0 
37201.771,13,30 ,1 ,256 ,0 ,0 ,0 ,0 ,2 ,3 ,3 ,8 ,0 ,5 ,5 ,10,19311 , 0 
37201.787,3,30 ,1 ,256 ,0 ,0 ,1 ,1 ,0 ,0 ,0 ,2 ,0 ,1 ,0 ,1,13592 , 0 
37201.832,17,30 ,7 ,749 ,0 ,0 ,5 ,7 ,0 ,2 ,0 ,14 ,0 ,13 ,2 ,15,26709 , 0 
37320.96,8,30 ,1 ,256 ,0 ,0 ,3 ,0 ,2 ,0 ,0 ,5 ,0 ,4 ,2 ,6,15446 , 0 
37321.078,11,30 ,9 ,300 ,0 ,0 ,4 ,7 ,60 ,1 ,1 ,73 ,0 ,17 ,62 ,79,25479 , 0 
37321.124,2,30 ,1 ,256 ,0 ,0 ,2 ,0 ,20 ,0 ,3 ,25 ,0 ,12 ,24 ,36,27027 , 0 
37321.138,6,30 ,10 ,1090 ,0 ,0 ,4 ,1 ,0 ,1 ,0 ,6 ,0 ,15 ,0 ,15,34403 , 0 
37321.214,18,30 ,12 ,1076 ,0 ,0 ,5 ,3 ,0 ,0 ,0 ,8 ,0 ,9 ,0 ,9,21339 , 0 
37321.236,4,30 ,8 ,516 ,0 ,0 ,2 ,2 ,0 ,0 ,0 ,4 ,0 ,6 ,0 ,6,18983 , 0 
37321.337,14,30 ,1 ,256 ,0 ,0 ,0 ,0 ,1 ,0 ,0 ,1 ,0 ,5 ,2 ,7,18593 , 0 
37321.35,15,30 ,11 ,632 ,0 ,0 ,6 ,4 ,0 ,1 ,0 ,11 ,0 ,19 ,0 ,19,23141 , 0 
37321.355,7,30 ,16 ,871 ,0 ,0 ,9 ,6 ,3 ,6 ,0 ,24 ,0 ,23 ,11 ,34,29456 , 0 
37321.36,20,30 ,11 ,568 ,0 ,0 ,4 ,3 ,0 ,0 ,0 ,7 ,0 ,10 ,0 ,10,20454 , 0 
37321.364,16,30 ,9 ,300 ,0 ,0 ,6 ,8 ,1 ,1 ,1 ,17 ,0 ,24 ,5 ,29,38545 , 0 
37321.444,10,30 ,14 ,542 ,0 ,0 ,1 ,0 ,1 ,1 ,0 ,3 ,0 ,3 ,2 ,5,19487 , 0 
37321.482,12,30 ,11 ,568 ,0 ,0 ,3 ,3 ,3 ,0 ,0 ,9 ,0 ,13 ,3 ,16,22444 , 0 
37321.601,9,30 ,5 ,853 ,0 ,0 ,10 ,8 ,69 ,7 ,2 ,96 ,0 ,21 ,90 ,111,34934 , 1 
37321.607,19,30 ,1 ,256 ,0 ,0 ,2 ,0 ,0 ,1 ,0 ,3 ,0 ,12 ,0 ,12,22184 , 0 
37321.61,5,30 ,2 ,527 ,0 ,0 ,6 ,3 ,69 ,2 ,3 ,83 ,0 ,21 ,79 ,100,33975 , 0 
37321.697,17,30 ,7 ,723 ,0 ,0 ,8 ,5 ,0 ,2 ,0 ,15 ,0 ,13 ,0 ,13,26815 , 0 
37321.771,13,30 ,1 ,256 ,0 ,0 ,3 ,0 ,0 ,0 ,0 ,3 ,0 ,6 ,0 ,6,19483 , 0 
37321.787,3,30 ,1 ,256 ,0 ,0 ,2 ,0 ,0 ,0 ,0 ,2 ,0 ,2 ,0 ,2,14057 , 0 
37440.96,8,30 ,1 ,256 ,0 ,0 ,1 ,0 ,0 ,0 ,0 ,1 ,0 ,1 ,0 ,1,15692 , 0 
37441.078,11,30 ,9 ,300 ,0 ,0 ,1 ,16 ,1 ,0 ,0 ,18 ,0 ,22 ,1 ,23,24846 , 0 
37441.124,2,30 ,1 ,256 ,0 ,0 ,2 ,0 ,14 ,2 ,5 ,23 ,0 ,18 ,23 ,41,28174 , 0 
37441.138,6,30 ,10 ,1090 ,0 ,0 ,4 ,0 ,0 ,0 ,0 ,4 ,0 ,18 ,0 ,18,39362 , 0 
37441.214,18,30 ,12 ,1076 ,0 ,0 ,2 ,1 ,0 ,0 ,0 ,3 ,0 ,4 ,0 ,4,20146 , 0 
37441.236,4,30 ,8 ,516 ,0 ,0 ,2 ,0 ,0 ,0 ,0 ,2 ,0 ,2 ,0 ,2,17892 , 0 
37441.29,7,30 ,9 ,300 ,0 ,0 ,15 ,17 ,11 ,16 ,0 ,59 ,0 ,36 ,30 ,66,29690 , 0 
37441.337,14,30 ,1 ,256 ,0 ,0 ,3 ,0 ,0 ,0 ,0 ,3 ,0 ,1 ,0 ,1,17909 , 0 
37441.35,15,30 ,11 ,632 ,0 ,0 ,3 ,0 ,0 ,0 ,0 ,3 ,0 ,29 ,0 ,29,22401 , 0 
37441.36,20,30 ,11 ,607 ,0 ,0 ,1 ,0 ,0 ,0 ,0 ,1 ,0 ,4 ,0 ,4,19274 , 0 
37441.361,16,30 ,2 ,512 ,0 ,0 ,17 ,14 ,3 ,18 ,1 ,53 ,0 ,34 ,30 ,64,41224 , 0 
37441.482,12,30 ,11 ,568 ,0 ,0 ,2 ,0 ,1 ,0 ,0 ,3 ,0 ,2 ,1 ,3,21217 , 0 
37441.574,10,30 ,14 ,533 ,0 ,0 ,1 ,1 ,0 ,0 ,0 ,2 ,0 ,4 ,0 ,4,20199 , 0 
37441.597,9,30 ,7 ,563 ,0 ,0 ,19 ,12 ,24 ,28 ,4 ,87 ,0 ,30 ,77 ,107,36733 , 1 
37441.603,5,30 ,2 ,527 ,0 ,0 ,3 ,0 ,11 ,1 ,2 ,17 ,0 ,20 ,27 ,47,34296 , 0 
37441.606,19,30 ,1 ,256 ,0 ,0 ,1 ,0 ,0 ,0 ,0 ,1 ,0 ,2 ,0 ,2,21587 , 0 
37441.697,17,30 ,7 ,563 ,0 ,0 ,2 ,11 ,0 ,0 ,0 ,13 ,0 ,29 ,1 ,30,26919 , 0 
37441.771,13,30 ,1 ,256 ,0 ,0 ,1 ,0 ,0 ,0 ,0 ,1 ,0 ,3 ,0 ,3,19447 , 0 
37441.787,3,30 ,1 ,256 ,0 ,0 ,1 ,0 ,0 ,0 ,0 ,1 ,0 ,1 ,0 ,1,13655 , 0 
37560.96,8,30 ,1 ,256 ,0 ,0 ,0 ,0 ,0 ,0 ,0 ,0 ,0 ,2 ,0 ,2,15502 , 0 
37561.078,11,30 ,9 ,1196 ,0 ,0 ,1 ,6 ,0 ,0 ,0 ,7 ,0 ,13 ,1 ,14,25601 , 0 
37561.124,2,30 ,1 ,256 ,0 ,0 ,0 ,0 ,18 ,0 ,0 ,18 ,0 ,8 ,20 ,28,27143 , 0 
37561.138,6,30 ,10 ,1076 ,0 ,0 ,2 ,1 ,0 ,0 ,0 ,3 ,0 ,7 ,0 ,7,34495 , 0 
37561.214,18,30 ,19 ,512 ,0 ,0 ,5 ,1 ,0 ,1 ,0 ,7 ,0 ,4 ,0 ,4,21459 , 0 
37561.236,4,30 ,8 ,516 ,0 ,0 ,1 ,0 ,0 ,0 ,0 ,1 ,0 ,3 ,0 ,3,19042 , 0 
37561.289,7,30 ,16 ,905 ,0 ,0 ,7 ,5 ,5 ,1 ,0 ,18 ,0 ,11 ,8 ,19,29667 , 0 
37561.337,14,30 ,1 ,256 ,0 ,0 ,1 ,0 ,2 ,0 ,0 ,3 ,0 ,3 ,2 ,5,18668 , 0 
37561.35,15,30 ,11 ,632 ,0 ,0 ,2 ,0 ,0 ,0 ,0 ,2 ,0 ,11 ,0 ,11,23244 , 0 
37561.36,20,30 ,11 ,607 ,0 ,0 ,2 ,0 ,0 ,0 ,0 ,2 ,0 ,5 ,0 ,5,20544 , 0 
37561.36,16,30 ,2 ,512 ,0 ,0 ,7 ,1 ,9 ,0 ,0 ,17 ,0 ,12 ,9 ,21,38752 , 0 
37561.444,10,30 ,14 ,533 ,0 ,0 ,1 ,0 ,1 ,0 ,0 ,2 ,0 ,1 ,1 ,2,19559 , 0 
37561.482,12,30 ,5 ,930 ,0 ,0 ,5 ,1 ,0 ,2 ,1 ,9 ,0 ,5 ,1 ,6,22577 , 0 
37561.596,9,30 ,5 ,930 ,0 ,0 ,7 ,1 ,6 ,2 ,0 ,16 ,0 ,9 ,8 ,17,35150 , 0 
37561.603,5,30 ,2 ,527 ,0 ,0 ,1 ,0 ,8 ,1 ,1 ,11 ,0 ,12 ,11 ,23,34227 , 0 
37561.606,19,30 ,1 ,256 ,0 ,0 ,1 ,0 ,1 ,0 ,0 ,2 ,0 ,5 ,1 ,6,22285 , 0 
37561.697,17,30 ,7 ,1250 ,0 ,0 ,2 ,6 ,0 ,0 ,0 ,8 ,0 ,12 ,0 ,12,26947 , 0 
37561.771,13,30 ,1 ,256 ,0 ,0 ,2 ,0 ,0 ,0 ,0 ,2 ,0 ,0 ,0 ,0,19561 , 0 
37561.787,3,30 ,1 ,256 ,0 ,0 ,3 ,0 ,0 ,0 ,0 ,3 ,0 ,1 ,0 ,1,14119 , 0 
37680.96,8,30 ,1 ,256 ,0 ,0 ,2 ,0 ,0 ,0 ,0 ,2 ,0 ,4 ,0 ,4,15766 , 0 
37681.078,11,30 ,9 ,1196 ,0 ,0 ,3 ,0 ,0 ,0 ,0 ,3 ,0 ,7 ,2 ,9,24943 , 0 
37681.123,2,30 ,1 ,256 ,0 ,0 ,1 ,0 ,3 ,0 ,0 ,4 ,0 ,3 ,3 ,6,28275 , 0 
37681.138,6,30 ,10 ,997 ,0 ,0 ,1 ,0 ,0 ,0 ,0 ,1 ,0 ,2 ,0 ,2,39425 , 0 
37681.214,18,30 ,19 ,534 ,0 ,0 ,3 ,1 ,0 ,0 ,0 ,4 ,0 ,3 ,0 ,3,20225 , 0 
37681.236,4,30 ,8 ,513 ,0 ,0 ,2 ,0 ,0 ,0 ,0 ,2 ,0 ,4 ,0 ,4,18001 , 0 
37681.289,7,30 ,16 ,884 ,0 ,0 ,2 ,2 ,2 ,0 ,0 ,6 ,0 ,4 ,2 ,6,29786 , 0 
37681.337,14,30 ,1 ,256 ,0 ,0 ,1 ,0 ,0 ,0 ,0 ,1 ,0 ,1 ,0 ,1,17969 , 0 
37681.35,15,30 ,7 ,1224 ,0 ,0 ,2 ,1 ,0 ,1 ,0 ,4 ,0 ,2 ,0 ,2,22471 , 0 
37681.36,20,30 ,12 ,1368 ,0 ,0 ,5 ,1 ,0 ,1 ,0 ,7 ,0 ,4 ,0 ,4,19381 , 0 
37681.361,16,30 ,2 ,512 ,0 ,0 ,2 ,0 ,3 ,0 ,0 ,5 ,0 ,4 ,3 ,7,41330 , 0 
37681.444,10,30 ,14 ,533 ,0 ,0 ,2 ,0 ,0 ,0 ,0 ,2 ,0 ,0 ,0 ,0,20263 , 0 
37681.482,12,30 ,5 ,930 ,0 ,0 ,2 ,0 ,0 ,0 ,0 ,2 ,0 ,7 ,1 ,8,21297 , 0 
37681.596,9,30 ,5 ,930 ,0 ,0 ,1 ,0 ,0 ,0 ,0 ,1 ,0 ,6 ,0 ,6,36797 , 0 
37681.603,5,30 ,2 ,527 ,0 ,0 ,1 ,0 ,0 ,0 ,0 ,1 ,0 ,10 ,0 ,10,34394 , 0 
37681.606,19,30 ,1 ,256 ,0 ,0 ,2 ,0 ,1 ,0 ,0 ,3 ,0 ,3 ,1 ,4,21687 , 0 
37681.696,17,30 ,7 ,1224 ,0 ,0 ,1 ,1 ,0 ,0 ,0 ,2 ,0 ,2 ,0 ,2,26980 , 0 
37681.771,13,30 ,1 ,256 ,0 ,0 ,1 ,0 ,0 ,0 ,0 ,1 ,0 ,2 ,0 ,2,19529 , 0 
37681.786,3,30 ,1 ,256 ,0 ,0 ,1 ,0 ,0 ,0 ,0 ,1 ,0 ,1 ,0 ,1,13709 , 0 
37800.96,8,30 ,1 ,256 ,0 ,0 ,2 ,1 ,0 ,0 ,0 ,3 ,0 ,1 ,0 ,1,15564 , 0 
37801.078,11,30 ,9 ,1075 ,0 ,0 ,1 ,1 ,0 ,0 ,0 ,2 ,0 ,8 ,0 ,8,25690 , 0 
37801.123,2,30 ,1 ,256 ,0 ,0 ,2 ,1 ,4 ,0 ,0 ,7 ,0 ,5 ,4 ,9,27234 , 0 
37801.138,6,30 ,10 ,945 ,0 ,0 ,2 ,1 ,0 ,0 ,0 ,3 ,0 ,6 ,0 ,6,34560 , 0 
37801.214,18,30 ,19 ,534 ,0 ,0 ,1 ,0 ,0 ,0 ,0 ,1 ,0 ,4 ,0 ,4,21523 , 0 
37801.236,4,30 ,8 ,513 ,0 ,0 ,1 ,0 ,0 ,0 ,0 ,1 ,0 ,1 ,0 ,1,19100 , 0 
37801.289,7,30 ,16 ,884 ,0 ,0 ,1 ,0 ,0 ,0 ,0 ,1 ,0 ,6 ,0 ,6,29773 , 0 
37801.337,14,30 ,1 ,256 ,0 ,0 ,2 ,1 ,2 ,0 ,0 ,5 ,0 ,5 ,2 ,7,18778 , 0 
37801.35,15,30 ,7 ,1224 ,0 ,0 ,5 ,0 ,0 ,0 ,0 ,5 ,0 ,2 ,0 ,2,23352 , 0 
37801.36,20,30 ,5 ,801 ,0 ,0 ,3 ,0 ,0 ,1 ,0 ,4 ,0 ,3 ,0 ,3,20648 , 0 
37801.36,16,30 ,2 ,512 ,0 ,0 ,1 ,0 ,1 ,0 ,0 ,2 ,0 ,3 ,1 ,4,38843 , 0 
37801.444,10,30 ,14 ,521 ,0 ,0 ,3 ,1 ,1 ,0 ,0 ,5 ,0 ,2 ,1 ,3,19630 , 0 
37801.482,12,30 ,5 ,803 ,0 ,0 ,2 ,1 ,0 ,0 ,0 ,3 ,0 ,4 ,1 ,5,22653 , 0 
37801.596,9,30 ,5 ,803 ,0 ,0 ,2 ,1 ,1 ,0 ,0 ,4 ,0 ,7 ,1 ,8,35268 , 0 
37801.602,5,30 ,2 ,527 ,0 ,0 ,2 ,0 ,3 ,0 ,0 ,5 ,0 ,6 ,3 ,9,34356 , 0 
37801.606,19,30 ,1 ,256 ,0 ,0 ,0 ,1 ,0 ,0 ,0 ,1 ,0 ,5 ,0 ,5,22352 , 0 
37801.696,17,30 ,7 ,1220 ,0 ,0 ,2 ,0 ,0 ,0 ,0 ,2 ,0 ,2 ,0 ,2,27019 , 0 
37801.771,13,30 ,1 ,256 ,0 ,0 ,1 ,1 ,0 ,0 ,0 ,2 ,0 ,4 ,0 ,4,19642 , 0 
37801.787,3,30 ,1 ,256 ,0 ,0 ,1 ,1 ,0 ,0 ,0 ,2 ,0 ,3 ,0 ,3,14185 , 0 
37920.96,8,30 ,1 ,256 ,0 ,0 ,1 ,0 ,0 ,0 ,0 ,1 ,0 ,2 ,0 ,2,15828 , 0 
37921.078,11,30 ,9 ,1075 ,0 ,0 ,1 ,0 ,0 ,0 ,0 ,1 ,0 ,5 ,0 ,5,25046 , 0 
37921.124,2,30 ,1 ,256 ,0 ,0 ,25 ,0 ,46 ,0 ,0 ,71 ,111 ,19 ,46 ,176,28595 , 0 
37921.148,6,30 ,10 ,877 ,0 ,120 ,1 ,14 ,0 ,0 ,0 ,135 ,0 ,82 ,0 ,82,40344 , 1 
37921.214,18,30 ,19 ,525 ,0 ,0 ,3 ,1 ,0 ,0 ,0 ,4 ,0 ,3 ,0 ,3,20344 , 0 
37921.236,4,30 ,8 ,512 ,0 ,0 ,1 ,0 ,0 ,0 ,0 ,1 ,0 ,3 ,0 ,3,18068 , 0 
37921.29,7,30 ,16 ,808 ,0 ,0 ,1 ,15 ,1 ,0 ,0 ,17 ,0 ,42 ,1 ,43,29973 , 0 
37921.338,14,30 ,1 ,256 ,0 ,0 ,1 ,0 ,14 ,0 ,0 ,15 ,0 ,42 ,14 ,56,18112 , 0 
37921.36,20,30 ,5 ,801 ,0 ,0 ,5 ,1 ,0 ,0 ,0 ,6 ,0 ,0 ,0 ,0,19490 , 0 
37921.361,16,30 ,2 ,512 ,0 ,0 ,25 ,13 ,16 ,0 ,0 ,54 ,110 ,39 ,16 ,165,41848 , 0 
37921.424,15,30 ,7 ,1224 ,0 ,0 ,2 ,0 ,0 ,0 ,0 ,2 ,0 ,1 ,0 ,1,22567 , 0 
37921.445,10,30 ,14 ,521 ,0 ,0 ,26 ,0 ,14 ,0 ,0 ,40 ,116 ,0 ,14 ,130,20693 , 0 
37921.482,12,30 ,5 ,803 ,0 ,0 ,1 ,0 ,0 ,0 ,0 ,1 ,0 ,6 ,0 ,6,21407 , 0 
37921.596,9,30 ,5 ,803 ,0 ,0 ,1 ,0 ,0 ,0 ,0 ,1 ,0 ,21 ,0 ,21,36935 , 0 
37921.603,5,30 ,2 ,512 ,0 ,0 ,1 ,16 ,1 ,0 ,0 ,18 ,0 ,28 ,1 ,29,34680 , 0 
37921.606,19,30 ,1 ,256 ,0 ,0 ,1 ,0 ,1 ,0 ,0 ,2 ,0 ,19 ,1 ,20,21781 , 0 
37921.7,17,30 ,7 ,1220 ,0 ,0 ,26 ,1 ,0 ,0 ,0 ,27 ,114 ,23 ,0 ,137,27295 , 0 
37921.771,13,30 ,1 ,256 ,0 ,0 ,1 ,0 ,0 ,0 ,0 ,1 ,0 ,18 ,0 ,18,19607 , 0 
37921.787,3,30 ,1 ,256 ,0 ,0 ,1 ,0 ,0 ,0 ,0 ,1 ,0 ,0 ,0 ,0,13775 , 0 
38040.96,8,30 ,1 ,256 ,0 ,0 ,1 ,0 ,1 ,0 ,0 ,2 ,0 ,0 ,1 ,1,15641 , 0 
38041.078,11,30 ,9 ,1065 ,0 ,0 ,1 ,1 ,0 ,0 ,0 ,2 ,0 ,4 ,0 ,4,25765 , 0 
38041.127,2,30 ,1 ,256 ,0 ,0 ,26 ,0 ,52 ,0 ,0 ,78 ,105 ,18 ,52 ,175,27591 , 0 
38041.214,18,30 ,19 ,525 ,0 ,0 ,1 ,0 ,0 ,0 ,0 ,1 ,0 ,1 ,0 ,1,21621 , 0 
38041.236,4,30 ,8 ,512 ,0 ,0 ,1 ,1 ,0 ,0 ,0 ,2 ,0 ,0 ,0 ,0,19206 , 0 
38041.274,6,30 ,10 ,867 ,0 ,120 ,1 ,11 ,0 ,0 ,0 ,132 ,0 ,80 ,0 ,80,35387 , 1 
38041.29,7,30 ,16 ,775 ,0 ,0 ,0 ,18 ,0 ,0 ,0 ,18 ,0 ,45 ,0 ,45,30015 , 0 
38041.338,14,30 ,1 ,256 ,0 ,0 ,1 ,0 ,11 ,0 ,0 ,12 ,0 ,40 ,11 ,51,18870 , 0 
38041.35,15,30 ,7 ,1224 ,0 ,0 ,1 ,0 ,0 ,0 ,0 ,1 ,0 ,1 ,0 ,1,23415 , 0 
38041.36,20,30 ,5 ,801 ,0 ,0 ,3 ,0 ,0 ,0 ,0 ,3 ,0 ,1 ,0 ,1,20731 , 0 
38041.361,16,30 ,2 ,512 ,0 ,0 ,24 ,15 ,17 ,0 ,0 ,56 ,106 ,40 ,17 ,163,39386 , 0 
38041.445,10,30 ,14 ,521 ,0 ,0 ,26 ,0 ,11 ,0 ,0 ,37 ,109 ,0 ,11 ,120,19999 , 0 
38041.482,12,30 ,5 ,803 ,0 ,0 ,1 ,0 ,0 ,0 ,0 ,1 ,0 ,4 ,0 ,4,22745 , 0 
38041.596,9,30 ,5 ,908 ,0 ,0 ,2 ,0 ,1 ,0 ,0 ,3 ,0 ,23 ,1 ,24,35386 , 0 
38041.607,19,30 ,1 ,256 ,0 ,0 ,1 ,0 ,0 ,0 ,0 ,1 ,0 ,27 ,0 ,27,22479 , 0 
38041.608,5,30 ,2 ,512 ,0 ,0 ,1 ,19 ,1 ,0 ,0 ,21 ,0 ,31 ,1 ,32,34675 , 0 
38041.697,17,30 ,7 ,1220 ,0 ,0 ,25 ,0 ,0 ,0 ,0 ,25 ,110 ,22 ,0 ,132,27302 , 0 
38041.771,13,30 ,1 ,256 ,0 ,0 ,1 ,0 ,0 ,0 ,0 ,1 ,0 ,22 ,0 ,22,19753 , 0 
38041.787,3,30 ,1 ,256 ,0 ,0 ,0 ,0 ,0 ,0 ,0 ,0 ,0 ,0 ,0 ,0,14238 , 0 
38160.96,8,30 ,1 ,256 ,0 ,0 ,1 ,0 ,0 ,0 ,0 ,1 ,0 ,1 ,0 ,1,15889 , 0 
38161.078,11,30 ,9 ,1146 ,0 ,0 ,1 ,4 ,0 ,0 ,0 ,5 ,0 ,5 ,0 ,5,25195 , 0 
38161.124,2,30 ,1 ,256 ,0 ,0 ,26 ,0 ,61 ,0 ,1 ,88 ,105 ,16 ,63 ,184,28972 , 0 
38161.214,18,30 ,19 ,525 ,0 ,0 ,1 ,0 ,0 ,0 ,0 ,1 ,0 ,1 ,0 ,1,20413 , 0 
38161.236,4,30 ,8 ,512 ,0 ,0 ,1 ,0 ,0 ,0 ,0 ,1 ,0 ,0 ,0 ,0,18123 , 0 
38161.27,6,30 ,10 ,880 ,0 ,120 ,1 ,14 ,0 ,0 ,0 ,135 ,0 ,73 ,0 ,73,41228 , 1 
38161.29,7,30 ,16 ,787 ,0 ,0 ,1 ,15 ,0 ,0 ,0 ,16 ,0 ,46 ,0 ,46,30247 , 0 
38161.338,14,30 ,1 ,256 ,0 ,0 ,0 ,0 ,15 ,0 ,0 ,15 ,0 ,36 ,15 ,51,18223 , 0 
38161.35,15,30 ,7 ,1224 ,0 ,0 ,1 ,0 ,0 ,0 ,0 ,1 ,0 ,5 ,0 ,5,22662 , 0 
38161.36,20,30 ,5 ,801 ,0 ,0 ,1 ,0 ,0 ,0 ,0 ,1 ,0 ,2 ,0 ,2,19589 , 0 
38161.361,16,30 ,2 ,512 ,0 ,0 ,26 ,16 ,30 ,0 ,0 ,72 ,103 ,43 ,30 ,176,42572 , 0 
38161.445,10,30 ,14 ,521 ,0 ,0 ,25 ,0 ,15 ,0 ,0 ,40 ,109 ,0 ,15 ,124,21090 , 0 
38161.482,12,30 ,5 ,803 ,0 ,0 ,1 ,0 ,0 ,0 ,0 ,1 ,0 ,1 ,0 ,1,21541 , 0 
38161.596,9,30 ,16 ,787 ,0 ,0 ,5 ,11 ,4 ,1 ,0 ,21 ,0 ,22 ,4 ,26,37303 , 0 
38161.603,5,30 ,2 ,512 ,0 ,0 ,0 ,15 ,0 ,1 ,1 ,17 ,0 ,28 ,1 ,29,34938 , 0 
38161.606,19,30 ,1 ,256 ,0 ,0 ,1 ,0 ,0 ,0 ,0 ,1 ,0 ,25 ,0 ,25,21887 , 0 
38161.697,17,30 ,7 ,1240 ,0 ,0 ,25 ,0 ,0 ,0 ,0 ,25 ,104 ,18 ,0 ,122,27589 , 0 
38161.771,13,30 ,1 ,256 ,0 ,0 ,2 ,0 ,0 ,0 ,0 ,2 ,0 ,20 ,0 ,20,19736 , 0 
38161.787,3,30 ,1 ,256 ,0 ,0 ,1 ,0 ,0 ,0 ,0 ,1 ,0 ,0 ,0 ,0,13826 , 0 
38280.96,8,30 ,1 ,256 ,0 ,0 ,1 ,0 ,0 ,0 ,0 ,1 ,0 ,2 ,0 ,2,15704 , 0 
38281.078,11,30 ,9 ,1151 ,0 ,0 ,1 ,1 ,0 ,0 ,0 ,2 ,0 ,4 ,0 ,4,25835 , 0 
38281.124,2,30 ,1 ,256 ,0 ,0 ,6 ,0 ,18 ,0 ,0 ,24 ,1 ,3 ,18 ,22,27714 , 0 
38281.138,6,30 ,10 ,849 ,0 ,0 ,0 ,4 ,0 ,0 ,0 ,4 ,0 ,20 ,0 ,20,35495 , 0 
38281.214,18,30 ,19 ,525 ,0 ,0 ,1 ,0 ,0 ,0 ,0 ,1 ,0 ,2 ,0 ,2,21686 , 0 
38281.236,4,30 ,8 ,512 ,0 ,0 ,1 ,0 ,0 ,0 ,0 ,1 ,0 ,1 ,0 ,1,19262 , 0 
38281.292,7,30 ,16 ,806 ,0 ,0 ,1 ,4 ,0 ,0 ,0 ,5 ,0 ,11 ,0 ,11,30107 , 0 
38281.337,14,30 ,1 ,256 ,0 ,0 ,1 ,0 ,4 ,0 ,0 ,5 ,0 ,9 ,4 ,13,18962 , 0 
38281.35,15,30 ,7 ,1224 ,0 ,0 ,2 ,0 ,0 ,0 ,0 ,2 ,0 ,3 ,0 ,3,23509 , 0 
38281.36,20,30 ,5 ,801 ,0 ,0 ,2 ,0 ,0 ,0 ,0 ,2 ,0 ,0 ,0 ,0,20795 , 0 
38281.378,16,30 ,2 ,512 ,0 ,0 ,7 ,3 ,9 ,0 ,0 ,19 ,0 ,8 ,9 ,17,39619 , 0 
38281.444,10,30 ,14 ,521 ,0 ,0 ,5 ,0 ,4 ,0 ,0 ,9 ,0 ,0 ,4 ,4,20134 , 0 
38281.482,12,30 ,5 ,803 ,0 ,0 ,2 ,0 ,0 ,0 ,0 ,2 ,0 ,1 ,0 ,1,22818 , 0 
38281.596,9,30 ,16 ,806 ,0 ,0 ,2 ,4 ,1 ,0 ,0 ,7 ,0 ,6 ,1 ,7,35492 , 0 
38281.602,5,30 ,2 ,512 ,0 ,0 ,1 ,6 ,0 ,0 ,0 ,7 ,0 ,7 ,0 ,7,34788 , 0 
38281.606,19,30 ,1 ,256 ,0 ,0 ,1 ,0 ,0 ,0 ,0 ,1 ,0 ,5 ,0 ,5,22555 , 0 
38281.696,17,30 ,7 ,1157 ,0 ,0 ,6 ,0 ,0 ,0 ,0 ,6 ,0 ,6 ,0 ,6,27414 , 0 
38281.771,13,30 ,1 ,256 ,0 ,0 ,0 ,0 ,0 ,0 ,0 ,0 ,0 ,5 ,0 ,5,19825 , 0 
38281.787,3,30 ,1 ,256 ,0 ,0 ,1 ,0 ,0 ,0 ,0 ,1 ,0 ,2 ,0 ,2,14302 , 0 
38400.96,8,30 ,1 ,256 ,0 ,0 ,1 ,0 ,0 ,0 ,0 ,1 ,0 ,0 ,0 ,0,15950 , 0 
38401.078,11,30 ,9 ,1125 ,0 ,0 ,1 ,1 ,0 ,0 ,0 ,2 ,0 ,3 ,0 ,3,25286 , 0 
38401.123,2,30 ,1 ,256 ,0 ,0 ,2 ,0 ,5 ,0 ,0 ,7 ,0 ,2 ,5 ,7,29088 , 0 
38401.138,6,30 ,10 ,828 ,0 ,0 ,2 ,2 ,0 ,0 ,0 ,4 ,0 ,6 ,0 ,6,41315 , 0 
38401.214,18,30 ,19 ,525 ,0 ,0 ,2 ,0 ,0 ,0 ,0 ,2 ,0 ,2 ,0 ,2,20485 , 0 
38401.236,4,30 ,8 ,512 ,0 ,0 ,2 ,0 ,0 ,0 ,0 ,2 ,0 ,1 ,0 ,1,18210 , 0 
38401.289,7,30 ,16 ,806 ,0 ,0 ,1 ,1 ,0 ,0 ,0 ,2 ,0 ,4 ,0 ,4,30328 , 0 
38401.337,14,30 ,1 ,256 ,0 ,0 ,1 ,0 ,2 ,0 ,0 ,3 ,0 ,4 ,2 ,6,18304 , 0 
38401.35,15,30 ,7 ,1145 ,0 ,0 ,2 ,0 ,0 ,0 ,0 ,2 ,0 ,2 ,0 ,2,22725 , 0 
38401.36,20,30 ,5 ,801 ,0 ,0 ,1 ,0 ,0 ,0 ,0 ,1 ,0 ,2 ,0 ,2,19661 , 0 
38401.36,16,30 ,2 ,512 ,0 ,0 ,0 ,1 ,3 ,0 ,0 ,4 ,0 ,4 ,3 ,7,42668 , 0 
38401.444,10,30 ,14 ,521 ,0 ,0 ,3 ,0 ,2 ,0 ,0 ,5 ,0 ,0 ,2 ,2,21185 , 0 
38401.482,12,30 ,5 ,803 ,0 ,0 ,1 ,0 ,0 ,0 ,0 ,1 ,0 ,2 ,0 ,2,21611 , 0 
38401.596,9,30 ,16 ,806 ,0 ,0 ,2 ,1 ,1 ,0 ,0 ,4 ,0 ,0 ,1 ,1,37380 , 0 
38401.602,5,30 ,2 ,512 ,0 ,0 ,1 ,1 ,0 ,0 ,0 ,2 ,0 ,6 ,0 ,6,35041 , 0 
38401.606,19,30 ,1 ,256 ,0 ,0 ,1 ,0 ,0 ,0 ,0 ,1 ,0 ,6 ,0 ,6,21994 , 0 
38401.696,17,30 ,7 ,1157 ,0 ,0 ,2 ,0 ,0 ,0 ,0 ,2 ,0 ,0 ,0 ,0,27669 , 0 
38401.771,13,30 ,1 ,256 ,0 ,0 ,1 ,0 ,0 ,0 ,0 ,1 ,0 ,3 ,0 ,3,19806 , 0 
38401.787,3,30 ,1 ,256 ,0 ,0 ,1 ,0 ,0 ,0 ,0 ,1 ,0 ,0 ,0 ,0,13882 , 0 
38520.96,8,30 ,1 ,256 ,0 ,0 ,1 ,0 ,0 ,0 ,0 ,1 ,0 ,2 ,0 ,2,15762 , 0 
38521.078,11,30 ,9 ,1125 ,0 ,0 ,1 ,0 ,0 ,0 ,0 ,1 ,0 ,2 ,0 ,2,25911 , 0 
38521.123,2,30 ,1 ,256 ,0 ,0 ,1 ,0 ,2 ,0 ,0 ,3 ,0 ,1 ,2 ,3,27788 , 0 
38521.138,6,30 ,10 ,822 ,0 ,0 ,1 ,1 ,0 ,0 ,0 ,2 ,0 ,2 ,0 ,2,35559 , 0 
38521.214,18,30 ,19 ,525 ,0 ,0 ,0 ,0 ,0 ,0 ,0 ,0 ,0 ,1 ,0 ,1,21747 , 0 
38521.236,4,30 ,8 ,512 ,0 ,0 ,1 ,0 ,0 ,0 ,0 ,1 ,0 ,0 ,0 ,0,19321 , 0 
38521.289,7,30 ,16 ,784 ,0 ,0 ,1 ,1 ,0 ,0 ,0 ,2 ,0 ,1 ,0 ,1,30201 , 0 
38521.337,14,30 ,1 ,256 ,0 ,0 ,1 ,0 ,1 ,0 ,0 ,2 ,0 ,1 ,1 ,2,19052 , 0 
38521.35,15,30 ,7 ,1145 ,0 ,0 ,1 ,0 ,0 ,0 ,0 ,1 ,0 ,1 ,0 ,1,23579 , 0 
38521.36,20,30 ,5 ,801 ,0 ,0 ,1 ,0 ,0 ,0 ,0 ,1 ,0 ,0 ,0 ,0,20856 , 0 
38521.36,16,30 ,2 ,512 ,0 ,0 ,2 ,0 ,2 ,0 ,0 ,4 ,0 ,1 ,2 ,3,39721 , 0 
38521.444,10,30 ,14 ,521 ,0 ,0 ,1 ,0 ,1 ,0 ,0 ,2 ,0 ,0 ,1 ,1,20194 , 0 
38521.482,12,30 ,5 ,803 ,0 ,0 ,2 ,0 ,0 ,0 ,0 ,2 ,0 ,0 ,0 ,0,22885 , 0 
38521.596,9,30 ,16 ,786 ,0 ,0 ,1 ,1 ,0 ,0 ,0 ,2 ,0 ,4 ,0 ,4,35593 , 0 
38521.602,5,30 ,2 ,512 ,0 ,0 ,1 ,0 ,0 ,0 ,0 ,1 ,0 ,2 ,0 ,2,34906 , 0 
38521.606,19,30 ,1 ,256 ,0 ,0 ,1 ,0 ,0 ,0 ,0 ,1 ,0 ,2 ,0 ,2,22644 , 0 
38521.696,17,30 ,7 ,1157 ,0 ,0 ,1 ,0 ,0 ,0 ,0 ,1 ,0 ,1 ,0 ,1,27476 , 0 
38521.771,13,30 ,1 ,256 ,0 ,0 ,2 ,0 ,0 ,0 ,0 ,2 ,0 ,1 ,0 ,1,19933 , 0 
38521.787,3,30 ,1 ,256 ,0 ,0 ,1 ,0 ,0 ,0 ,0 ,1 ,0 ,1 ,0 ,1,14363 , 0 
38640.96,8,30 ,1 ,256 ,0 ,0 ,2 ,0 ,0 ,0 ,0 ,2 ,0 ,1 ,0 ,1,16032 , 0 
38641.078,11,30 ,9 ,1150 ,0 ,0 ,6 ,7 ,0 ,2 ,0 ,15 ,0 ,22 ,0 ,22,25488 , 0 
38641.124,2,30 ,1 ,256 ,0 ,0 ,8 ,0 ,26 ,0 ,2 ,36 ,0 ,14 ,30 ,44,29262 , 0 
38641.138,6,30 ,10 ,915 ,0 ,0 ,8 ,1 ,5 ,0 ,0 ,14 ,0 ,21 ,5 ,26,41471 , 0 
38641.214,18,30 ,19 ,525 ,0 ,0 ,1 ,0 ,0 ,0 ,0 ,1 ,0 ,7 ,0 ,7,20560 , 0 
38641.236,4,30 ,8 ,512 ,0 ,0 ,1 ,0 ,0 ,0 ,0 ,1 ,0 ,2 ,0 ,2,18288 , 0 
38641.289,7,30 ,9 ,1150 ,0 ,0 ,9 ,2 ,1 ,2 ,0 ,14 ,0 ,20 ,3 ,23,30508 , 0 
38641.337,14,30 ,1 ,256 ,0 ,0 ,1 ,0 ,6 ,0 ,0 ,7 ,0 ,8 ,6 ,14,18381 , 0 
38641.35,15,30 ,9 ,1150 ,0 ,0 ,5 ,4 ,0 ,1 ,0 ,10 ,0 ,18 ,0 ,18,22891 , 0 
38641.36,20,30 ,5 ,840 ,0 ,0 ,5 ,1 ,0 ,0 ,0 ,6 ,0 ,11 ,0 ,11,19765 , 0 
38641.361,16,30 ,2 ,512 ,0 ,0 ,6 ,5 ,2 ,2 ,2 ,17 ,0 ,32 ,4 ,36,42921 , 1 
38641.461,10,30 ,14 ,521 ,0 ,0 ,2 ,0 ,7 ,0 ,0 ,9 ,0 ,6 ,7 ,13,21339 , 0 
38641.482,12,30 ,5 ,840 ,0 ,0 ,5 ,1 ,0 ,0 ,0 ,6 ,0 ,12 ,1 ,13,21753 , 0 
38641.596,9,30 ,5 ,844 ,0 ,0 ,10 ,1 ,13 ,1 ,0 ,25 ,0 ,22 ,14 ,36,37684 , 0 
38641.603,5,30 ,2 ,512 ,0 ,0 ,6 ,5 ,15 ,0 ,0 ,26 ,0 ,24 ,15 ,39,35394 , 0 
38641.607,19,30 ,1 ,256 ,0 ,0 ,1 ,0 ,0 ,0 ,0 ,1 ,0 ,12 ,0 ,12,22074 , 0 
38641.697,17,30 ,6 ,1171 ,0 ,0 ,10 ,7 ,0 ,1 ,0 ,18 ,0 ,20 ,1 ,21,27892 , 0 
38641.771,13,30 ,1 ,256 ,0 ,0 ,1 ,0 ,0 ,0 ,0 ,1 ,0 ,8 ,0 ,8,19877 , 0 
38641.787,3,30 ,1 ,256 ,0 ,0 ,0 ,0 ,0 ,0 ,0 ,0 ,0 ,2 ,0 ,2,13949 , 0 
38760.96,8,30 ,1 ,256 ,0 ,0 ,1 ,0 ,0 ,0 ,0 ,1 ,0 ,0 ,0 ,0,15817 , 0 
38761.078,11,30 ,9 ,1090 ,0 ,0 ,2 ,3 ,0 ,0 ,0 ,5 ,0 ,8 ,0 ,8,26012 , 0 
38761.124,2,30 ,1 ,256 ,0 ,0 ,6 ,0 ,27 ,0 ,0 ,33 ,0 ,7 ,27 ,34,27931 , 0 
38761.138,6,30 ,2 ,512 ,0 ,0 ,8 ,4 ,6 ,1 ,0 ,19 ,0 ,11 ,6 ,17,35743 , 0 
38761.214,18,30 ,19 ,525 ,0 ,0 ,1 ,0 ,0 ,0 ,0 ,1 ,0 ,2 ,0 ,2,21821 , 0 
38761.236,4,30 ,8 ,512 ,0 ,0 ,1 ,0 ,0 ,0 ,0 ,1 ,0 ,0 ,0 ,0,19396 , 0 
38761.289,7,30 ,9 ,1090 ,0 ,0 ,6 ,3 ,0 ,0 ,0 ,9 ,0 ,11 ,0 ,11,30316 , 0 
38761.337,14,30 ,1 ,256 ,0 ,0 ,1 ,0 ,2 ,1 ,1 ,5 ,0 ,5 ,4 ,9,19123 , 0 
38761.35,15,30 ,9 ,1090 ,0 ,0 ,2 ,3 ,0 ,0 ,0 ,5 ,0 ,9 ,0 ,9,23667 , 0 
38761.36,20,30 ,5 ,821 ,0 ,0 ,2 ,1 ,0 ,0 ,0 ,3 ,0 ,4 ,0 ,4,20935 , 0 
38761.36,16,30 ,2 ,512 ,0 ,0 ,2 ,3 ,0 ,0 ,0 ,5 ,0 ,18 ,0 ,18,39835 , 1 
38761.444,10,30 ,14 ,521 ,0 ,0 ,0 ,0 ,1 ,1 ,1 ,3 ,0 ,7 ,2 ,9,20260 , 0 
38761.482,12,30 ,5 ,821 ,0 ,0 ,1 ,1 ,0 ,0 ,0 ,2 ,0 ,5 ,0 ,5,22969 , 0 
38761.596,9,30 ,5 ,821 ,0 ,0 ,6 ,1 ,9 ,0 ,0 ,16 ,0 ,7 ,9 ,16,35796 , 0 
38761.603,5,30 ,2 ,512 ,0 ,0 ,2 ,4 ,12 ,0 ,0 ,18 ,0 ,10 ,12 ,22,35136 , 0 
38761.606,19,30 ,1 ,256 ,0 ,0 ,1 ,0 ,0 ,0 ,0 ,1 ,0 ,7 ,0 ,7,22741 , 0 
38761.697,17,30 ,6 ,878 ,0 ,0 ,5 ,5 ,0 ,0 ,0 ,10 ,0 ,11 ,0 ,11,27603 , 0 
38761.771,13,30 ,1 ,256 ,0 ,0 ,1 ,0 ,0 ,0 ,0 ,1 ,0 ,6 ,0 ,6,20010 , 0 
38761.787,3,30 ,1 ,256 ,0 ,0 ,1 ,0 ,0 ,0 ,0 ,1 ,0 ,0 ,0 ,0,14420 , 0 
38880.96,8,30 ,1 ,256 ,0 ,0 ,1 ,0 ,0 ,0 ,0 ,1 ,0 ,1 ,0 ,1,16091 , 0 
38881.078,11,30 ,9 ,1094 ,0 ,0 ,2 ,6 ,0 ,0 ,0 ,8 ,0 ,13 ,0 ,13,25617 , 0 
38881.124,2,30 ,1 ,256 ,0 ,0 ,6 ,0 ,40 ,0 ,0 ,46 ,0 ,7 ,40 ,47,29423 , 0 
38881.138,6,30 ,2 ,512 ,0 ,0 ,7 ,5 ,7 ,0 ,0 ,19 ,0 ,11 ,7 ,18,41649 , 0 
38881.214,18,30 ,19 ,525 ,0 ,0 ,1 ,0 ,0 ,0 ,0 ,1 ,0 ,4 ,0 ,4,20645 , 0 
38881.236,4,30 ,8 ,512 ,0 ,0 ,1 ,0 ,0 ,0 ,0 ,1 ,0 ,0 ,0 ,0,18357 , 0 
38881.289,7,30 ,9 ,1094 ,0 ,0 ,6 ,6 ,0 ,0 ,0 ,12 ,0 ,13 ,0 ,13,30675 , 0 
38881.337,14,30 ,1 ,256 ,0 ,0 ,1 ,0 ,0 ,0 ,0 ,1 ,0 ,5 ,0 ,5,18480 , 0 
38881.35,15,30 ,9 ,1094 ,0 ,0 ,2 ,7 ,0 ,0 ,0 ,9 ,0 ,13 ,0 ,13,23010 , 0 
38881.36,20,30 ,5 ,793 ,0 ,0 ,2 ,1 ,0 ,0 ,0 ,3 ,0 ,4 ,0 ,4,19885 , 0 
38881.36,16,30 ,2 ,512 ,0 ,0 ,2 ,3 ,0 ,0 ,0 ,5 ,0 ,22 ,0 ,22,43049 , 1 
38881.444,10,30 ,14 ,521 ,0 ,0 ,2 ,0 ,0 ,0 ,0 ,2 ,0 ,5 ,0 ,5,21430 , 0 
38881.482,12,30 ,5 ,793 ,0 ,0 ,3 ,1 ,0 ,0 ,0 ,4 ,0 ,3 ,0 ,3,21885 , 0 
38881.596,9,30 ,5 ,793 ,0 ,0 ,8 ,1 ,19 ,0 ,0 ,28 ,0 ,9 ,19 ,28,37995 , 0 
38881.603,5,30 ,2 ,512 ,0 ,0 ,2 ,3 ,22 ,0 ,0 ,27 ,0 ,15 ,22 ,37,35761 , 0 
38881.606,19,30 ,1 ,256 ,0 ,0 ,1 ,0 ,0 ,0 ,0 ,1 ,0 ,5 ,0 ,5,22192 , 0 
38881.697,17,30 ,6 ,819 ,0 ,0 ,6 ,7 ,0 ,0 ,0 ,13 ,0 ,11 ,0 ,11,28048 , 0 
38881.771,13,30 ,1 ,256 ,0 ,0 ,0 ,0 ,0 ,0 ,0 ,0 ,0 ,6 ,0 ,6,19951 , 0 
38881.787,3,30 ,1 ,256 ,0 ,0 ,2 ,0 ,0 ,0 ,0 ,2 ,0 ,1 ,0 ,1,14018 , 0 
39000.96,8,30 ,1 ,256 ,0 ,0 ,1 ,0 ,0 ,0 ,0 ,1 ,0 ,2 ,0 ,2,15891 , 0 
39001.078,11,30 ,9 ,1071 ,0 ,0 ,2 ,2 ,0 ,0 ,0 ,4 ,0 ,5 ,0 ,5,26116 , 0 
39001.124,2,30 ,1 ,256 ,0 ,0 ,2 ,0 ,14 ,0 ,1 ,17 ,0 ,5 ,15 ,20,28043 , 0 
39001.138,6,30 ,2 ,512 ,0 ,0 ,2 ,1 ,1 ,0 ,0 ,4 ,0 ,5 ,1 ,6,35835 , 0 
39001.214,18,30 ,19 ,525 ,0 ,0 ,2 ,0 ,0 ,0 ,0 ,2 ,0 ,2 ,0 ,2,21885 , 0 
39001.236,4,30 ,8 ,512 ,0 ,0 ,1 ,0 ,0 ,0 ,0 ,1 ,0 ,0 ,0 ,0,19460 , 0 
39001.337,14,30 ,1 ,256 ,0 ,0 ,1 ,0 ,0 ,0 ,0 ,1 ,0 ,4 ,0 ,4,19191 , 0 
39001.352,15,30 ,9 ,1071 ,0 ,0 ,1 ,2 ,0 ,0 ,0 ,3 ,0 ,5 ,0 ,5,23757 , 0 
39001.36,20,30 ,5 ,771 ,0 ,0 ,1 ,1 ,0 ,0 ,0 ,2 ,0 ,2 ,0 ,2,20998 , 0 
39001.363,16,30 ,2 ,512 ,0 ,0 ,2 ,2 ,0 ,0 ,0 ,4 ,0 ,10 ,0 ,10,39936 , 0 
39001.425,7,30 ,16 ,832 ,0 ,0 ,4 ,3 ,0 ,1 ,0 ,8 ,0 ,7 ,0 ,7,30435 , 0 
39001.444,10,30 ,14 ,521 ,0 ,0 ,2 ,0 ,0 ,0 ,0 ,2 ,0 ,2 ,0 ,2,20323 , 0 
39001.482,12,30 ,5 ,771 ,0 ,0 ,1 ,1 ,0 ,0 ,0 ,2 ,0 ,3 ,0 ,3,23030 , 0 
39001.596,9,30 ,5 ,793 ,0 ,0 ,3 ,0 ,7 ,0 ,1 ,11 ,0 ,3 ,8 ,11,35954 , 0 
39001.603,5,30 ,2 ,512 ,0 ,0 ,2 ,1 ,9 ,0 ,1 ,13 ,0 ,3 ,10 ,13,35318 , 0 
39001.606,19,30 ,1 ,256 ,0 ,0 ,2 ,0 ,0 ,0 ,0 ,2 ,0 ,3 ,0 ,3,22840 , 0 
39001.696,17,30 ,6 ,808 ,0 ,0 ,3 ,1 ,0 ,0 ,0 ,4 ,0 ,5 ,0 ,5,27690 , 0 
39001.771,13,30 ,1 ,256 ,0 ,0 ,1 ,0 ,0 ,0 ,0 ,1 ,0 ,4 ,0 ,4,20095 , 0 
39001.786,3,30 ,1 ,256 ,0 ,0 ,1 ,0 ,0 ,0 ,0 ,1 ,0 ,1 ,0 ,1,14484 , 0 
39120.96,8,30 ,1 ,256 ,0 ,0 ,1 ,0 ,0 ,0 ,0 ,1 ,0 ,0 ,0 ,0,16145 , 0 
39121.078,11,30 ,9 ,1060 ,0 ,0 ,2 ,1 ,0 ,0 ,0 ,3 ,0 ,4 ,0 ,4,25692 , 0 
39121.123,2,30 ,1 ,256 ,0 ,0 ,2 ,0 ,6 ,0 ,0 ,8 ,0 ,1 ,7 ,8,29505 , 0 
39121.138,6,30 ,2 ,512 ,0 ,0 ,1 ,1 ,1 ,0 ,0 ,3 ,0 ,4 ,1 ,5,41721 , 0 
39121.214,18,30 ,19 ,525 ,0 ,0 ,1 ,0 ,0 ,0 ,0 ,1 ,0 ,1 ,0 ,1,20705 , 0 
39121.235,4,30 ,8 ,512 ,0 ,0 ,1 ,0 ,0 ,0 ,0 ,1 ,0 ,1 ,0 ,1,18423 , 0 
39121.289,7,30 ,16 ,832 ,0 ,0 ,5 ,1 ,0 ,0 ,0 ,6 ,0 ,4 ,0 ,4,30774 , 0 
39121.337,14,30 ,1 ,256 ,0 ,0 ,1 ,0 ,0 ,0 ,0 ,1 ,0 ,3 ,0 ,3,18544 , 0 
39121.35,15,30 ,9 ,1060 ,0 ,0 ,2 ,1 ,0 ,0 ,0 ,3 ,0 ,6 ,0 ,6,23083 , 0 
39121.36,20,30 ,5 ,771 ,0 ,0 ,2 ,0 ,0 ,0 ,0 ,2 ,0 ,3 ,0 ,3,19959 , 0 
39121.36,16,30 ,2 ,512 ,0 ,0 ,1 ,0 ,1 ,0 ,0 ,2 ,0 ,9 ,1 ,10,43125 , 0 
39121.444,10,30 ,14 ,521 ,0 ,0 ,2 ,0 ,0 ,0 ,0 ,2 ,0 ,1 ,0 ,1,21491 , 0 
39121.482,12,30 ,5 ,771 ,0 ,0 ,2 ,0 ,0 ,0 ,0 ,2 ,0 ,3 ,0 ,3,21958 , 0 
39121.596,9,30 ,5 ,793 ,0 ,0 ,1 ,0 ,2 ,1 ,0 ,4 ,0 ,6 ,2 ,8,38100 , 0 
39121.602,5,30 ,2 ,512 ,0 ,0 ,1 ,1 ,2 ,1 ,0 ,5 ,0 ,8 ,3 ,11,35901 , 0 
39121.606,19,30 ,1 ,256 ,0 ,0 ,1 ,0 ,0 ,0 ,0 ,1 ,0 ,4 ,0 ,4,22278 , 0 
39121.696,17,30 ,6 ,793 ,0 ,0 ,2 ,1 ,0 ,0 ,0 ,3 ,0 ,6 ,0 ,6,28118 , 0 
39121.771,13,30 ,1 ,256 ,0 ,0 ,2 ,0 ,0 ,0 ,0 ,2 ,0 ,1 ,0 ,1,20040 , 0 
39121.787,3,30 ,1 ,256 ,0 ,0 ,0 ,0 ,0 ,0 ,0 ,0 ,0 ,0 ,0 ,0,14068 , 0 
39240.96,8,30 ,1 ,256 ,0 ,0 ,2 ,0 ,1 ,0 ,0 ,3 ,0 ,1 ,1 ,2,15958 , 0 
39241.078,11,30 ,9 ,1060 ,0 ,0 ,2 ,0 ,0 ,0 ,0 ,2 ,0 ,3 ,0 ,3,26202 , 0 
39241.123,2,30 ,1 ,256 ,0 ,0 ,2 ,0 ,1 ,0 ,0 ,3 ,0 ,2 ,1 ,3,28130 , 0 
39241.138,6,30 ,2 ,512 ,0 ,0 ,1 ,0 ,0 ,0 ,0 ,1 ,0 ,1 ,0 ,1,35911 , 0 
39241.214,18,30 ,19 ,525 ,0 ,0 ,1 ,0 ,0 ,0 ,0 ,1 ,0 ,2 ,0 ,2,21971 , 0 
39241.236,4,30 ,8 ,512 ,0 ,0 ,1 ,1 ,0 ,0 ,0 ,2 ,0 ,1 ,0 ,1,19549 , 0 
39241.289,7,30 ,16 ,832 ,0 ,0 ,2 ,0 ,0 ,0 ,0 ,2 ,0 ,0 ,0 ,0,30502 , 0 
39241.337,14,30 ,1 ,256 ,0 ,0 ,1 ,0 ,0 ,0 ,0 ,1 ,0 ,3 ,0 ,3,19274 , 0 
39241.35,15,30 ,9 ,1054 ,0 ,0 ,1 ,1 ,0 ,0 ,0 ,2 ,0 ,4 ,0 ,4,23834 , 0 
39241.36,20,30 ,5 ,771 ,0 ,0 ,2 ,0 ,0 ,0 ,0 ,2 ,0 ,0 ,0 ,0,21067 , 0 
39241.36,16,30 ,2 ,512 ,0 ,0 ,1 ,0 ,0 ,0 ,0 ,1 ,0 ,4 ,0 ,4,40010 , 0 
39241.444,10,30 ,14 ,521 ,0 ,0 ,1 ,0 ,0 ,0 ,0 ,1 ,0 ,0 ,0 ,0,20377 , 0 
39241.482,12,30 ,5 ,771 ,0 ,0 ,1 ,0 ,0 ,0 ,0 ,1 ,0 ,2 ,0 ,2,23104 , 0 
39241.596,9,30 ,5 ,793 ,0 ,0 ,2 ,0 ,1 ,0 ,0 ,3 ,0 ,2 ,1 ,3,36052 , 0 
39241.602,5,30 ,2 ,512 ,0 ,0 ,1 ,0 ,1 ,0 ,0 ,2 ,0 ,2 ,1 ,3,35423 , 0 
39241.606,19,30 ,1 ,256 ,0 ,0 ,1 ,0 ,0 ,0 ,0 ,1 ,0 ,2 ,0 ,2,22918 , 0 
39241.696,17,30 ,6 ,793 ,0 ,0 ,0 ,0 ,0 ,0 ,0 ,0 ,0 ,1 ,0 ,1,27750 , 0 
39241.771,13,30 ,1 ,256 ,0 ,0 ,1 ,0 ,0 ,0 ,0 ,1 ,0 ,1 ,0 ,1,20156 , 0 
39241.787,3,30 ,1 ,256 ,0 ,0 ,2 ,0 ,0 ,0 ,0 ,2 ,0 ,1 ,0 ,1,14564 , 0 
39360.96,8,30 ,1 ,256 ,0 ,0 ,1 ,0 ,0 ,0 ,0 ,1 ,0 ,1 ,0 ,1,16214 , 0 
39361.078,11,30 ,9 ,1053 ,0 ,0 ,1 ,1 ,0 ,0 ,0 ,2 ,0 ,2 ,0 ,2,25768 , 0 
39361.123,2,30 ,1 ,256 ,0 ,0 ,2 ,0 ,6 ,0 ,0 ,8 ,0 ,2 ,6 ,8,29655 , 0 
39361.138,6,30 ,2 ,512 ,0 ,0 ,2 ,2 ,1 ,0 ,0 ,5 ,0 ,3 ,1 ,4,41834 , 0 
39361.214,18,30 ,19 ,525 ,0 ,0 ,1 ,0 ,0 ,0 ,0 ,1 ,0 ,0 ,0 ,0,20778 , 0 
39361.236,4,30 ,8 ,512 ,0 ,0 ,1 ,0 ,0 ,0 ,0 ,1 ,0 ,0 ,0 ,0,18485 , 0 
39361.289,7,30 ,16 ,832 ,0 ,0 ,1 ,0 ,0 ,0 ,0 ,1 ,0 ,4 ,0 ,4,30880 , 0 
39361.337,14,30 ,1 ,256 ,0 ,0 ,1 ,0 ,0 ,0 ,0 ,1 ,0 ,3 ,0 ,3,18618 , 0 
39361.35,15,30 ,9 ,1053 ,0 ,0 ,1 ,0 ,0 ,0 ,0 ,1 ,0 ,1 ,0 ,1,23204 , 0 
39361.36,20,30 ,5 ,771 ,0 ,0 ,0 ,0 ,0 ,0 ,0 ,0 ,0 ,0 ,0 ,0,20050 , 0 
39361.36,16,30 ,2 ,512 ,0 ,0 ,1 ,1 ,0 ,0 ,0 ,2 ,0 ,3 ,0 ,3,43237 , 1 
39361.444,10,30 ,14 ,521 ,0 ,0 ,2 ,0 ,0 ,0 ,0 ,2 ,0 ,2 ,0 ,2,21559 , 0 
39361.482,12,30 ,5 ,771 ,0 ,0 ,1 ,0 ,0 ,0 ,0 ,1 ,0 ,0 ,0 ,0,22036 , 0 
39361.596,9,30 ,5 ,793 ,0 ,0 ,2 ,0 ,1 ,0 ,0 ,3 ,0 ,2 ,1 ,3,38194 , 0 
39361.602,5,30 ,2 ,512 ,0 ,0 ,1 ,1 ,1 ,0 ,0 ,3 ,0 ,2 ,1 ,3,35988 , 0 
39361.606,19,30 ,1 ,256 ,0 ,0 ,1 ,0 ,0 ,0 ,0 ,1 ,0 ,3 ,0 ,3,22355 , 0 
39361.696,17,30 ,6 ,797 ,0 ,0 ,2 ,1 ,0 ,0 ,0 ,3 ,0 ,2 ,0 ,2,28200 , 0 
39361.771,13,30 ,1 ,256 ,0 ,0 ,2 ,0 ,0 ,0 ,0 ,2 ,0 ,2 ,0 ,2,20127 , 0 
39361.786,3,30 ,1 ,256 ,0 ,0 ,1 ,0 ,0 ,0 ,0 ,1 ,0 ,1 ,0 ,1,14132 , 0 
39480.96,8,30 ,1 ,256 ,0 ,0 ,2 ,0 ,0 ,0 ,0 ,2 ,0 ,1 ,0 ,1,16018 , 0 
39481.078,11,30 ,9 ,1024 ,0 ,0 ,1 ,4 ,0 ,0 ,0 ,5 ,0 ,10 ,0 ,10,26292 , 0 
39481.124,2,30 ,1 ,256 ,0 ,0 ,1 ,0 ,15 ,0 ,1 ,17 ,0 ,6 ,17 ,23,28225 , 0 
39481.138,6,30 ,2 ,512 ,0 ,0 ,1 ,0 ,0 ,0 ,0 ,1 ,0 ,8 ,0 ,8,35969 , 0 
39481.214,18,30 ,19 ,525 ,0 ,0 ,1 ,0 ,0 ,0 ,0 ,1 ,0 ,4 ,0 ,4,22044 , 0 
39481.236,4,30 ,8 ,512 ,0 ,0 ,2 ,0 ,0 ,0 ,0 ,2 ,0 ,2 ,0 ,2,19614 , 0 
39481.29,7,30 ,9 ,1024 ,0 ,0 ,5 ,4 ,0 ,1 ,0 ,10 ,0 ,17 ,0 ,17,30622 , 0 
39481.337,14,30 ,1 ,256 ,0 ,0 ,0 ,0 ,0 ,0 ,0 ,0 ,0 ,1 ,0 ,1,19336 , 0 
39481.35,15,30 ,9 ,1024 ,0 ,0 ,5 ,4 ,0 ,0 ,0 ,9 ,0 ,8 ,0 ,8,23937 , 0 
39481.36,20,30 ,5 ,768 ,0 ,0 ,2 ,1 ,0 ,0 ,0 ,3 ,0 ,3 ,0 ,3,21162 , 0 
39481.36,16,30 ,2 ,512 ,0 ,0 ,5 ,0 ,0 ,1 ,1 ,7 ,0 ,14 ,1 ,15,40125 , 1 
39481.444,10,30 ,14 ,521 ,0 ,0 ,0 ,0 ,0 ,0 ,0 ,0 ,0 ,0 ,0 ,0,20425 , 0 
39481.482,12,30 ,5 ,768 ,0 ,0 ,1 ,1 ,0 ,0 ,0 ,2 ,0 ,2 ,0 ,2,23185 , 0 
39481.596,9,30 ,5 ,768 ,0 ,0 ,5 ,1 ,12 ,0 ,0 ,18 ,0 ,13 ,12 ,25,36285 , 0 
39481.603,5,30 ,2 ,512 ,0 ,0 ,2 ,0 ,15 ,0 ,0 ,17 ,0 ,7 ,15 ,22,35670 , 0 
39481.606,19,30 ,1 ,256 ,0 ,0 ,1 ,0 ,0 ,0 ,0 ,1 ,0 ,5 ,0 ,5,23000 , 0 
39481.696,17,30 ,6 ,797 ,0 ,0 ,5 ,0 ,0 ,0 ,0 ,5 ,0 ,7 ,0 ,7,27842 , 0 
39481.771,13,30 ,1 ,256 ,0 ,0 ,1 ,0 ,0 ,0 ,0 ,1 ,0 ,2 ,0 ,2,20250 , 0 
39481.787,3,30 ,1 ,256 ,0 ,0 ,1 ,0 ,0 ,0 ,0 ,1 ,0 ,1 ,0 ,1,14616 , 0 
39600.96,8,30 ,1 ,256 ,0 ,0 ,1 ,0 ,1 ,0 ,0 ,2 ,0 ,1 ,1 ,2,16280 , 0 
39601.078,11,30 ,9 ,1024 ,0 ,0 ,2 ,1 ,0 ,0 ,0 ,3 ,0 ,5 ,0 ,5,25859 , 0 
39601.123,2,30 ,1 ,256 ,0 ,0 ,1 ,0 ,3 ,0 ,0 ,4 ,0 ,2 ,3 ,5,29736 , 0 
39601.138,6,30 ,2 ,512 ,0 ,0 ,1 ,0 ,0 ,0 ,0 ,1 ,0 ,5 ,0 ,5,41909 , 0 
39601.214,18,30 ,19 ,525 ,0 ,0 ,2 ,0 ,0 ,0 ,0 ,2 ,0 ,0 ,0 ,0,20843 , 0 
39601.236,4,30 ,8 ,512 ,0 ,0 ,1 ,1 ,0 ,0 ,0 ,2 ,0 ,3 ,0 ,3,18565 , 0 
39601.289,7,30 ,9 ,1024 ,0 ,0 ,3 ,1 ,0 ,0 ,0 ,4 ,0 ,7 ,0 ,7,30959 , 0 
39601.337,14,30 ,1 ,256 ,0 ,0 ,2 ,0 ,1 ,0 ,0 ,3 ,0 ,1 ,1 ,2,18709 , 0 
39601.35,15,30 ,9 ,1024 ,0 ,0 ,2 ,1 ,0 ,0 ,0 ,3 ,0 ,5 ,0 ,5,23286 , 0 
39601.36,20,30 ,5 ,768 ,0 ,0 ,2 ,0 ,0 ,0 ,0 ,2 ,0 ,2 ,0 ,2,20131 , 0 
39601.36,16,30 ,2 ,512 ,0 ,0 ,3 ,0 ,0 ,0 ,0 ,3 ,0 ,4 ,0 ,4,43328 , 1 
39601.444,10,30 ,14 ,512 ,0 ,0 ,2 ,1 ,0 ,0 ,0 ,3 ,0 ,3 ,0 ,3,21642 , 0 
39601.482,12,30 ,5 ,768 ,0 ,0 ,1 ,0 ,0 ,0 ,0 ,1 ,0 ,4 ,0 ,4,22110 , 0 
39601.596,9,30 ,5 ,768 ,0 ,0 ,2 ,0 ,3 ,0 ,0 ,5 ,0 ,5 ,3 ,8,38304 , 0 
39601.602,5,30 ,2 ,512 ,0 ,0 ,1 ,0 ,3 ,0 ,0 ,4 ,0 ,6 ,3 ,9,36101 , 0 
39601.606,19,30 ,1 ,256 ,0 ,0 ,1 ,0 ,0 ,0 ,0 ,1 ,0 ,2 ,0 ,2,22457 , 0 
39601.696,17,30 ,6 ,797 ,0 ,0 ,3 ,0 ,0 ,0 ,0 ,3 ,0 ,5 ,0 ,5,28278 , 0 
39601.771,13,30 ,1 ,256 ,0 ,0 ,1 ,0 ,0 ,0 ,0 ,1 ,0 ,2 ,0 ,2,20197 , 0 
39601.787,3,30 ,1 ,256 ,0 ,0 ,1 ,0 ,0 ,0 ,0 ,1 ,0 ,1 ,0 ,1,14202 , 0 
39720.96,8,30 ,1 ,256 ,0 ,0 ,2 ,0 ,0 ,0 ,0 ,2 ,0 ,0 ,0 ,0,16105 , 0 
39721.078,11,30 ,9 ,1024 ,0 ,0 ,1 ,2 ,0 ,0 ,0 ,3 ,0 ,4 ,0 ,4,26376 , 0 
39721.124,2,30 ,1 ,256 ,0 ,0 ,3 ,0 ,8 ,0 ,1 ,12 ,0 ,4 ,9 ,13,28382 , 0 
39721.138,6,30 ,2 ,512 ,0 ,0 ,1 ,0 ,1 ,0 ,0 ,2 ,0 ,3 ,1 ,4,36052 , 0 
39721.214,18,30 ,19 ,525 ,0 ,0 ,1 ,0 ,0 ,0 ,0 ,1 ,0 ,3 ,0 ,3,22118 , 0 
39721.235,4,30 ,8 ,512 ,0 ,0 ,1 ,0 ,0 ,0 ,0 ,1 ,0 ,0 ,0 ,0,19693 , 0 
39721.289,7,30 ,16 ,855 ,0 ,0 ,5 ,2 ,0 ,1 ,0 ,8 ,0 ,3 ,0 ,3,30774 , 0 
39721.337,14,30 ,1 ,256 ,0 ,0 ,1 ,0 ,0 ,0 ,0 ,1 ,0 ,1 ,0 ,1,19405 , 0 
39721.35,15,30 ,9 ,1024 ,0 ,0 ,2 ,1 ,0 ,0 ,0 ,3 ,0 ,5 ,0 ,5,24017 , 0 
39721.36,20,30 ,5 ,768 ,0 ,0 ,1 ,0 ,0 ,0 ,0 ,1 ,0 ,0 ,0 ,0,21215 , 0 
39721.36,16,30 ,2 ,512 ,0 ,0 ,3 ,1 ,1 ,0 ,0 ,5 ,0 ,8 ,1 ,9,40277 , 0 
39721.444,10,30 ,14 ,512 ,0 ,0 ,0 ,0 ,0 ,0 ,0 ,0 ,0 ,0 ,0 ,0,20474 , 0 
39721.482,12,30 ,5 ,768 ,0 ,0 ,1 ,0 ,0 ,0 ,0 ,1 ,0 ,0 ,0 ,0,23261 , 0 
39721.596,9,30 ,5 ,768 ,0 ,0 ,2 ,0 ,4 ,0 ,1 ,7 ,0 ,6 ,5 ,11,36411 , 0 
39721.602,5,30 ,2 ,512 ,0 ,0 ,1 ,1 ,4 ,0 ,1 ,7 ,0 ,5 ,5 ,10,35829 , 0 
39721.606,19,30 ,1 ,256 ,0 ,0 ,1 ,0 ,0 ,0 ,0 ,1 ,0 ,3 ,0 ,3,23087 , 0 
39721.696,17,30 ,6 ,788 ,0 ,0 ,2 ,1 ,0 ,0 ,0 ,3 ,0 ,7 ,0 ,7,27928 , 0 
39721.771,13,30 ,1 ,256 ,0 ,0 ,1 ,0 ,0 ,0 ,0 ,1 ,0 ,1 ,0 ,1,20349 , 0 
39721.787,3,30 ,1 ,256 ,0 ,0 ,0 ,0 ,0 ,0 ,0 ,0 ,0 ,1 ,0 ,1,14678 , 0 
39840.96,8,30 ,1 ,256 ,0 ,0 ,0 ,0 ,0 ,0 ,0 ,0 ,0 ,1 ,0 ,1,16333 , 0 
39841.078,11,30 ,9 ,1024 ,0 ,0 ,1 ,0 ,0 ,0 ,0 ,1 ,0 ,2 ,0 ,2,25925 , 0 
39841.128,2,30 ,1 ,256 ,0 ,0 ,1 ,0 ,2 ,0 ,0 ,3 ,0 ,1 ,3 ,4,29817 , 0 
39841.14,6,30 ,2 ,512 ,0 ,0 ,0 ,0 ,0 ,0 ,0 ,0 ,0 ,2 ,0 ,2,41962 , 0 
39841.214,18,30 ,19 ,525 ,0 ,0 ,1 ,0 ,0 ,0 ,0 ,1 ,0 ,0 ,0 ,0,20913 , 0 
39841.236,4,30 ,8 ,512 ,0 ,0 ,1 ,0 ,0 ,0 ,0 ,1 ,0 ,0 ,0 ,0,18623 , 0 
39841.289,7,30 ,16 ,846 ,0 ,0 ,3 ,0 ,0 ,0 ,0 ,3 ,0 ,1 ,0 ,1,31044 , 0 
39841.337,14,30 ,1 ,256 ,0 ,0 ,1 ,0 ,1 ,0 ,0 ,2 ,0 ,4 ,1 ,5,18783 , 0 
39841.35,15,30 ,9 ,1024 ,0 ,0 ,0 ,1 ,0 ,0 ,0 ,1 ,0 ,4 ,0 ,4,23356 , 0 
39841.36,20,30 ,5 ,804 ,0 ,0 ,2 ,1 ,0 ,0 ,0 ,3 ,0 ,1 ,0 ,1,20228 , 0 
39841.36,16,30 ,2 ,512 ,0 ,0 ,1 ,0 ,0 ,0 ,0 ,1 ,0 ,4 ,0 ,4,43404 , 0 
39841.444,10,30 ,14 ,512 ,0 ,0 ,2 ,1 ,0 ,0 ,0 ,3 ,0 ,1 ,0 ,1,21705 , 0 
39841.482,12,30 ,5 ,768 ,0 ,0 ,2 ,0 ,0 ,0 ,0 ,2 ,0 ,3 ,0 ,3,22181 , 0 
39841.596,9,30 ,5 ,768 ,0 ,0 ,2 ,0 ,1 ,1 ,0 ,4 ,0 ,3 ,1 ,4,38415 , 0 
39841.602,5,30 ,2 ,512 ,0 ,0 ,1 ,0 ,2 ,1 ,0 ,4 ,0 ,1 ,3 ,4,36235 , 0 
39841.606,19,30 ,1 ,256 ,0 ,0 ,1 ,0 ,0 ,0 ,0 ,1 ,0 ,1 ,0 ,1,22534 , 0 
39841.696,17,30 ,6 ,788 ,0 ,0 ,1 ,0 ,0 ,0 ,0 ,1 ,0 ,3 ,0 ,3,28338 , 0 
39841.771,13,30 ,1 ,256 ,0 ,0 ,1 ,0 ,0 ,0 ,0 ,1 ,0 ,2 ,0 ,2,20283 , 0 
39841.787,3,30 ,1 ,256 ,0 ,0 ,3 ,0 ,0 ,0 ,0 ,3 ,0 ,0 ,0 ,0,14263 , 0 
39960.96,8,30 ,1 ,256 ,0 ,0 ,2 ,0 ,0 ,0 ,0 ,2 ,0 ,1 ,0 ,1,16175 , 0 
39961.078,11,30 ,9 ,1024 ,0 ,0 ,1 ,0 ,0 ,0 ,0 ,1 ,0 ,3 ,0 ,3,26444 , 0 
39961.123,2,30 ,1 ,256 ,0 ,0 ,1 ,0 ,2 ,0 ,0 ,3 ,0 ,0 ,2 ,2,28461 , 0 
39961.138,6,30 ,2 ,512 ,0 ,0 ,1 ,0 ,0 ,0 ,0 ,1 ,0 ,1 ,0 ,1,36119 , 0 
39961.214,18,30 ,19 ,525 ,0 ,0 ,1 ,0 ,0 ,0 ,0 ,1 ,0 ,1 ,0 ,1,22179 , 0 
39961.236,4,30 ,8 ,512 ,0 ,0 ,1 ,0 ,0 ,0 ,0 ,1 ,0 ,3 ,0 ,3,19773 , 0 
39961.289,7,30 ,16 ,846 ,0 ,0 ,3 ,1 ,0 ,0 ,0 ,4 ,0 ,5 ,0 ,5,30849 , 0 
39961.337,14,30 ,1 ,256 ,0 ,0 ,1 ,0 ,0 ,0 ,0 ,1 ,0 ,0 ,0 ,0,19478 , 0 
39961.35,15,30 ,9 ,1024 ,0 ,0 ,3 ,0 ,0 ,0 ,0 ,3 ,0 ,2 ,0 ,2,24097 , 0 
39961.36,20,30 ,5 ,804 ,0 ,0 ,1 ,0 ,0 ,0 ,0 ,1 ,0 ,1 ,0 ,1,21281 , 0 
39961.36,16,30 ,2 ,512 ,0 ,0 ,1 ,1 ,1 ,0 ,0 ,3 ,0 ,4 ,1 ,5,40349 , 0 
39961.444,10,30 ,14 ,512 ,0 ,0 ,0 ,0 ,0 ,0 ,0 ,0 ,0 ,1 ,0 ,1,20523 , 0 
39961.482,12,30 ,5 ,768 ,0 ,0 ,0 ,0 ,0 ,0 ,0 ,0 ,0 ,1 ,0 ,1,23314 , 0 
39961.596,9,30 ,5 ,768 ,0 ,0 ,2 ,0 ,0 ,0 ,0 ,2 ,0 ,4 ,0 ,4,36495 , 0 
39961.602,5,30 ,2 ,512 ,0 ,0 ,1 ,0 ,0 ,0 ,0 ,1 ,0 ,3 ,0 ,3,35914 , 0 
39961.606,19,30 ,1 ,256 ,0 ,0 ,2 ,0 ,0 ,0 ,0 ,2 ,0 ,0 ,0 ,0,23174 , 0 
39961.696,17,30 ,6 ,788 ,0 ,0 ,1 ,0 ,0 ,0 ,0 ,1 ,0 ,2 ,0 ,2,27993 , 0 
39961.771,13,30 ,1 ,256 ,0 ,0 ,1 ,0 ,0 ,0 ,0 ,1 ,0 ,1 ,0 ,1,20419 , 0 
39961.787,3,30 ,1 ,256 ,0 ,0 ,1 ,0 ,0 ,0 ,0 ,1 ,0 ,2 ,0 ,2,14739 , 0 
40080.96,8,30 ,1 ,256 ,0 ,0 ,1 ,0 ,0 ,0 ,0 ,1 ,0 ,0 ,0 ,0,16397 , 0 
40081.078,11,30 ,9 ,1024 ,0 ,0 ,1 ,0 ,0 ,0 ,0 ,1 ,0 ,1 ,0 ,1,26004 , 0 
40081.123,2,30 ,1 ,256 ,0 ,0 ,1 ,0 ,0 ,0 ,0 ,1 ,0 ,2 ,0 ,2,29936 , 0 
40081.138,6,30 ,2 ,512 ,0 ,0 ,1 ,0 ,0 ,0 ,0 ,1 ,0 ,2 ,0 ,2,42047 , 0 
40081.214,18,30 ,19 ,525 ,0 ,0 ,0 ,0 ,0 ,0 ,0 ,0 ,0 ,2 ,0 ,2,20972 , 0 
40081.236,4,30 ,8 ,512 ,0 ,0 ,1 ,0 ,0 ,0 ,0 ,1 ,0 ,0 ,0 ,0,18677 , 0 
40081.289,7,30 ,16 ,846 ,0 ,0 ,0 ,0 ,0 ,0 ,0 ,0 ,0 ,1 ,0 ,1,31105 , 1 
40081.337,14,30 ,1 ,256 ,0 ,0 ,1 ,0 ,0 ,0 ,0 ,1 ,0 ,2 ,0 ,2,18851 , 0 
40081.35,15,30 ,9 ,1024 ,0 ,0 ,2 ,0 ,0 ,0 ,0 ,2 ,0 ,1 ,0 ,1,23428 , 0 
40081.36,20,30 ,5 ,804 ,0 ,0 ,1 ,0 ,0 ,0 ,0 ,1 ,0 ,0 ,0 ,0,20284 , 0 
40081.36,16,30 ,2 ,512 ,0 ,0 ,1 ,0 ,0 ,0 ,0 ,1 ,0 ,3 ,0 ,3,43498 , 0 
40081.444,10,30 ,14 ,512 ,0 ,0 ,3 ,0 ,0 ,0 ,0 ,3 ,0 ,0 ,0 ,0,21778 , 0 
40081.482,12,30 ,5 ,768 ,0 ,0 ,1 ,0 ,0 ,0 ,0 ,1 ,0 ,0 ,0 ,0,22250 , 0 
40081.596,9,30 ,5 ,768 ,0 ,0 ,1 ,0 ,0 ,0 ,0 ,1 ,0 ,1 ,0 ,1,38491 , 0 
40081.602,5,30 ,2 ,512 ,0 ,0 ,1 ,0 ,0 ,0 ,0 ,1 ,0 ,1 ,0 ,1,36317 , 0 
40081.606,19,30 ,1 ,256 ,0 ,0 ,0 ,0 ,0 ,0 ,0 ,0 ,0 ,3 ,0 ,3,22622 , 0 
40081.696,17,30 ,6 ,788 ,0 ,0 ,2 ,0 ,0 ,0 ,0 ,2 ,0 ,1 ,0 ,1,28398 , 0 
40081.771,13,30 ,1 ,256 ,0 ,0 ,1 ,0 ,0 ,0 ,0 ,1 ,0 ,0 ,0 ,0,20358 , 0 
40081.787,3,30 ,1 ,256 ,0 ,0 ,1 ,0 ,0 ,0 ,0 ,1 ,0 ,0 ,0 ,0,14313 , 0 
40200.96,8,47 ,0 ,0 ,0 ,0 ,10 ,5 ,7 ,6 ,4 ,32 ,0 ,16 ,12 ,28,16486 , 0 
40201.078,11,54 ,5 ,768 ,0 ,0 ,15 ,8 ,1 ,12 ,1 ,37 ,0 ,28 ,3 ,31,27122 , 0 
40201.124,2,54 ,2 ,0 ,0 ,0 ,12 ,5 ,10 ,8 ,7 ,42 ,0 ,30 ,23 ,53,28868 , 0 
40201.138,6,54 ,2 ,512 ,0 ,0 ,12 ,2 ,0 ,4 ,1 ,19 ,0 ,28 ,4 ,32,36464 , 0 
40201.214,18,54 ,19 ,512 ,0 ,0 ,14 ,7 ,1 ,8 ,1 ,31 ,0 ,18 ,2 ,20,22809 , 0 
40201.236,4,47 ,19 ,512 ,0 ,0 ,10 ,6 ,0 ,7 ,0 ,23 ,0 ,14 ,1 ,15,20164 , 0 
40201.294,7,59 ,16 ,65535 ,0 ,0 ,15 ,0 ,3 ,1 ,1 ,20 ,0 ,18 ,15 ,33,31217 , 1 
40201.337,14,47 ,0 ,0 ,0 ,0 ,8 ,6 ,5 ,8 ,4 ,31 ,0 ,18 ,9 ,27,19820 , 0 
40201.354,15,54 ,9 ,1046 ,0 ,0 ,13 ,3 ,1 ,5 ,2 ,24 ,0 ,21 ,6 ,27,24478 , 0 
40201.36,20,54 ,5 ,768 ,0 ,0 ,14 ,6 ,0 ,8 ,0 ,28 ,0 ,22 ,0 ,22,21827 , 0 
40201.361,16,56 ,2 ,512 ,0 ,0 ,12 ,2 ,3 ,6 ,1 ,24 ,0 ,23 ,7 ,30,40784 , 0 
40201.444,10,47 ,14 ,698 ,0 ,0 ,10 ,6 ,0 ,8 ,0 ,24 ,0 ,11 ,1 ,12,20939 , 0 
40201.482,12,54 ,18 ,1792 ,0 ,0 ,10 ,4 ,0 ,5 ,0 ,19 ,0 ,19 ,6 ,25,23744 , 0 
40201.596,9,54 ,5 ,768 ,0 ,0 ,14 ,3 ,3 ,10 ,4 ,34 ,0 ,28 ,14 ,42,37092 , 0 
40201.603,5,54 ,2 ,512 ,0 ,0 ,15 ,3 ,3 ,8 ,5 ,34 ,0 ,37 ,34 ,71,36620 , 0 
40201.607,19,54 ,19 ,0 ,0 ,0 ,12 ,5 ,6 ,6 ,2 ,31 ,0 ,27 ,19 ,46,23676 , 0 
40201.772,13,54 ,1 ,256 ,0 ,0 ,10 ,5 ,0 ,6 ,0 ,21 ,0 ,19 ,2 ,21,20733 , 0 
40201.787,3,47 ,1 ,256 ,0 ,0 ,8 ,7 ,1 ,7 ,2 ,25 ,0 ,17 ,4 ,21,15047 , 0 
40201.816,17,54 ,6 ,768 ,0 ,0 ,12 ,3 ,0 ,6 ,0 ,21 ,0 ,21 ,1 ,22,28510 , 0 
40320.961,8,91 ,1 ,256 ,0 ,0 ,15 ,11 ,4 ,11 ,2 ,43 ,0 ,46 ,8 ,54,16766 , 0 
40321.078,11,96 ,5 ,1064 ,0 ,0 ,20 ,0 ,0 ,1 ,0 ,21 ,0 ,62 ,0 ,62,26234 , 0 
40321.124,2,91 ,1 ,256 ,0 ,0 ,20 ,8 ,7 ,13 ,2 ,50 ,0 ,70 ,20 ,90,30392 , 0 
40321.139,6,91 ,16 ,1024 ,0 ,0 ,18 ,2 ,3 ,3 ,2 ,28 ,0 ,50 ,7 ,57,42414 , 0 
40321.214,18,91 ,19 ,512 ,0 ,0 ,19 ,3 ,0 ,7 ,0 ,29 ,0 ,38 ,0 ,38,21316 , 0 
40321.236,4,91 ,19 ,512 ,0 ,0 ,17 ,9 ,0 ,11 ,0 ,37 ,0 ,30 ,4 ,34,19200 , 0 
40321.29,7,97 ,16 ,65535 ,0 ,0 ,19 ,0 ,0 ,0 ,0 ,19 ,0 ,45 ,0 ,45,31313 , 1 
40321.338,14,91 ,1 ,256 ,0 ,0 ,17 ,10 ,4 ,9 ,2 ,42 ,0 ,51 ,12 ,63,19173 , 0 
40321.35,15,96 ,9 ,1046 ,0 ,0 ,19 ,0 ,0 ,0 ,0 ,19 ,0 ,53 ,0 ,53,23626 , 0 
40321.36,20,94 ,12 ,1320 ,0 ,0 ,19 ,2 ,0 ,3 ,0 ,24 ,0 ,37 ,0 ,37,20547 , 0 
40321.364,16,96 ,2 ,512 ,0 ,0 ,20 ,1 ,0 ,2 ,0 ,23 ,0 ,57 ,7 ,64,43808 , 0 
40321.454,10,91 ,14 ,512 ,0 ,0 ,18 ,7 ,0 ,9 ,0 ,34 ,0 ,28 ,0 ,28,22217 , 0 
40321.482,12,96 ,5 ,1064 ,0 ,0 ,17 ,2 ,1 ,2 ,0 ,22 ,0 ,41 ,2 ,43,22525 , 0 
40321.596,9,96 ,5 ,1064 ,0 ,0 ,20 ,0 ,0 ,1 ,0 ,21 ,0 ,64 ,0 ,64,38725 , 0 
40321.603,5,94 ,13 ,512 ,0 ,0 ,21 ,2 ,1 ,5 ,0 ,29 ,0 ,82 ,9 ,91,36717 , 0 
40321.607,19,91 ,1 ,256 ,0 ,0 ,19 ,9 ,9 ,10 ,3 ,50 ,0 ,69 ,31 ,100,23109 , 0 
40321.697,17,96 ,16 ,1024 ,0 ,0 ,19 ,2 ,0 ,4 ,0 ,25 ,0 ,46 ,0 ,46,28657 , 0 
40321.772,13,91 ,1 ,256 ,0 ,0 ,18 ,7 ,2 ,8 ,1 ,36 ,0 ,51 ,3 ,54,20781 , 0 
40321.787,3,91 ,1 ,256 ,0 ,0 ,17 ,12 ,1 ,11 ,1 ,42 ,0 ,33 ,2 ,35,14618 , 0 
40440.96,8,99 ,1 ,256 ,0 ,0 ,7 ,4 ,1 ,3 ,1 ,16 ,0 ,15 ,2 ,17,16645 , 0 
40441.078,11,99 ,5 ,855 ,0 ,0 ,7 ,8 ,12 ,1 ,6 ,34 ,0 ,34 ,21 ,55,27517 , 0 
40441.124,2,99 ,1 ,256 ,0 ,0 ,7 ,4 ,15 ,1 ,4 ,31 ,0 ,36 ,23 ,59,29156 , 0 
40441.138,6,99 ,2 ,585 ,0 ,0 ,9 ,3 ,3 ,3 ,2 ,20 ,0 ,30 ,7 ,37,36793 , 0 
40441.214,18,99 ,5 ,855 ,0 ,0 ,14 ,7 ,4 ,5 ,0 ,30 ,0 ,23 ,6 ,29,23257 , 0 
40441.236,4,99 ,19 ,599 ,0 ,0 ,8 ,6 ,0 ,3 ,0 ,17 ,0 ,18 ,0 ,18,20425 , 0 
40441.29,7,99 ,16 ,891 ,0 ,0 ,15 ,6 ,0 ,4 ,0 ,25 ,0 ,26 ,0 ,26,31619 , 0 
40441.338,14,99 ,1 ,256 ,0 ,0 ,7 ,3 ,2 ,1 ,1 ,14 ,0 ,24 ,4 ,28,20013 , 0 
40441.35,15,99 ,9 ,1305 ,0 ,0 ,10 ,4 ,0 ,1 ,0 ,15 ,0 ,23 ,0 ,23,24682 , 0 
40441.36,20,99 ,11 ,1441 ,0 ,0 ,12 ,4 ,5 ,4 ,2 ,27 ,0 ,20 ,7 ,27,22206 , 0 
40441.361,16,99 ,2 ,585 ,0 ,0 ,12 ,4 ,7 ,5 ,1 ,29 ,0 ,30 ,10 ,40,41201 , 0 
40441.444,10,99 ,14 ,698 ,0 ,0 ,9 ,4 ,0 ,2 ,0 ,15 ,0 ,9 ,0 ,9,21185 , 0 
40441.482,12,99 ,18 ,1111 ,0 ,0 ,15 ,10 ,4 ,6 ,2 ,37 ,0 ,25 ,7 ,32,24239 , 0 
40441.596,9,99 ,5 ,855 ,0 ,0 ,9 ,7 ,3 ,1 ,0 ,20 ,0 ,32 ,4 ,36,37504 , 0 
40441.603,5,99 ,19 ,599 ,0 ,0 ,12 ,3 ,32 ,1 ,4 ,52 ,0 ,43 ,39 ,82,37169 , 0 
40441.607,19,99 ,1 ,256 ,0 ,0 ,7 ,5 ,19 ,6 ,1 ,38 ,0 ,36 ,24 ,60,23988 , 0 
40441.697,17,99 ,16 ,891 ,0 ,0 ,11 ,6 ,1 ,2 ,1 ,21 ,0 ,20 ,2 ,22,28805 , 0 
40441.772,13,99 ,1 ,256 ,0 ,0 ,7 ,4 ,22 ,0 ,3 ,36 ,0 ,26 ,25 ,51,21000 , 0 
40441.787,3,99 ,1 ,256 ,0 ,0 ,6 ,6 ,0 ,2 ,0 ,14 ,0 ,14 ,1 ,15,15189 , 0 
40560.96,8,99 ,1 ,256 ,0 ,0 ,2 ,1 ,0 ,0 ,0 ,3 ,0 ,5 ,0 ,5,16844 , 0 
40561.078,11,99 ,5 ,776 ,0 ,0 ,3 ,2 ,4 ,2 ,0 ,11 ,0 ,10 ,6 ,16,26378 , 0 
40561.123,2,99 ,1 ,256 ,0 ,0 ,3 ,2 ,4 ,0 ,0 ,9 ,0 ,9 ,4 ,13,30530 , 0 
40561.138,6,99 ,2 ,548 ,0 ,0 ,2 ,1 ,0 ,0 ,0 ,3 ,0 ,5 ,0 ,5,42497 , 0 
40561.214,18,99 ,5 ,776 ,0 ,0 ,3 ,1 ,2 ,0 ,0 ,6 ,0 ,7 ,3 ,10,21450 , 0 
40561.236,4,99 ,19 ,520 ,0 ,0 ,3 ,1 ,0 ,0 ,0 ,4 ,0 ,5 ,0 ,5,19315 , 0 
40561.289,7,99 ,16 ,891 ,0 ,0 ,2 ,1 ,0 ,0 ,0 ,3 ,0 ,7 ,0 ,7,31405 , 0 
40561.337,14,99 ,1 ,256 ,0 ,0 ,3 ,2 ,1 ,0 ,0 ,6 ,0 ,8 ,1 ,9,19272 , 0 
40561.35,15,99 ,11 ,1113 ,0 ,0 ,6 ,2 ,0 ,1 ,0 ,9 ,0 ,4 ,0 ,4,23757 , 0 
40561.36,20,99 ,11 ,1113 ,0 ,0 ,2 ,3 ,0 ,2 ,0 ,7 ,0 ,7 ,0 ,7,20660 , 0 
40561.36,16,99 ,2 ,548 ,0 ,0 ,1 ,1 ,2 ,0 ,0 ,4 ,0 ,6 ,2 ,8,43946 , 0 
40561.444,10,99 ,14 ,609 ,0 ,0 ,2 ,1 ,0 ,0 ,0 ,3 ,0 ,3 ,0 ,3,22298 , 0 
40561.482,12,99 ,18 ,1136 ,0 ,0 ,2 ,2 ,0 ,1 ,0 ,5 ,0 ,8 ,0 ,8,22655 , 0 
40561.596,9,99 ,5 ,776 ,0 ,0 ,2 ,2 ,1 ,0 ,1 ,6 ,0 ,9 ,2 ,11,38850 , 0 
40561.603,5,99 ,19 ,520 ,0 ,0 ,3 ,1 ,12 ,0 ,1 ,17 ,0 ,11 ,15 ,26,36948 , 0 
40561.607,19,99 ,1 ,256 ,0 ,0 ,2 ,0 ,14 ,0 ,1 ,17 ,0 ,9 ,15 ,24,23249 , 0 
40561.696,17,99 ,16 ,891 ,0 ,0 ,2 ,1 ,0 ,0 ,0 ,3 ,0 ,4 ,0 ,4,28731 , 0 
40561.771,13,99 ,1 ,256 ,0 ,0 ,4 ,1 ,0 ,1 ,0 ,6 ,0 ,5 ,0 ,5,20891 , 0 
40561.786,3,99 ,1 ,256 ,0 ,0 ,2 ,1 ,0 ,0 ,0 ,3 ,0 ,5 ,0 ,5,14695 , 0 
40680.96,8,99 ,1 ,256 ,0 ,0 ,2 ,0 ,0 ,0 ,0 ,2 ,0 ,3 ,0 ,3,16717 , 0 
40681.078,11,99 ,5 ,768 ,0 ,0 ,1 ,1 ,0 ,0 ,0 ,2 ,0 ,7 ,0 ,7,27593 , 0 
40681.123,2,99 ,1 ,256 ,0 ,0 ,2 ,0 ,6 ,0 ,0 ,8 ,0 ,3 ,6 ,9,29248 , 0 
40681.138,6,99 ,2 ,531 ,0 ,0 ,1 ,1 ,0 ,0 ,0 ,2 ,0 ,6 ,0 ,6,36875 , 0 
40681.214,18,99 ,5 ,768 ,0 ,0 ,1 ,1 ,1 ,0 ,0 ,3 ,0 ,3 ,1 ,4,23344 , 0 
40681.236,4,99 ,19 ,512 ,0 ,0 ,1 ,1 ,0 ,0 ,0 ,2 ,0 ,3 ,0 ,3,20496 , 0 
40681.289,7,99 ,16 ,846 ,0 ,0 ,2 ,1 ,0 ,0 ,0 ,3 ,0 ,6 ,0 ,6,31695 , 0 
40681.337,14,99 ,1 ,256 ,0 ,0 ,2 ,0 ,2 ,0 ,0 ,4 ,0 ,3 ,2 ,5,20082 , 0 
40681.35,15,99 ,11 ,1113 ,0 ,0 ,3 ,0 ,0 ,0 ,0 ,3 ,0 ,3 ,0 ,3,24756 , 0 
40681.36,20,99 ,11 ,1113 ,0 ,0 ,2 ,0 ,0 ,0 ,0 ,2 ,0 ,3 ,0 ,3,22289 , 0 
40681.36,16,99 ,2 ,525 ,0 ,0 ,3 ,2 ,3 ,0 ,0 ,8 ,0 ,6 ,3 ,9,41311 , 0 
40681.444,10,99 ,14 ,599 ,0 ,0 ,2 ,2 ,0 ,0 ,0 ,4 ,0 ,1 ,0 ,1,21257 , 0 
40681.482,12,99 ,18 ,1077 ,0 ,0 ,3 ,1 ,0 ,0 ,0 ,4 ,0 ,4 ,0 ,4,24338 , 0 
40681.596,9,99 ,5 ,768 ,0 ,0 ,3 ,1 ,0 ,1 ,0 ,5 ,0 ,5 ,0 ,5,37594 , 0 
40681.603,5,99 ,19 ,512 ,0 ,0 ,1 ,1 ,4 ,0 ,0 ,6 ,0 ,8 ,5 ,13,37307 , 0 
40681.606,19,99 ,1 ,256 ,0 ,0 ,1 ,0 ,6 ,0 ,0 ,7 ,0 ,5 ,6 ,11,24077 , 0 
40681.696,17,99 ,16 ,846 ,0 ,0 ,1 ,2 ,0 ,0 ,0 ,3 ,0 ,4 ,0 ,4,28890 , 0 
40681.771,13,99 ,1 ,256 ,0 ,0 ,0 ,0 ,0 ,0 ,0 ,0 ,0 ,4 ,0 ,4,21071 , 0 
40681.787,3,99 ,1 ,256 ,0 ,0 ,2 ,0 ,0 ,0 ,0 ,2 ,0 ,1 ,0 ,1,15250 , 0 
40800.96,8,99 ,1 ,256 ,0 ,0 ,2 ,1 ,0 ,0 ,0 ,3 ,0 ,6 ,0 ,6,16916 , 0 
40801.078,11,99 ,9 ,300 ,0 ,0 ,5 ,4 ,4 ,1 ,1 ,15 ,0 ,14 ,5 ,19,26593 , 0 
40801.123,2,99 ,1 ,256 ,0 ,0 ,2 ,0 ,5 ,0 ,1 ,8 ,0 ,9 ,6 ,15,30626 , 0 
40801.138,6,99 ,2 ,520 ,0 ,0 ,2 ,1 ,0 ,0 ,0 ,3 ,0 ,4 ,0 ,4,42580 , 0 
40801.214,18,99 ,5 ,768 ,0 ,0 ,6 ,2 ,0 ,2 ,0 ,10 ,0 ,7 ,1 ,8,21627 , 0 
40801.236,4,99 ,19 ,512 ,0 ,0 ,2 ,2 ,0 ,0 ,0 ,4 ,0 ,7 ,1 ,8,19427 , 0 
40801.289,7,99 ,15 ,583 ,0 ,0 ,5 ,3 ,0 ,3 ,0 ,11 ,0 ,10 ,0 ,10,31552 , 0 
40801.337,14,99 ,1 ,256 ,0 ,0 ,2 ,1 ,0 ,0 ,0 ,3 ,0 ,3 ,0 ,3,19354 , 0 
40801.35,15,99 ,11 ,556 ,0 ,0 ,6 ,5 ,0 ,5 ,0 ,16 ,0 ,13 ,10 ,23,24031 , 0 
40801.36,20,99 ,11 ,556 ,0 ,0 ,0 ,3 ,0 ,0 ,0 ,3 ,0 ,5 ,0 ,5,20749 , 0 
40801.361,16,99 ,2 ,520 ,0 ,0 ,1 ,0 ,4 ,0 ,2 ,7 ,0 ,9 ,9 ,18,44167 , 0 
40801.444,10,99 ,14 ,575 ,0 ,0 ,1 ,0 ,0 ,0 ,0 ,1 ,0 ,3 ,0 ,3,22364 , 0 
40801.482,12,99 ,18 ,1072 ,0 ,0 ,3 ,1 ,0 ,2 ,0 ,6 ,0 ,8 ,0 ,8,22829 , 0 
40801.596,9,99 ,5 ,768 ,0 ,0 ,7 ,3 ,7 ,7 ,1 ,25 ,0 ,14 ,20 ,34,39248 , 1 
40801.603,5,99 ,19 ,512 ,0 ,0 ,5 ,4 ,5 ,4 ,1 ,19 ,0 ,13 ,11 ,24,37251 , 0 
40801.607,19,99 ,1 ,256 ,0 ,0 ,5 ,1 ,8 ,0 ,1 ,15 ,0 ,12 ,9 ,21,23423 , 0 
40801.696,17,99 ,16 ,843 ,0 ,0 ,1 ,1 ,0 ,0 ,0 ,2 ,0 ,4 ,0 ,4,28856 , 0 
40801.771,13,99 ,1 ,256 ,0 ,0 ,5 ,0 ,0 ,0 ,0 ,5 ,0 ,9 ,0 ,9,21015 , 0 
40801.787,3,99 ,1 ,256 ,0 ,0 ,1 ,0 ,0 ,0 ,0 ,1 ,0 ,3 ,0 ,3,14755 , 0 
40920.96,8,99 ,1 ,256 ,0 ,0 ,2 ,0 ,0 ,0 ,0 ,2 ,0 ,10 ,0 ,10,16805 , 0 
40921.078,11,99 ,9 ,300 ,0 ,0 ,8 ,12 ,17 ,0 ,0 ,37 ,0 ,43 ,17 ,60,28034 , 0 
40921.124,2,99 ,1 ,256 ,0 ,0 ,5 ,0 ,26 ,1 ,4 ,36 ,0 ,23 ,32 ,55,29441 , 0 
40921.138,6,99 ,2 ,512 ,0 ,0 ,0 ,3 ,0 ,0 ,0 ,3 ,0 ,6 ,0 ,6,36978 , 0 
40921.214,18,99 ,5 ,773 ,0 ,0 ,8 ,13 ,3 ,1 ,0 ,25 ,0 ,28 ,4 ,32,23632 , 0 
40921.236,4,99 ,19 ,523 ,0 ,0 ,4 ,6 ,0 ,0 ,0 ,10 ,0 ,9 ,0 ,9,20666 , 0 
40921.289,7,99 ,15 ,989 ,0 ,0 ,4 ,3 ,0 ,0 ,0 ,7 ,0 ,16 ,0 ,16,31878 , 0 
40921.337,14,99 ,1 ,256 ,0 ,0 ,1 ,0 ,0 ,0 ,0 ,1 ,0 ,11 ,0 ,11,20188 , 0 
40921.35,15,99 ,11 ,613 ,0 ,0 ,6 ,7 ,3 ,0 ,0 ,16 ,0 ,14 ,3 ,17,25032 , 0 
40921.361,16,99 ,2 ,512 ,0 ,0 ,2 ,3 ,18 ,1 ,3 ,27 ,0 ,16 ,33 ,49,41771 , 0 
40921.362,20,99 ,11 ,601 ,0 ,0 ,7 ,6 ,1 ,0 ,0 ,14 ,0 ,28 ,1 ,29,22466 , 0 
40921.444,10,99 ,14 ,575 ,0 ,0 ,2 ,0 ,0 ,0 ,0 ,2 ,0 ,0 ,0 ,0,21380 , 0 
40921.482,12,99 ,20 ,865 ,0 ,0 ,9 ,4 ,0 ,1 ,0 ,14 ,0 ,25 ,0 ,25,24534 , 0 
40921.603,5,99 ,9 ,300 ,0 ,0 ,18 ,13 ,19 ,16 ,1 ,67 ,0 ,43 ,36 ,79,38014 , 0 
40921.607,19,99 ,1 ,256 ,0 ,0 ,9 ,0 ,16 ,0 ,4 ,29 ,0 ,27 ,20 ,47,24336 , 0 
40921.615,9,99 ,5 ,697 ,0 ,0 ,16 ,9 ,26 ,15 ,2 ,68 ,0 ,28 ,59 ,87,38328 , 1 
40921.696,17,99 ,16 ,843 ,0 ,0 ,2 ,0 ,0 ,0 ,0 ,2 ,0 ,1 ,0 ,1,28976 , 0 
40921.771,13,99 ,1 ,256 ,0 ,0 ,8 ,0 ,0 ,0 ,0 ,8 ,0 ,25 ,0 ,25,21240 , 0 
40921.787,3,99 ,1 ,256 ,0 ,0 ,2 ,0 ,0 ,0 ,0 ,2 ,0 ,0 ,0 ,0,15313 , 0 
41040.96,8,99 ,1 ,256 ,0 ,0 ,0 ,0 ,0 ,0 ,0 ,0 ,0 ,4 ,0 ,4,16984 , 0 
41041.078,11,99 ,9 ,300 ,0 ,0 ,1 ,5 ,6 ,0 ,0 ,12 ,0 ,15 ,6 ,21,26774 , 0 
41041.123,2,99 ,1 ,256 ,0 ,0 ,2 ,0 ,3 ,1 ,1 ,7 ,0 ,8 ,5 ,13,30755 , 0 
41041.138,6,99 ,2 ,512 ,0 ,0 ,2 ,1 ,0 ,0 ,0 ,3 ,0 ,2 ,0 ,2,42652 , 0 
41041.214,18,99 ,5 ,780 ,0 ,0 ,2 ,5 ,0 ,0 ,0 ,7 ,0 ,11 ,0 ,11,21743 , 0 
41041.236,4,99 ,19 ,512 ,0 ,0 ,3 ,1 ,0 ,0 ,0 ,4 ,0 ,2 ,0 ,2,19509 , 0 
41041.289,7,99 ,15 ,955 ,0 ,0 ,3 ,1 ,0 ,0 ,0 ,4 ,0 ,6 ,0 ,6,31640 , 0 
41041.337,14,99 ,1 ,256 ,0 ,0 ,1 ,0 ,0 ,0 ,0 ,1 ,0 ,3 ,0 ,3,19415 , 0 
41041.35,15,99 ,11 ,593 ,0 ,0 ,2 ,1 ,1 ,0 ,0 ,4 ,0 ,5 ,1 ,6,24114 , 0 
41041.36,20,99 ,11 ,593 ,0 ,0 ,3 ,2 ,2 ,0 ,0 ,7 ,0 ,7 ,2 ,9,20880 , 0 
41041.36,16,99 ,2 ,512 ,0 ,0 ,1 ,1 ,1 ,1 ,1 ,5 ,0 ,9 ,2 ,11,44273 , 0 
41041.444,10,99 ,14 ,575 ,0 ,0 ,1 ,0 ,0 ,0 ,0 ,1 ,0 ,0 ,0 ,0,22419 , 0 
41041.482,12,99 ,20 ,885 ,0 ,0 ,2 ,2 ,0 ,0 ,0 ,4 ,0 ,8 ,0 ,8,22932 , 0 
41041.596,9,99 ,5 ,780 ,0 ,0 ,7 ,6 ,9 ,1 ,0 ,23 ,0 ,7 ,12 ,19,39503 , 1 
41041.603,5,99 ,19 ,512 ,0 ,0 ,5 ,2 ,13 ,1 ,1 ,22 ,0 ,16 ,21 ,37,37584 , 0 
41041.607,19,99 ,1 ,256 ,0 ,0 ,2 ,0 ,16 ,0 ,1 ,19 ,0 ,10 ,17 ,27,23548 , 0 
41041.696,17,99 ,16 ,859 ,0 ,0 ,1 ,1 ,0 ,0 ,0 ,2 ,0 ,4 ,0 ,4,28939 , 0 
41041.771,13,99 ,1 ,256 ,0 ,0 ,2 ,0 ,0 ,0 ,0 ,2 ,0 ,6 ,0 ,6,21095 , 0 
41041.787,3,99 ,1 ,256 ,0 ,0 ,1 ,0 ,0 ,0 ,0 ,1 ,0 ,1 ,0 ,1,14820 , 0 
41160.96,8,99 ,1 ,256 ,0 ,0 ,2 ,0 ,0 ,0 ,0 ,2 ,0 ,3 ,0 ,3,16875 , 0 
41161.078,11,99 ,5 ,780 ,0 ,0 ,5 ,2 ,7 ,1 ,0 ,15 ,0 ,4 ,9 ,13,28208 , 0 
41161.123,2,99 ,1 ,256 ,0 ,0 ,2 ,0 ,2 ,0 ,0 ,4 ,0 ,3 ,2 ,5,29537 , 0 
41161.138,6,99 ,2 ,512 ,0 ,0 ,1 ,1 ,0 ,0 ,0 ,2 ,0 ,2 ,0 ,2,37039 , 0 
41161.214,18,99 ,5 ,780 ,0 ,0 ,2 ,1 ,0 ,0 ,0 ,3 ,0 ,3 ,0 ,3,23732 , 0 
41161.236,4,99 ,19 ,512 ,0 ,0 ,0 ,1 ,0 ,0 ,0 ,1 ,0 ,3 ,0 ,3,20727 , 0 
41161.289,7,99 ,15 ,918 ,0 ,0 ,1 ,1 ,0 ,0 ,0 ,2 ,0 ,3 ,0 ,3,31961 , 0 
41161.337,14,99 ,1 ,256 ,0 ,0 ,1 ,0 ,1 ,0 ,0 ,2 ,0 ,5 ,1 ,6,20282 , 0 
41161.351,15,99 ,11 ,1064 ,0 ,0 ,1 ,4 ,1 ,0 ,0 ,6 ,0 ,6 ,1 ,7,25136 , 0 
41161.36,20,99 ,11 ,1068 ,0 ,0 ,2 ,2 ,2 ,0 ,0 ,6 ,0 ,4 ,2 ,6,22565 , 0 
41161.36,16,99 ,2 ,512 ,0 ,0 ,1 ,1 ,0 ,0 ,0 ,2 ,0 ,2 ,0 ,2,41862 , 0 
41161.444,10,99 ,14 ,557 ,0 ,0 ,1 ,1 ,0 ,0 ,0 ,2 ,0 ,2 ,0 ,2,21436 , 0 
41161.482,12,99 ,20 ,856 ,0 ,0 ,2 ,2 ,0 ,0 ,0 ,4 ,0 ,7 ,0 ,7,24640 , 0 
41161.596,9,99 ,5 ,780 ,0 ,0 ,2 ,0 ,6 ,0 ,1 ,9 ,0 ,6 ,8 ,14,38488 , 0 
41161.603,5,99 ,19 ,512 ,0 ,0 ,1 ,1 ,9 ,0 ,1 ,12 ,0 ,9 ,10 ,19,38216 , 0 
41161.607,19,99 ,1 ,256 ,0 ,0 ,2 ,0 ,11 ,0 ,1 ,14 ,0 ,6 ,12 ,18,24424 , 0 
41161.696,17,99 ,16 ,859 ,0 ,0 ,1 ,0 ,0 ,0 ,0 ,1 ,0 ,0 ,0 ,0,29035 , 0 
41161.771,13,99 ,1 ,256 ,0 ,0 ,2 ,0 ,0 ,0 ,0 ,2 ,0 ,2 ,0 ,2,21348 , 0 
41161.787,3,99 ,1 ,256 ,0 ,0 ,3 ,0 ,0 ,0 ,0 ,3 ,0 ,1 ,0 ,1,15387 , 0 
41280.96,8,99 ,1 ,256 ,0 ,0 ,1 ,0 ,0 ,0 ,0 ,1 ,0 ,2 ,0 ,2,17048 , 0 
41281.078,11,99 ,5 ,768 ,0 ,0 ,4 ,1 ,6 ,1 ,1 ,13 ,0 ,3 ,8 ,11,26901 , 0 
41281.123,2,99 ,1 ,256 ,0 ,0 ,1 ,0 ,2 ,0 ,0 ,3 ,0 ,3 ,2 ,5,30838 , 0 
41281.138,6,99 ,2 ,512 ,0 ,0 ,1 ,0 ,0 ,0 ,0 ,1 ,0 ,6 ,0 ,6,42736 , 0 
41281.214,18,99 ,5 ,768 ,0 ,0 ,1 ,1 ,0 ,0 ,0 ,2 ,0 ,2 ,0 ,2,21820 , 0 
41281.236,4,99 ,19 ,512 ,0 ,0 ,2 ,0 ,0 ,0 ,0 ,2 ,0 ,1 ,0 ,1,19597 , 0 
41281.289,7,99 ,16 ,851 ,0 ,0 ,5 ,1 ,0 ,1 ,0 ,7 ,0 ,4 ,0 ,4,31738 , 0 
41281.337,14,99 ,1 ,256 ,0 ,0 ,1 ,0 ,0 ,0 ,0 ,1 ,0 ,2 ,0 ,2,19523 , 0 
41281.35,15,99 ,11 ,1030 ,0 ,0 ,2 ,3 ,0 ,1 ,1 ,7 ,0 ,7 ,1 ,8,24257 , 0 
41281.36,20,99 ,11 ,1030 ,0 ,0 ,1 ,3 ,0 ,0 ,0 ,4 ,0 ,5 ,0 ,5,20959 , 0 
41281.36,16,99 ,2 ,512 ,0 ,0 ,2 ,0 ,2 ,0 ,0 ,4 ,0 ,6 ,2 ,8,44362 , 0 
41281.444,10,99 ,14 ,557 ,0 ,0 ,2 ,0 ,0 ,0 ,0 ,2 ,0 ,1 ,0 ,1,22494 , 0 
41281.482,12,99 ,20 ,856 ,0 ,0 ,2 ,0 ,0 ,0 ,0 ,2 ,0 ,4 ,0 ,4,23021 , 0 
41281.596,9,99 ,5 ,780 ,0 ,0 ,0 ,0 ,0 ,1 ,0 ,1 ,0 ,9 ,0 ,9,39592 , 0 
41281.603,5,99 ,19 ,512 ,0 ,0 ,2 ,0 ,8 ,0 ,0 ,10 ,0 ,6 ,11 ,17,37779 , 0 
41281.606,19,99 ,1 ,256 ,0 ,0 ,1 ,0 ,8 ,0 ,0 ,9 ,0 ,2 ,8 ,10,23635 , 0 
41281.696,17,99 ,16 ,851 ,0 ,0 ,2 ,1 ,0 ,0 ,0 ,3 ,0 ,7 ,0 ,7,29023 , 0 
41281.771,13,99 ,1 ,256 ,0 ,0 ,0 ,0 ,0 ,0 ,0 ,0 ,0 ,4 ,0 ,4,21193 , 0 
41281.787,3,99 ,1 ,256 ,0 ,0 ,2 ,0 ,0 ,0 ,0 ,2 ,0 ,1 ,0 ,1,14880 , 0 
41400.96,8,99 ,1 ,256 ,0 ,0 ,1 ,0 ,0 ,0 ,0 ,1 ,0 ,1 ,0 ,1,16938 , 0 
41401.078,11,99 ,5 ,768 ,0 ,0 ,2 ,0 ,1 ,1 ,1 ,5 ,0 ,5 ,3 ,8,28314 , 0 
41401.123,2,99 ,1 ,256 ,0 ,0 ,2 ,0 ,1 ,0 ,0 ,3 ,0 ,5 ,1 ,6,29653 , 0 
41401.138,6,99 ,2 ,512 ,0 ,0 ,1 ,0 ,0 ,0 ,0 ,1 ,0 ,0 ,0 ,0,37103 , 0 
41401.214,18,99 ,5 ,790 ,0 ,0 ,2 ,1 ,2 ,0 ,0 ,5 ,0 ,8 ,2 ,10,23856 , 0 
41401.236,4,99 ,19 ,512 ,0 ,0 ,1 ,1 ,0 ,0 ,0 ,2 ,0 ,3 ,0 ,3,20785 , 0 
41401.289,7,99 ,16 ,821 ,0 ,0 ,1 ,1 ,0 ,0 ,0 ,2 ,0 ,3 ,0 ,3,32084 , 0 
41401.337,14,99 ,1 ,256 ,0 ,0 ,1 ,0 ,0 ,0 ,0 ,1 ,0 ,2 ,0 ,2,20347 , 0 
41401.35,15,99 ,11 ,1027 ,0 ,0 ,1 ,1 ,0 ,0 ,0 ,2 ,0 ,2 ,0 ,2,25213 , 0 
41401.36,20,99 ,11 ,1030 ,0 ,0 ,3 ,0 ,0 ,1 ,1 ,5 ,0 ,5 ,1 ,6,22662 , 0 
41401.36,16,99 ,2 ,512 ,0 ,0 ,1 ,0 ,1 ,0 ,0 ,2 ,0 ,1 ,1 ,2,41960 , 0 
41401.444,10,99 ,14 ,557 ,0 ,0 ,1 ,0 ,0 ,0 ,0 ,1 ,0 ,0 ,0 ,0,21489 , 0 
41401.482,12,99 ,18 ,1042 ,0 ,0 ,5 ,2 ,0 ,1 ,0 ,8 ,0 ,5 ,0 ,5,24783 , 0 
41401.596,9,99 ,5 ,790 ,0 ,0 ,1 ,1 ,0 ,0 ,0 ,2 ,0 ,5 ,0 ,5,38573 , 0 
41401.603,5,99 ,19 ,512 ,0 ,0 ,2 ,1 ,5 ,0 ,0 ,8 ,0 ,10 ,7 ,17,38430 , 0 
41401.606,19,99 ,1 ,256 ,0 ,0 ,2 ,0 ,7 ,0 ,0 ,9 ,0 ,5 ,7 ,12,24551 , 0 
41401.696,17,99 ,16 ,851 ,0 ,0 ,1 ,0 ,0 ,0 ,0 ,1 ,0 ,1 ,0 ,1,29098 , 0 
41401.771,13,99 ,1 ,256 ,0 ,0 ,3 ,0 ,0 ,0 ,0 ,3 ,0 ,2 ,0 ,2,21437 , 0 
41401.786,3,99 ,1 ,256 ,0 ,0 ,0 ,0 ,0 ,0 ,0 ,0 ,0 ,1 ,0 ,1,15437 , 0 
41520.96,8,99 ,1 ,256 ,0 ,0 ,1 ,0 ,0 ,0 ,0 ,1 ,0 ,1 ,0 ,1,17104 , 0 
41521.078,11,99 ,5 ,768 ,0 ,0 ,0 ,0 ,0 ,0 ,0 ,0 ,0 ,2 ,0 ,2,26964 , 0 
41521.124,2,99 ,1 ,256 ,0 ,0 ,26 ,0 ,57 ,0 ,0 ,83 ,113 ,25 ,57 ,195,31204 , 0 
41521.214,18,99 ,5 ,790 ,0 ,0 ,0 ,0 ,0 ,0 ,0 ,0 ,0 ,2 ,0 ,2,21881 , 0 
41521.236,4,99 ,19 ,512 ,0 ,0 ,1 ,0 ,0 ,0 ,0 ,1 ,0 ,0 ,0 ,0,19694 , 0 
41521.272,6,99 ,2 ,512 ,0 ,120 ,1 ,14 ,0 ,0 ,0 ,135 ,0 ,81 ,0 ,81,43610 , 1 
41521.29,7,99 ,16 ,799 ,0 ,0 ,3 ,14 ,0 ,0 ,0 ,17 ,0 ,45 ,0 ,45,31939 , 0 
41521.337,14,99 ,1 ,256 ,0 ,0 ,1 ,0 ,0 ,0 ,0 ,1 ,0 ,36 ,0 ,36,19630 , 0 
41521.35,15,99 ,11 ,1027 ,0 ,0 ,1 ,0 ,0 ,0 ,0 ,1 ,0 ,3 ,0 ,3,24336 , 0 
41521.36,20,99 ,11 ,1030 ,0 ,0 ,1 ,0 ,0 ,0 ,0 ,1 ,0 ,4 ,0 ,4,21032 , 0 
41521.361,16,99 ,2 ,512 ,0 ,0 ,26 ,12 ,31 ,0 ,0 ,69 ,115 ,37 ,31 ,183,45043 , 0 
41521.444,10,99 ,14 ,557 ,0 ,0 ,26 ,0 ,0 ,0 ,0 ,26 ,108 ,0 ,0 ,108,22754 , 0 
41521.482,12,99 ,18 ,1042 ,0 ,0 ,3 ,0 ,0 ,0 ,0 ,3 ,0 ,1 ,0 ,1,23090 , 0 
41521.596,9,99 ,5 ,790 ,0 ,0 ,2 ,0 ,0 ,0 ,0 ,2 ,0 ,24 ,0 ,24,39734 , 0 
41521.603,5,99 ,19 ,512 ,0 ,0 ,1 ,0 ,0 ,0 ,0 ,1 ,0 ,25 ,0 ,25,37900 , 0 
41521.607,19,99 ,1 ,256 ,0 ,0 ,0 ,0 ,0 ,0 ,0 ,0 ,0 ,22 ,0 ,22,23724 , 0 
41521.697,17,99 ,16 ,799 ,0 ,0 ,25 ,17 ,0 ,0 ,0 ,42 ,112 ,26 ,0 ,138,29416 , 0 
41521.771,13,99 ,1 ,256 ,0 ,0 ,1 ,0 ,0 ,0 ,0 ,1 ,0 ,19 ,0 ,19,21292 , 0 
41521.786,3,99 ,1 ,256 ,0 ,0 ,1 ,0 ,0 ,0 ,0 ,1 ,0 ,0 ,0 ,0,14944 , 0 
41640.96,8,99 ,1 ,256 ,0 ,0 ,1 ,0 ,0 ,0 ,0 ,1 ,0 ,1 ,0 ,1,17025 , 0 
41641.078,11,99 ,5 ,768 ,0 ,0 ,3 ,0 ,2 ,0 ,0 ,5 ,0 ,3 ,2 ,5,28411 , 0 
41641.143,6,99 ,2 ,512 ,0 ,120 ,1 ,13 ,0 ,0 ,0 ,134 ,0 ,85 ,0 ,85,37966 , 1 
41641.145,2,99 ,1 ,256 ,0 ,0 ,25 ,0 ,61 ,0 ,0 ,86 ,104 ,24 ,61 ,189,30041 , 0 
41641.214,18,99 ,5 ,790 ,0 ,0 ,1 ,0 ,0 ,0 ,0 ,1 ,0 ,1 ,0 ,1,23916 , 0 
41641.236,4,99 ,19 ,512 ,0 ,0 ,1 ,0 ,0 ,0 ,0 ,1 ,0 ,1 ,0 ,1,20878 , 0 
41641.29,7,99 ,16 ,790 ,0 ,0 ,1 ,17 ,0 ,0 ,0 ,18 ,0 ,47 ,0 ,47,32334 , 0 
41641.338,14,99 ,1 ,256 ,0 ,0 ,1 ,0 ,0 ,0 ,0 ,1 ,0 ,38 ,0 ,38,20442 , 0 
41641.35,15,99 ,11 ,1025 ,0 ,0 ,2 ,1 ,0 ,0 ,0 ,3 ,0 ,1 ,0 ,1,25308 , 0 
41641.36,20,99 ,11 ,1025 ,0 ,0 ,2 ,1 ,0 ,0 ,0 ,3 ,0 ,2 ,0 ,2,22734 , 0 
41641.361,16,99 ,2 ,512 ,0 ,0 ,25 ,13 ,35 ,0 ,0 ,73 ,106 ,38 ,35 ,179,42642 , 0 
41641.444,10,99 ,14 ,557 ,0 ,0 ,25 ,0 ,0 ,0 ,0 ,25 ,107 ,0 ,0 ,107,21758 , 0 
41641.482,12,99 ,18 ,1042 ,0 ,0 ,1 ,0 ,0 ,0 ,0 ,1 ,0 ,2 ,0 ,2,24853 , 0 
41641.596,9,99 ,5 ,790 ,0 ,0 ,1 ,0 ,0 ,0 ,0 ,1 ,0 ,25 ,0 ,25,38687 , 0 
41641.603,5,99 ,19 ,512 ,0 ,0 ,2 ,0 ,2 ,0 ,0 ,4 ,0 ,25 ,2 ,27,38598 , 0 
41641.606,19,99 ,1 ,256 ,0 ,0 ,2 ,0 ,2 ,0 ,0 ,4 ,0 ,23 ,2 ,25,24655 , 0 
41641.697,17,99 ,16 ,790 ,0 ,0 ,26 ,18 ,0 ,0 ,0 ,44 ,111 ,21 ,0 ,132,29514 , 0 
41641.771,13,99 ,1 ,256 ,0 ,0 ,1 ,0 ,0 ,0 ,0 ,1 ,0 ,24 ,0 ,24,21577 , 0 
41641.787,3,99 ,1 ,256 ,0 ,0 ,1 ,0 ,0 ,0 ,0 ,1 ,0 ,0 ,0 ,0,15505 , 0 
41760.96,8,99 ,1 ,256 ,0 ,0 ,1 ,0 ,0 ,0 ,0 ,1 ,0 ,1 ,0 ,1,17166 , 0 
41761.078,11,99 ,5 ,768 ,0 ,0 ,1 ,0 ,1 ,0 ,0 ,2 ,0 ,2 ,1 ,3,27052 , 0 
41761.124,2,99 ,1 ,256 ,0 ,0 ,25 ,0 ,66 ,0 ,0 ,91 ,107 ,22 ,66 ,195,31586 , 0 
41761.214,18,99 ,5 ,790 ,0 ,0 ,2 ,0 ,1 ,0 ,0 ,3 ,0 ,2 ,1 ,3,21981 , 0 
41761.236,4,99 ,19 ,512 ,0 ,0 ,3 ,0 ,0 ,0 ,0 ,3 ,0 ,1 ,0 ,1,19794 , 0 
41761.27,6,99 ,2 ,512 ,0 ,120 ,1 ,15 ,0 ,0 ,0 ,136 ,0 ,82 ,0 ,82,44516 , 1 
41761.29,7,99 ,16 ,768 ,0 ,0 ,2 ,21 ,0 ,0 ,0 ,23 ,0 ,45 ,0 ,45,32253 , 0 
41761.338,14,99 ,1 ,256 ,0 ,0 ,1 ,0 ,0 ,0 ,0 ,1 ,0 ,41 ,0 ,41,19724 , 0 
41761.35,15,99 ,11 ,1024 ,0 ,0 ,1 ,1 ,0 ,0 ,0 ,2 ,0 ,1 ,0 ,1,24442 , 0 
41761.36,20,99 ,11 ,1025 ,0 ,0 ,1 ,0 ,0 ,0 ,0 ,1 ,0 ,1 ,0 ,1,21128 , 0 
41761.361,16,99 ,2 ,512 ,0 ,0 ,25 ,13 ,38 ,0 ,0 ,76 ,101 ,34 ,38 ,173,45745 , 0 
41761.444,10,99 ,14 ,557 ,0 ,0 ,25 ,0 ,0 ,0 ,0 ,25 ,102 ,0 ,0 ,102,23000 , 0 
41761.482,12,99 ,18 ,1068 ,0 ,0 ,2 ,1 ,0 ,0 ,0 ,3 ,0 ,3 ,0 ,3,23217 , 0 
41761.596,9,99 ,5 ,790 ,0 ,0 ,1 ,0 ,0 ,0 ,0 ,1 ,0 ,25 ,0 ,25,39854 , 0 
41761.603,5,99 ,19 ,512 ,0 ,0 ,1 ,0 ,2 ,0 ,0 ,3 ,0 ,25 ,2 ,27,38056 , 0 
41761.607,19,99 ,1 ,256 ,0 ,0 ,1 ,0 ,2 ,0 ,0 ,3 ,0 ,26 ,2 ,28,23864 , 0 
41761.697,17,99 ,16 ,768 ,0 ,0 ,26 ,17 ,0 ,0 ,0 ,43 ,107 ,25 ,0 ,132,29838 , 0 
41761.771,13,99 ,1 ,256 ,0 ,0 ,1 ,0 ,0 ,0 ,0 ,1 ,0 ,22 ,0 ,22,21419 , 0 
41761.786,3,99 ,1 ,256 ,0 ,0 ,0 ,0 ,0 ,0 ,0 ,0 ,0 ,1 ,0 ,1,15020 , 0 
41880.96,8,99 ,1 ,256 ,0 ,0 ,1 ,0 ,0 ,0 ,0 ,1 ,0 ,1 ,0 ,1,17087 , 0 
41881.078,11,99 ,5 ,794 ,0 ,0 ,0 ,1 ,0 ,0 ,0 ,1 ,0 ,2 ,0 ,2,28478 , 0 
41881.124,2,99 ,1 ,256 ,0 ,0 ,5 ,0 ,18 ,0 ,0 ,23 ,1 ,5 ,18 ,24,30162 , 0 
41881.138,6,99 ,2 ,512 ,0 ,0 ,1 ,3 ,0 ,0 ,0 ,4 ,0 ,20 ,0 ,20,38057 , 0 
41881.214,18,99 ,5 ,790 ,0 ,0 ,1 ,0 ,0 ,0 ,0 ,1 ,0 ,0 ,0 ,0,23977 , 0 
41881.236,4,99 ,19 ,512 ,0 ,0 ,0 ,0 ,0 ,0 ,0 ,0 ,0 ,1 ,0 ,1,20952 , 0 
41881.29,7,99 ,16 ,768 ,0 ,0 ,0 ,6 ,0 ,0 ,0 ,6 ,0 ,11 ,0 ,11,32435 , 0 
41881.337,14,99 ,1 ,256 ,0 ,0 ,1 ,0 ,0 ,0 ,0 ,1 ,0 ,7 ,0 ,7,20526 , 0 
41881.35,15,99 ,11 ,1024 ,0 ,0 ,2 ,0 ,0 ,0 ,0 ,2 ,0 ,0 ,0 ,0,25378 , 0 
41881.36,20,99 ,11 ,1025 ,0 ,0 ,2 ,0 ,0 ,0 ,0 ,2 ,0 ,0 ,0 ,0,22810 , 0 
41881.361,16,99 ,2 ,512 ,0 ,0 ,7 ,4 ,11 ,0 ,0 ,22 ,0 ,10 ,11 ,21,42869 , 0 
41881.444,10,99 ,14 ,557 ,0 ,0 ,6 ,0 ,0 ,0 ,0 ,6 ,0 ,1 ,0 ,1,21849 , 0 
41881.482,12,99 ,18 ,1068 ,0 ,0 ,0 ,0 ,0 ,0 ,0 ,0 ,0 ,1 ,0 ,1,24907 , 0 
41881.596,9,99 ,5 ,790 ,0 ,0 ,1 ,0 ,0 ,0 ,0 ,1 ,0 ,7 ,0 ,7,38756 , 0 
41881.602,5,99 ,19 ,512 ,0 ,0 ,1 ,0 ,1 ,0 ,0 ,2 ,0 ,5 ,1 ,6,38680 , 0 
41881.606,19,99 ,1 ,256 ,0 ,0 ,1 ,0 ,1 ,0 ,0 ,2 ,0 ,3 ,1 ,4,24741 , 0 
41881.696,17,99 ,16 ,768 ,0 ,0 ,5 ,5 ,0 ,0 ,0 ,10 ,0 ,5 ,0 ,5,29642 , 0 
41881.771,13,99 ,1 ,256 ,0 ,0 ,1 ,0 ,0 ,0 ,0 ,1 ,0 ,3 ,0 ,3,21638 , 0 
41881.787,3,99 ,1 ,256 ,0 ,0 ,1 ,0 ,0 ,0 ,0 ,1 ,0 ,0 ,0 ,0,15565 , 0 
42000.96,8,99 ,1 ,256 ,0 ,0 ,1 ,0 ,0 ,0 ,0 ,1 ,0 ,2 ,0 ,2,17234 , 0 
42001.078,11,99 ,5 ,794 ,0 ,0 ,2 ,0 ,2 ,0 ,0 ,4 ,0 ,0 ,2 ,2,27145 , 0 
42001.123,2,99 ,1 ,256 ,0 ,0 ,2 ,0 ,6 ,0 ,0 ,8 ,0 ,3 ,6 ,9,31698 , 0 
42001.138,6,99 ,2 ,512 ,0 ,0 ,1 ,2 ,0 ,0 ,0 ,3 ,0 ,4 ,0 ,4,44596 , 0 
42001.214,18,99 ,5 ,790 ,0 ,0 ,2 ,0 ,1 ,0 ,0 ,3 ,0 ,0 ,1 ,1,22060 , 0 
42001.236,4,99 ,19 ,512 ,0 ,0 ,1 ,0 ,0 ,0 ,0 ,1 ,0 ,1 ,0 ,1,19866 , 0 
42001.289,7,99 ,16 ,768 ,0 ,0 ,1 ,1 ,0 ,0 ,0 ,2 ,0 ,2 ,0 ,2,32314 , 0 
42001.337,14,99 ,1 ,256 ,0 ,0 ,1 ,0 ,0 ,0 ,0 ,1 ,0 ,2 ,0 ,2,19800 , 0 
42001.35,15,99 ,11 ,1050 ,0 ,0 ,0 ,1 ,0 ,0 ,0 ,1 ,0 ,2 ,0 ,2,24518 , 0 
42001.36,20,99 ,11 ,1050 ,0 ,0 ,1 ,1 ,0 ,0 ,0 ,2 ,0 ,1 ,0 ,1,21203 , 0 
42001.36,16,99 ,2 ,512 ,0 ,0 ,1 ,2 ,2 ,0 ,0 ,5 ,0 ,1 ,2 ,3,45846 , 0 
42001.444,10,99 ,14 ,557 ,0 ,0 ,3 ,0 ,0 ,0 ,0 ,3 ,0 ,0 ,0 ,0,23075 , 0 
42001.482,12,99 ,18 ,1091 ,0 ,0 ,1 ,1 ,0 ,0 ,0 ,2 ,0 ,3 ,0 ,3,23292 , 0 
42001.596,9,99 ,5 ,790 ,0 ,0 ,1 ,0 ,0 ,0 ,0 ,1 ,0 ,4 ,0 ,4,39945 , 0 
42001.602,5,99 ,19 ,512 ,0 ,0 ,1 ,0 ,3 ,0 ,0 ,4 ,0 ,3 ,3 ,6,38201 , 0 
42001.606,19,99 ,1 ,256 ,0 ,0 ,2 ,0 ,3 ,0 ,0 ,5 ,0 ,2 ,3 ,5,23972 , 0 
42001.696,17,99 ,16 ,768 ,0 ,0 ,2 ,1 ,0 ,0 ,0 ,3 ,0 ,2 ,0 ,2,29904 , 0 
42001.771,13,99 ,1 ,256 ,0 ,0 ,0 ,0 ,0 ,0 ,0 ,0 ,0 ,5 ,0 ,5,21510 , 0 
42001.787,3,99 ,1 ,256 ,0 ,0 ,1 ,0 ,0 ,0 ,0 ,1 ,0 ,0 ,0 ,0,15087 , 0 
42120.96,8,99 ,1 ,256 ,0 ,0 ,1 ,0 ,0 ,0 ,0 ,1 ,0 ,1 ,0 ,1,17148 , 0 
42121.078,11,99 ,5 ,794 ,0 ,0 ,2 ,0 ,1 ,0 ,0 ,3 ,0 ,1 ,1 ,2,28551 , 0 
42121.123,2,99 ,1 ,256 ,0 ,0 ,2 ,0 ,1 ,0 ,0 ,3 ,0 ,2 ,1 ,3,30237 , 0 
42121.138,6,99 ,2 ,512 ,0 ,0 ,1 ,0 ,0 ,0 ,0 ,1 ,0 ,1 ,0 ,1,38131 , 0 
42121.214,18,99 ,5 ,780 ,0 ,0 ,1 ,1 ,0 ,0 ,0 ,2 ,0 ,2 ,0 ,2,24077 , 0 
42121.236,4,99 ,19 ,512 ,0 ,0 ,1 ,0 ,0 ,0 ,0 ,1 ,0 ,1 ,0 ,1,21011 , 0 
42121.289,7,99 ,16 ,768 ,0 ,0 ,1 ,0 ,0 ,0 ,0 ,1 ,0 ,3 ,0 ,3,32510 , 0 
42121.337,14,99 ,1 ,256 ,0 ,0 ,1 ,0 ,0 ,0 ,0 ,1 ,0 ,1 ,0 ,1,20603 , 0 
42121.35,15,99 ,11 ,1050 ,0 ,0 ,1 ,1 ,0 ,0 ,0 ,2 ,0 ,2 ,0 ,2,25438 , 0 
42121.36,20,99 ,11 ,1050 ,0 ,0 ,2 ,0 ,0 ,0 ,0 ,2 ,0 ,1 ,0 ,1,22866 , 0 
42121.36,16,99 ,2 ,512 ,0 ,0 ,1 ,0 ,1 ,0 ,0 ,2 ,0 ,2 ,1 ,3,42959 , 0 
42121.444,10,99 ,14 ,557 ,0 ,0 ,0 ,0 ,0 ,0 ,0 ,0 ,0 ,0 ,0 ,0,21901 , 0 
42121.482,12,99 ,18 ,1091 ,0 ,0 ,2 ,0 ,0 ,0 ,0 ,2 ,0 ,2 ,0 ,2,24985 , 0 
42121.596,9,99 ,5 ,790 ,0 ,0 ,1 ,0 ,0 ,0 ,0 ,1 ,0 ,0 ,0 ,0,38853 , 0 
42121.602,5,99 ,19 ,512 ,0 ,0 ,2 ,0 ,2 ,0 ,0 ,4 ,0 ,2 ,2 ,4,38783 , 0 
42121.606,19,99 ,1 ,256 ,0 ,0 ,0 ,0 ,2 ,0 ,0 ,2 ,0 ,2 ,2 ,4,24800 , 0 
42121.696,17,99 ,16 ,768 ,0 ,0 ,1 ,1 ,0 ,0 ,0 ,2 ,0 ,1 ,0 ,1,29718 , 0 
42121.771,13,99 ,1 ,256 ,0 ,0 ,2 ,0 ,0 ,0 ,0 ,2 ,0 ,0 ,0 ,0,21706 , 0 
42121.787,3,99 ,1 ,256 ,0 ,0 ,2 ,0 ,0 ,0 ,0 ,2 ,0 ,1 ,0 ,1,15630 , 0 
42240.96,8,99 ,1 ,256 ,0 ,0 ,2 ,0 ,0 ,0 ,0 ,2 ,0 ,3 ,0 ,3,17302 , 0 
42241.098,11,99 ,5 ,794 ,0 ,0 ,1 ,0 ,1 ,0 ,1 ,3 ,0 ,5 ,2 ,7,27247 , 0 
42241.124,2,99 ,1 ,256 ,0 ,0 ,8 ,0 ,24 ,0 ,2 ,34 ,0 ,11 ,28 ,39,31843 , 0 
42241.138,6,99 ,2 ,512 ,0 ,0 ,9 ,8 ,11 ,0 ,0 ,28 ,0 ,22 ,11 ,33,44840 , 0 
42241.214,18,99 ,5 ,780 ,0 ,0 ,1 ,0 ,0 ,0 ,0 ,1 ,0 ,1 ,0 ,1,22119 , 0 
42241.236,4,99 ,19 ,512 ,0 ,0 ,1 ,0 ,0 ,0 ,0 ,1 ,0 ,1 ,0 ,1,19937 , 0 
42241.29,7,99 ,17 ,1040 ,0 ,0 ,9 ,7 ,0 ,2 ,0 ,18 ,0 ,21 ,0 ,21,32511 , 0 
42241.337,14,99 ,1 ,256 ,0 ,0 ,1 ,0 ,0 ,0 ,0 ,1 ,0 ,8 ,0 ,8,19863 , 0 
42241.35,15,99 ,11 ,1050 ,0 ,0 ,1 ,0 ,1 ,0 ,1 ,3 ,0 ,14 ,2 ,16,24626 , 0 
42241.36,20,99 ,11 ,1050 ,0 ,0 ,0 ,0 ,0 ,0 ,0 ,0 ,0 ,1 ,0 ,1,21280 , 0 
42241.361,16,99 ,2 ,512 ,0 ,0 ,7 ,5 ,0 ,2 ,2 ,16 ,0 ,29 ,2 ,31,46040 , 1 
42241.444,10,99 ,14 ,557 ,0 ,0 ,1 ,0 ,0 ,0 ,0 ,1 ,0 ,7 ,0 ,7,23139 , 0 
42241.482,12,99 ,18 ,1091 ,0 ,0 ,3 ,0 ,0 ,0 ,0 ,3 ,0 ,0 ,0 ,0,23381 , 0 
42241.596,9,99 ,5 ,790 ,0 ,0 ,9 ,0 ,0 ,0 ,0 ,9 ,0 ,13 ,0 ,13,40094 , 0 
42241.603,5,99 ,19 ,512 ,0 ,0 ,1 ,0 ,1 ,0 ,1 ,3 ,0 ,13 ,2 ,15,38332 , 0 
42241.606,19,99 ,1 ,256 ,0 ,0 ,1 ,0 ,1 ,0 ,1 ,3 ,0 ,7 ,2 ,9,24073 , 0 
42241.697,17,99 ,6 ,768 ,0 ,0 ,9 ,5 ,6 ,1 ,0 ,21 ,0 ,16 ,6 ,22,30100 , 0 
42241.771,13,99 ,1 ,256 ,0 ,0 ,1 ,0 ,0 ,0 ,0 ,1 ,0 ,8 ,0 ,8,21577 , 0 
42241.787,3,99 ,1 ,256 ,0 ,0 ,1 ,0 ,0 ,0 ,0 ,1 ,0 ,1 ,0 ,1,15146 , 0 
42360.96,8,99 ,1 ,256 ,0 ,0 ,1 ,0 ,0 ,0 ,0 ,1 ,0 ,0 ,0 ,0,17215 , 0 
42361.078,11,99 ,5 ,794 ,0 ,0 ,0 ,0 ,0 ,1 ,0 ,1 ,0 ,7 ,1 ,8,28633 , 0 
42361.124,2,99 ,1 ,256 ,0 ,0 ,8 ,0 ,23 ,0 ,0 ,31 ,0 ,7 ,23 ,30,30430 , 0 
42361.138,6,99 ,2 ,512 ,0 ,0 ,8 ,6 ,12 ,0 ,0 ,26 ,0 ,14 ,12 ,26,38365 , 0 
42361.214,18,99 ,5 ,780 ,0 ,0 ,1 ,0 ,0 ,0 ,0 ,1 ,0 ,2 ,0 ,2,24148 , 0 
42361.236,4,99 ,19 ,512 ,0 ,0 ,2 ,0 ,0 ,0 ,0 ,2 ,0 ,1 ,0 ,1,21099 , 0 
42361.29,7,99 ,17 ,1078 ,0 ,0 ,6 ,5 ,0 ,0 ,0 ,11 ,0 ,12 ,0 ,12,32637 , 0 
42361.337,14,99 ,1 ,256 ,0 ,0 ,1 ,0 ,0 ,0 ,0 ,1 ,0 ,8 ,0 ,8,20673 , 0 
42361.35,15,99 ,11 ,1050 ,0 ,0 ,1 ,0 ,0 ,1 ,0 ,2 ,0 ,10 ,0 ,10,25512 , 0 
42361.36,20,99 ,11 ,1050 ,0 ,0 ,1 ,0 ,0 ,0 ,0 ,1 ,0 ,0 ,0 ,0,22936 , 0 
42361.36,16,99 ,2 ,512 ,0 ,0 ,2 ,5 ,0 ,0 ,0 ,7 ,0 ,26 ,0 ,26,43084 , 1 
42361.444,10,99 ,14 ,557 ,0 ,0 ,2 ,0 ,0 ,0 ,0 ,2 ,0 ,7 ,0 ,7,21971 , 0 
42361.482,12,99 ,18 ,1091 ,0 ,0 ,0 ,0 ,0 ,0 ,0 ,0 ,0 ,1 ,0 ,1,25040 , 0 
42361.596,9,99 ,5 ,790 ,0 ,0 ,6 ,0 ,0 ,0 ,0 ,6 ,0 ,8 ,0 ,8,38974 , 0 
42361.603,5,99 ,19 ,512 ,0 ,0 ,1 ,0 ,0 ,1 ,0 ,2 ,0 ,12 ,1 ,13,38891 , 0 
42361.606,19,99 ,1 ,256 ,0 ,0 ,1 ,0 ,0 ,1 ,0 ,2 ,0 ,8 ,1 ,9,24912 , 0 
42361.697,17,99 ,6 ,779 ,0 ,0 ,7 ,7 ,5 ,0 ,0 ,19 ,0 ,14 ,5 ,19,29901 , 0 
42361.771,13,99 ,1 ,256 ,0 ,0 ,0 ,0 ,0 ,0 ,0 ,0 ,0 ,8 ,0 ,8,21792 , 0 
42361.787,3,99 ,1 ,256 ,0 ,0 ,0 ,0 ,0 ,0 ,0 ,0 ,0 ,0 ,0 ,0,15679 , 0 
42480.96,8,99 ,1 ,256 ,0 ,0 ,2 ,0 ,0 ,0 ,0 ,2 ,0 ,0 ,0 ,0,17367 , 0 
42481.078,11,99 ,5 ,794 ,0 ,0 ,1 ,0 ,0 ,0 ,0 ,1 ,0 ,6 ,0 ,6,27307 , 0 
42481.124,2,99 ,1 ,256 ,0 ,0 ,6 ,0 ,21 ,0 ,0 ,27 ,0 ,8 ,21 ,29,31974 , 0 
42481.138,6,99 ,2 ,512 ,0 ,0 ,6 ,4 ,12 ,0 ,0 ,22 ,0 ,11 ,12 ,23,45044 , 0 
42481.214,18,99 ,5 ,780 ,0 ,0 ,1 ,0 ,0 ,0 ,0 ,1 ,0 ,0 ,0 ,0,22197 , 0 
42481.236,4,99 ,19 ,512 ,0 ,0 ,0 ,1 ,0 ,0 ,0 ,1 ,0 ,2 ,0 ,2,19989 , 0 
42481.29,7,99 ,17 ,1034 ,0 ,0 ,6 ,7 ,0 ,0 ,0 ,13 ,0 ,14 ,0 ,14,32662 , 0 
42481.337,14,99 ,1 ,256 ,0 ,0 ,1 ,0 ,0 ,0 ,0 ,1 ,0 ,9 ,0 ,9,19959 , 0 
42481.35,15,99 ,11 ,1050 ,0 ,0 ,1 ,0 ,0 ,0 ,0 ,1 ,0 ,10 ,0 ,10,24686 , 0 
42481.36,20,99 ,11 ,1050 ,0 ,0 ,1 ,0 ,0 ,0 ,0 ,1 ,0 ,0 ,0 ,0,21333 , 0 
42481.36,16,99 ,2 ,512 ,0 ,0 ,1 ,5 ,0 ,0 ,0 ,6 ,0 ,27 ,0 ,27,46167 , 1 
42481.444,10,99 ,14 ,527 ,0 ,0 ,1 ,0 ,0 ,0 ,0 ,1 ,0 ,7 ,0 ,7,23216 , 0 
42481.482,12,99 ,18 ,1091 ,0 ,0 ,1 ,0 ,0 ,0 ,0 ,1 ,0 ,2 ,0 ,2,23453 , 0 
42481.596,9,99 ,5 ,790 ,0 ,0 ,6 ,0 ,0 ,0 ,0 ,6 ,0 ,6 ,0 ,6,40207 , 0 
42481.603,5,99 ,19 ,512 ,0 ,0 ,1 ,0 ,0 ,0 ,0 ,1 ,0 ,11 ,0 ,11,38442 , 0 
42481.606,19,99 ,1 ,256 ,0 ,0 ,2 ,0 ,1 ,0 ,0 ,3 ,0 ,5 ,1 ,6,24152 , 0 
42481.697,17,99 ,6 ,768 ,0 ,0 ,7 ,5 ,7 ,0 ,0 ,19 ,0 ,10 ,7 ,17,30273 , 0 
42481.771,13,99 ,1 ,256 ,0 ,0 ,2 ,0 ,0 ,0 ,0 ,2 ,0 ,5 ,0 ,5,21669 , 0 
42481.787,3,99 ,1 ,256 ,0 ,0 ,2 ,0 ,0 ,0 ,0 ,2 ,0 ,1 ,0 ,1,15230 , 0 
42600.96,8,99 ,1 ,256 ,0 ,0 ,0 ,0 ,0 ,0 ,0 ,0 ,0 ,2 ,0 ,2,17274 , 0 
42601.078,11,99 ,5 ,794 ,0 ,0 ,1 ,0 ,1 ,0 ,0 ,2 ,0 ,2 ,1 ,3,28709 , 0 
42601.123,2,99 ,1 ,256 ,0 ,0 ,2 ,0 ,4 ,0 ,0 ,6 ,0 ,2 ,4 ,6,30516 , 0 
42601.138,6,99 ,2 ,512 ,0 ,0 ,3 ,1 ,2 ,0 ,0 ,6 ,0 ,4 ,2 ,6,38474 , 0 
42601.214,18,99 ,5 ,780 ,0 ,0 ,1 ,0 ,0 ,0 ,0 ,1 ,0 ,1 ,0 ,1,24206 , 0 
42601.236,4,99 ,19 ,512 ,0 ,0 ,1 ,0 ,0 ,0 ,0 ,1 ,0 ,0 ,0 ,0,21164 , 0 
42601.289,7,99 ,17 ,1032 ,0 ,0 ,1 ,1 ,0 ,0 ,0 ,2 ,0 ,2 ,0 ,2,32705 , 0 
42601.337,14,99 ,1 ,256 ,0 ,0 ,1 ,0 ,0 ,0 ,0 ,1 ,0 ,1 ,0 ,1,20732 , 0 
42601.35,15,99 ,11 ,1050 ,0 ,0 ,1 ,0 ,0 ,0 ,0 ,1 ,0 ,3 ,0 ,3,25585 , 0 
42601.36,20,99 ,11 ,1077 ,0 ,0 ,1 ,1 ,0 ,0 ,0 ,2 ,0 ,3 ,0 ,3,23029 , 0 
42601.36,16,99 ,2 ,512 ,0 ,0 ,1 ,1 ,0 ,0 ,0 ,2 ,0 ,9 ,0 ,9,43180 , 0 
42601.444,10,99 ,14 ,527 ,0 ,0 ,1 ,0 ,0 ,0 ,0 ,1 ,0 ,2 ,0 ,2,22030 , 0 
42601.482,12,99 ,18 ,1091 ,0 ,0 ,2 ,0 ,0 ,0 ,0 ,2 ,0 ,0 ,0 ,0,25128 , 0 
42601.596,9,99 ,5 ,790 ,0 ,0 ,3 ,0 ,0 ,0 ,0 ,3 ,0 ,2 ,0 ,2,39050 , 0 
42601.602,5,99 ,19 ,512 ,0 ,0 ,1 ,0 ,1 ,0 ,0 ,2 ,0 ,4 ,1 ,5,38998 , 0 
42601.606,19,99 ,1 ,256 ,0 ,0 ,1 ,0 ,1 ,0 ,0 ,2 ,0 ,2 ,1 ,3,25002 , 0 
42601.696,17,99 ,6 ,768 ,0 ,0 ,2 ,1 ,1 ,0 ,0 ,4 ,0 ,3 ,1 ,4,29979 , 0 
42601.771,13,99 ,1 ,256 ,0 ,0 ,1 ,0 ,0 ,0 ,0 ,1 ,0 ,2 ,0 ,2,21849 , 0 
42601.786,3,99 ,1 ,256 ,0 ,0 ,1 ,0 ,0 ,0 ,0 ,1 ,0 ,0 ,0 ,0,15730 , 0 
42720.96,8,99 ,1 ,256 ,0 ,0 ,2 ,0 ,0 ,0 ,0 ,2 ,0 ,1 ,0 ,1,17431 , 0 
42721.078,11,99 ,5 ,794 ,0 ,0 ,1 ,0 ,0 ,0 ,0 ,1 ,0 ,2 ,0 ,2,27377 , 0 
42721.123,2,99 ,1 ,256 ,0 ,0 ,2 ,0 ,6 ,0 ,0 ,8 ,0 ,0 ,6 ,6,32075 , 0 
42721.138,6,99 ,2 ,512 ,0 ,0 ,2 ,1 ,4 ,0 ,0 ,7 ,0 ,2 ,4 ,6,45145 , 0 
42721.214,18,99 ,5 ,780 ,0 ,0 ,1 ,0 ,0 ,0 ,0 ,1 ,0 ,2 ,0 ,2,22293 , 0 
42721.236,4,99 ,19 ,512 ,0 ,0 ,2 ,0 ,0 ,0 ,0 ,2 ,0 ,1 ,0 ,1,20067 , 0 
42721.289,7,99 ,17 ,1027 ,0 ,0 ,3 ,2 ,0 ,0 ,0 ,5 ,0 ,4 ,0 ,4,32750 , 0 
42721.337,14,99 ,1 ,256 ,0 ,0 ,1 ,0 ,0 ,0 ,0 ,1 ,0 ,3 ,0 ,3,20029 , 0 
42721.35,15,99 ,11 ,1050 ,0 ,0 ,1 ,0 ,0 ,0 ,0 ,1 ,0 ,2 ,0 ,2,24754 , 0 
42721.36,20,99 ,11 ,1077 ,0 ,0 ,2 ,0 ,0 ,0 ,0 ,2 ,0 ,0 ,0 ,0,21409 , 0 
42721.36,16,99 ,2 ,512 ,0 ,0 ,1 ,1 ,0 ,0 ,0 ,2 ,0 ,5 ,0 ,5,46252 , 0 
42721.444,10,99 ,14 ,527 ,0 ,0 ,0 ,0 ,0 ,0 ,0 ,0 ,0 ,1 ,0 ,1,23267 , 0 
42721.482,12,99 ,18 ,1091 ,0 ,0 ,0 ,0 ,0 ,0 ,0 ,0 ,0 ,3 ,0 ,3,23516 , 0 
42721.596,9,99 ,5 ,790 ,0 ,0 ,2 ,0 ,0 ,0 ,0 ,2 ,0 ,3 ,0 ,3,40292 , 0 
42721.602,5,99 ,19 ,512 ,0 ,0 ,2 ,0 ,0 ,0 ,0 ,2 ,0 ,3 ,0 ,3,38541 , 0 
42721.606,19,99 ,1 ,256 ,0 ,0 ,1 ,0 ,0 ,0 ,0 ,1 ,0 ,3 ,0 ,3,24242 , 0 
42721.696,17,99 ,6 ,768 ,0 ,0 ,2 ,2 ,2 ,0 ,0 ,6 ,0 ,3 ,2 ,5,30360 , 0 
42721.771,13,99 ,1 ,256 ,0 ,0 ,1 ,0 ,0 ,0 ,0 ,1 ,0 ,3 ,0 ,3,21746 , 0 
42721.787,3,99 ,1 ,256 ,0 ,0 ,1 ,0 ,0 ,0 ,0 ,1 ,0 ,1 ,0 ,1,15282 , 0 
42840.96,8,99 ,1 ,256 ,0 ,0 ,1 ,0 ,0 ,0 ,0 ,1 ,0 ,2 ,0 ,2,17340 , 0 
42841.078,11,99 ,5 ,794 ,0 ,0 ,2 ,0 ,0 ,0 ,0 ,2 ,0 ,2 ,0 ,2,28778 , 0 
42841.123,2,99 ,1 ,256 ,0 ,0 ,2 ,0 ,3 ,0 ,0 ,5 ,0 ,1 ,3 ,4,30593 , 0 
42841.138,6,99 ,2 ,512 ,0 ,0 ,1 ,1 ,1 ,0 ,0 ,3 ,0 ,2 ,1 ,3,38555 , 0 
42841.214,18,99 ,5 ,780 ,0 ,0 ,1 ,0 ,0 ,0 ,0 ,1 ,0 ,0 ,0 ,0,24270 , 0 
42841.236,4,99 ,19 ,512 ,0 ,0 ,1 ,0 ,0 ,0 ,0 ,1 ,0 ,1 ,0 ,1,21239 , 0 
42841.289,7,99 ,17 ,1027 ,0 ,0 ,1 ,0 ,0 ,0 ,0 ,1 ,0 ,1 ,0 ,1,32783 , 0 
42841.337,14,99 ,1 ,256 ,0 ,0 ,1 ,0 ,0 ,0 ,0 ,1 ,0 ,3 ,0 ,3,20819 , 0 
42841.35,15,99 ,11 ,1050 ,0 ,0 ,1 ,0 ,0 ,0 ,0 ,1 ,0 ,1 ,0 ,1,25657 , 0 
42841.36,20,99 ,11 ,1077 ,0 ,0 ,1 ,0 ,0 ,0 ,0 ,1 ,0 ,2 ,0 ,2,23096 , 0 
42841.36,16,99 ,2 ,512 ,0 ,0 ,0 ,1 ,0 ,0 ,0 ,1 ,0 ,5 ,0 ,5,43244 , 0 
42841.444,10,99 ,14 ,527 ,0 ,0 ,2 ,0 ,0 ,0 ,0 ,2 ,0 ,1 ,0 ,1,22097 , 0 
42841.482,12,99 ,18 ,1091 ,0 ,0 ,2 ,0 ,0 ,0 ,0 ,2 ,0 ,1 ,0 ,1,25213 , 0 
42841.597,9,99 ,5 ,790 ,0 ,0 ,2 ,0 ,0 ,0 ,0 ,2 ,0 ,2 ,0 ,2,39129 , 0 
42841.602,5,99 ,19 ,512 ,0 ,0 ,1 ,0 ,0 ,0 ,0 ,1 ,0 ,5 ,0 ,5,39088 , 0 
42841.609,19,99 ,1 ,256 ,0 ,0 ,0 ,0 ,0 ,0 ,0 ,0 ,0 ,4 ,0 ,4,25088 , 0 
42841.696,17,99 ,6 ,768 ,0 ,0 ,1 ,1 ,0 ,0 ,0 ,2 ,0 ,1 ,0 ,1,30068 , 0 
42841.771,13,99 ,1 ,256 ,0 ,0 ,1 ,0 ,0 ,0 ,0 ,1 ,0 ,1 ,0 ,1,21941 , 0 
42841.787,3,99 ,1 ,256 ,0 ,0 ,1 ,0 ,0 ,0 ,0 ,1 ,0 ,1 ,0 ,1,15806 , 0 
42960.96,8,99 ,1 ,256 ,0 ,0 ,0 ,0 ,0 ,0 ,0 ,0 ,0 ,2 ,0 ,2,17484 , 0 
42961.078,11,99 ,5 ,794 ,0 ,0 ,0 ,0 ,0 ,0 ,0 ,0 ,0 ,2 ,0 ,2,27440 , 0 
42961.123,2,99 ,1 ,256 ,0 ,0 ,0 ,0 ,2 ,0 ,0 ,2 ,0 ,2 ,2 ,4,32175 , 0 
42961.138,6,99 ,2 ,512 ,0 ,0 ,1 ,0 ,2 ,0 ,0 ,3 ,0 ,2 ,2 ,4,45232 , 0 
42961.214,18,99 ,5 ,780 ,0 ,0 ,1 ,0 ,1 ,0 ,0 ,2 ,0 ,3 ,1 ,4,22361 , 0 
42961.236,4,99 ,19 ,512 ,0 ,0 ,1 ,0 ,0 ,0 ,0 ,1 ,0 ,0 ,0 ,0,20125 , 0 
42961.289,7,99 ,17 ,1024 ,0 ,0 ,2 ,2 ,0 ,0 ,0 ,4 ,0 ,3 ,0 ,3,32840 , 0 
42961.337,14,99 ,1 ,256 ,0 ,0 ,1 ,0 ,0 ,0 ,0 ,1 ,0 ,1 ,0 ,1,20092 , 0 
42961.35,15,99 ,11 ,1050 ,0 ,0 ,1 ,0 ,0 ,0 ,0 ,1 ,0 ,2 ,0 ,2,24819 , 0 
42961.36,20,99 ,11 ,1077 ,0 ,0 ,0 ,0 ,0 ,0 ,0 ,0 ,0 ,1 ,0 ,1,21460 , 0 
42961.36,16,99 ,2 ,512 ,0 ,0 ,2 ,0 ,0 ,0 ,0 ,2 ,0 ,4 ,0 ,4,46365 , 1 
42961.444,10,99 ,14 ,527 ,0 ,0 ,1 ,0 ,0 ,0 ,0 ,1 ,0 ,0 ,0 ,0,23342 , 0 
42961.482,12,99 ,18 ,1072 ,0 ,0 ,2 ,1 ,0 ,0 ,0 ,3 ,0 ,1 ,0 ,1,23585 , 0 
42961.596,9,99 ,5 ,790 ,0 ,0 ,1 ,0 ,0 ,0 ,0 ,1 ,0 ,2 ,0 ,2,40390 , 0 
42961.602,5,99 ,19 ,512 ,0 ,0 ,1 ,0 ,1 ,0 ,0 ,2 ,0 ,1 ,1 ,2,38629 , 0 
42961.606,19,99 ,1 ,256 ,0 ,0 ,1 ,0 ,1 ,0 ,0 ,2 ,0 ,1 ,1 ,2,24305 , 0 
42961.696,17,99 ,6 ,768 ,0 ,0 ,3 ,0 ,2 ,0 ,0 ,5 ,0 ,1 ,2 ,3,30448 , 0 
42961.771,13,99 ,1 ,256 ,0 ,0 ,1 ,0 ,0 ,0 ,0 ,1 ,0 ,0 ,0 ,0,21803 , 0 
42961.787,3,99 ,1 ,256 ,0 ,0 ,2 ,0 ,0 ,0 ,0 ,2 ,0 ,0 ,0 ,0,15332 , 0 
43080.96,8,99 ,1 ,256 ,0 ,0 ,2 ,0 ,0 ,0 ,0 ,2 ,0 ,0 ,0 ,0,17407 , 0 
43081.078,11,99 ,5 ,794 ,0 ,0 ,1 ,0 ,0 ,0 ,0 ,1 ,0 ,1 ,0 ,1,28841 , 0 
43081.123,2,99 ,1 ,256 ,0 ,0 ,2 ,0 ,1 ,0 ,0 ,3 ,0 ,1 ,1 ,2,30672 , 0 
43081.138,6,99 ,2 ,512 ,0 ,0 ,1 ,0 ,1 ,0 ,0 ,2 ,0 ,0 ,1 ,1,38627 , 0 
43081.214,18,99 ,5 ,780 ,0 ,0 ,2 ,0 ,1 ,0 ,0 ,3 ,0 ,1 ,1 ,2,24373 , 0 
43081.236,4,99 ,19 ,512 ,0 ,0 ,0 ,0 ,0 ,0 ,0 ,0 ,0 ,2 ,0 ,2,21304 , 0 
43081.289,7,99 ,17 ,1024 ,0 ,0 ,0 ,0 ,0 ,0 ,0 ,0 ,0 ,2 ,0 ,2,32847 , 0 
43081.337,14,99 ,1 ,256 ,0 ,0 ,1 ,0 ,0 ,0 ,0 ,1 ,0 ,2 ,0 ,2,20879 , 0 
43081.35,15,99 ,11 ,1050 ,0 ,0 ,1 ,0 ,0 ,0 ,0 ,1 ,0 ,0 ,0 ,0,25719 , 0 
43081.36,20,99 ,11 ,1077 ,0 ,0 ,1 ,0 ,0 ,0 ,0 ,1 ,0 ,0 ,0 ,0,23168 , 0 
43081.36,16,99 ,2 ,512 ,0 ,0 ,0 ,0 ,0 ,0 ,0 ,0 ,0 ,1 ,0 ,1,43298 , 1 
43081.444,10,99 ,14 ,519 ,0 ,0 ,1 ,0 ,0 ,0 ,0 ,1 ,0 ,1 ,0 ,1,22153 , 0 
43081.482,12,99 ,18 ,1068 ,0 ,0 ,2 ,1 ,0 ,0 ,0 ,3 ,0 ,2 ,0 ,2,25303 , 0 
43081.596,9,99 ,5 ,790 ,0 ,0 ,1 ,0 ,0 ,0 ,0 ,1 ,0 ,1 ,0 ,1,39203 , 0 
43081.602,5,99 ,19 ,512 ,0 ,0 ,0 ,0 ,1 ,0 ,0 ,1 ,0 ,2 ,1 ,3,39191 , 0 
43081.606,19,99 ,1 ,256 ,0 ,0 ,2 ,0 ,1 ,0 ,0 ,3 ,0 ,2 ,1 ,3,25190 , 0 
43081.696,17,99 ,6 ,768 ,0 ,0 ,1 ,1 ,0 ,0 ,0 ,2 ,0 ,1 ,0 ,1,30125 , 0 
43081.771,13,99 ,1 ,256 ,0 ,0 ,1 ,0 ,0 ,0 ,0 ,1 ,0 ,2 ,0 ,2,21997 , 0 
43081.787,3,99 ,1 ,256 ,0 ,0 ,1 ,0 ,0 ,0 ,0 ,1 ,0 ,1 ,0 ,1,15862 , 0 
43200.96,8,99 ,1 ,256 ,0 ,0 ,1 ,0 ,0 ,0 ,0 ,1 ,0 ,1 ,0 ,1,17547 , 0 
43201.078,11,99 ,5 ,794 ,0 ,0 ,2 ,0 ,0 ,0 ,0 ,2 ,0 ,0 ,0 ,0,27520 , 0 
43201.123,2,99 ,1 ,256 ,0 ,0 ,1 ,0 ,1 ,0 ,0 ,2 ,0 ,2 ,1 ,3,32244 , 0 
43201.138,6,99 ,2 ,512 ,0 ,0 ,1 ,0 ,0 ,0 ,0 ,1 ,0 ,3 ,0 ,3,45294 , 0 
43201.214,18,99 ,5 ,780 ,0 ,0 ,1 ,0 ,0 ,0 ,0 ,1 ,0 ,0 ,0 ,0,22430 , 0 
43201.236,4,99 ,19 ,512 ,0 ,0 ,1 ,0 ,0 ,0 ,0 ,1 ,0 ,1 ,0 ,1,20212 , 0 
43201.289,7,99 ,17 ,1024 ,0 ,0 ,2 ,0 ,0 ,0 ,0 ,2 ,0 ,2 ,0 ,2,32912 , 0 
43201.337,14,99 ,1 ,256 ,0 ,0 ,1 ,0 ,0 ,0 ,0 ,1 ,0 ,1 ,0 ,1,20173 , 0 
43201.35,15,99 ,11 ,1050 ,0 ,0 ,1 ,0 ,0 ,0 ,0 ,1 ,0 ,1 ,0 ,1,24905 , 0 
43201.36,20,99 ,11 ,1077 ,0 ,0 ,1 ,0 ,0 ,0 ,0 ,1 ,0 ,1 ,0 ,1,21524 , 0 
43201.36,16,99 ,2 ,512 ,0 ,0 ,2 ,1 ,0 ,0 ,0 ,3 ,0 ,3 ,0 ,3,46433 , 1 
43201.444,10,99 ,14 ,519 ,0 ,0 ,2 ,0 ,0 ,0 ,0 ,2 ,0 ,0 ,0 ,0,23398 , 0 
43201.482,12,99 ,18 ,1068 ,0 ,0 ,1 ,0 ,0 ,0 ,0 ,1 ,0 ,1 ,0 ,1,23669 , 0 
43201.596,9,99 ,5 ,790 ,0 ,0 ,1 ,0 ,0 ,0 ,0 ,1 ,0 ,3 ,0 ,3,40465 , 0 
43201.602,5,99 ,19 ,512 ,0 ,0 ,1 ,0 ,0 ,0 ,0 ,1 ,0 ,2 ,0 ,2,38724 , 0 
43201.606,19,99 ,1 ,256 ,0 ,0 ,1 ,0 ,0 ,0 ,0 ,1 ,0 ,1 ,0 ,1,24383 , 0 
43201.696,17,99 ,6 ,768 ,0 ,0 ,0 ,0 ,0 ,0 ,0 ,0 ,0 ,1 ,0 ,1,30519 , 0 
43201.771,13,99 ,1 ,256 ,0 ,0 ,1 ,0 ,0 ,0 ,0 ,1 ,0 ,3 ,0 ,3,21912 , 0 
43201.787,3,99 ,1 ,256 ,0 ,0 ,1 ,0 ,0 ,0 ,0 ,1 ,0 ,1 ,0 ,1,15390 , 0 
43320.96,8,99 ,1 ,256 ,0 ,0 ,1 ,0 ,0 ,0 ,0 ,1 ,0 ,2 ,0 ,2,17482 , 0 
43321.078,11,99 ,5 ,794 ,0 ,0 ,1 ,0 ,0 ,0 ,0 ,1 ,0 ,4 ,0 ,4,28916 , 0 
43321.123,2,99 ,1 ,256 ,0 ,0 ,2 ,0 ,3 ,0 ,0 ,5 ,0 ,1 ,3 ,4,30766 , 0 
43321.138,6,99 ,2 ,512 ,0 ,0 ,2 ,1 ,2 ,0 ,0 ,5 ,0 ,2 ,2 ,4,38736 , 0 
43321.214,18,99 ,5 ,780 ,0 ,0 ,1 ,0 ,0 ,0 ,1 ,2 ,0 ,2 ,1 ,3,24446 , 0 
43321.236,4,99 ,19 ,512 ,0 ,0 ,1 ,0 ,0 ,0 ,0 ,1 ,0 ,0 ,0 ,0,21363 , 0 
43321.289,7,99 ,17 ,1024 ,0 ,0 ,0 ,1 ,0 ,0 ,0 ,1 ,0 ,3 ,0 ,3,32903 , 0 
43321.337,14,99 ,1 ,256 ,0 ,0 ,1 ,0 ,0 ,0 ,0 ,1 ,0 ,4 ,0 ,4,20948 , 0 
43321.35,15,99 ,11 ,1050 ,0 ,0 ,2 ,0 ,0 ,0 ,0 ,2 ,0 ,1 ,0 ,1,25776 , 0 
43321.36,16,99 ,2 ,512 ,0 ,0 ,1 ,0 ,0 ,0 ,0 ,1 ,0 ,3 ,0 ,3,43388 , 0 
43321.363,20,99 ,11 ,1077 ,0 ,0 ,2 ,0 ,0 ,0 ,0 ,2 ,0 ,2 ,0 ,2,23247 , 0 
43321.444,10,99 ,14 ,519 ,0 ,0 ,1 ,0 ,0 ,0 ,0 ,1 ,0 ,1 ,0 ,1,22225 , 0 
43321.482,12,99 ,5 ,768 ,0 ,0 ,3 ,1 ,0 ,1 ,0 ,5 ,0 ,3 ,0 ,3,25407 , 0 
43321.596,9,99 ,5 ,790 ,0 ,0 ,1 ,0 ,0 ,0 ,0 ,1 ,0 ,1 ,0 ,1,39278 , 0 
43321.602,5,99 ,19 ,512 ,0 ,0 ,1 ,0 ,1 ,0 ,1 ,3 ,0 ,3 ,2 ,5,39309 , 0 
43321.606,19,99 ,1 ,256 ,0 ,0 ,1 ,0 ,1 ,0 ,1 ,3 ,0 ,2 ,2 ,4,25287 , 0 
43321.696,17,99 ,6 ,768 ,0 ,0 ,2 ,1 ,1 ,0 ,0 ,4 ,0 ,1 ,1 ,2,30204 , 0 
43321.771,13,99 ,1 ,256 ,0 ,0 ,1 ,0 ,0 ,0 ,0 ,1 ,0 ,1 ,0 ,1,22059 , 0 
43321.787,3,99 ,1 ,256 ,0 ,0 ,1 ,0 ,0 ,0 ,0 ,1 ,0 ,1 ,0 ,1,15940 , 0 
43440.96,8,99 ,1 ,256 ,0 ,0 ,2 ,0 ,0 ,0 ,0 ,2 ,0 ,0 ,0 ,0,17617 , 0 
43441.078,11,99 ,5 ,794 ,0 ,0 ,1 ,0 ,0 ,0 ,0 ,1 ,0 ,4 ,0 ,4,27584 , 0 
43441.123,2,99 ,1 ,256 ,0 ,0 ,1 ,0 ,1 ,0 ,1 ,3 ,0 ,2 ,2 ,4,32329 , 0 
43441.138,6,99 ,2 ,512 ,0 ,0 ,2 ,0 ,0 ,0 ,1 ,3 ,0 ,1 ,1 ,2,45361 , 0 
43441.214,18,99 ,5 ,780 ,0 ,0 ,1 ,0 ,0 ,1 ,0 ,2 ,0 ,5 ,0 ,5,22512 , 0 
43441.236,4,99 ,19 ,512 ,0 ,0 ,1 ,0 ,0 ,0 ,0 ,1 ,0 ,3 ,0 ,3,20282 , 0 
43441.289,7,99 ,16 ,768 ,0 ,0 ,5 ,1 ,0 ,1 ,0 ,7 ,0 ,1 ,0 ,1,33011 , 0 
43441.337,14,99 ,1 ,256 ,0 ,0 ,1 ,0 ,0 ,0 ,0 ,1 ,0 ,0 ,0 ,0,20243 , 0 
43441.35,15,99 ,11 ,1050 ,0 ,0 ,1 ,0 ,0 ,0 ,0 ,1 ,0 ,4 ,0 ,4,24959 , 0 
43441.36,20,99 ,11 ,1077 ,0 ,0 ,0 ,0 ,0 ,0 ,0 ,0 ,0 ,2 ,0 ,2,21584 , 0 
43441.36,16,99 ,2 ,512 ,0 ,0 ,1 ,0 ,1 ,0 ,0 ,2 ,0 ,6 ,1 ,7,46534 , 0 
43441.444,10,99 ,14 ,519 ,0 ,0 ,1 ,0 ,0 ,0 ,0 ,1 ,0 ,2 ,0 ,2,23456 , 0 
43441.482,12,99 ,5 ,768 ,0 ,0 ,4 ,0 ,0 ,0 ,0 ,4 ,0 ,1 ,0 ,1,23759 , 0 
43441.596,9,99 ,5 ,790 ,0 ,0 ,1 ,0 ,0 ,0 ,0 ,1 ,0 ,5 ,0 ,5,40548 , 0 
43441.602,5,99 ,19 ,512 ,0 ,0 ,0 ,0 ,0 ,0 ,0 ,0 ,0 ,3 ,1 ,4,38825 , 0 
43441.606,19,99 ,1 ,256 ,0 ,0 ,1 ,0 ,0 ,0 ,0 ,1 ,0 ,1 ,0 ,1,24460 , 0 
43441.696,17,99 ,6 ,768 ,0 ,0 ,1 ,0 ,0 ,0 ,1 ,2 ,0 ,4 ,1 ,5,30580 , 0 
43441.771,13,99 ,1 ,256 ,0 ,0 ,0 ,0 ,0 ,0 ,0 ,0 ,0 ,0 ,0 ,0,21968 , 0 
43441.787,3,99 ,1 ,256 ,0 ,0 ,1 ,0 ,0 ,0 ,0 ,1 ,0 ,1 ,0 ,1,15441 , 0 
43560.96,8,99 ,1 ,256 ,0 ,0 ,1 ,0 ,0 ,0 ,0 ,1 ,0 ,3 ,0 ,3,17544 , 0 
43561.078,11,99 ,5 ,794 ,0 ,0 ,1 ,0 ,0 ,1 ,1 ,3 ,0 ,5 ,1 ,6,28992 , 0 
43561.123,2,99 ,1 ,256 ,0 ,0 ,1 ,0 ,0 ,0 ,0 ,1 ,0 ,0 ,1 ,1,30844 , 0 
43561.138,6,99 ,2 ,512 ,0 ,0 ,1 ,0 ,0 ,1 ,0 ,2 ,0 ,3 ,1 ,4,38819 , 0 
43561.214,18,99 ,5 ,780 ,0 ,0 ,2 ,0 ,0 ,0 ,0 ,2 ,0 ,1 ,0 ,1,24520 , 0 
43561.236,4,99 ,19 ,512 ,0 ,0 ,2 ,0 ,0 ,0 ,0 ,2 ,0 ,1 ,0 ,1,21434 , 0 
43561.289,7,99 ,16 ,768 ,0 ,0 ,3 ,0 ,0 ,0 ,0 ,3 ,0 ,2 ,0 ,2,33001 , 0 
43561.337,14,99 ,1 ,256 ,0 ,0 ,1 ,0 ,0 ,0 ,0 ,1 ,0 ,1 ,0 ,1,21018 , 0 
43561.35,15,99 ,11 ,1050 ,0 ,0 ,1 ,0 ,0 ,0 ,0 ,1 ,0 ,3 ,0 ,3,25855 , 0 
43561.36,20,99 ,5 ,768 ,0 ,0 ,5 ,1 ,0 ,1 ,0 ,7 ,0 ,1 ,0 ,1,23355 , 0 
43561.36,16,99 ,2 ,512 ,0 ,0 ,1 ,0 ,0 ,0 ,0 ,1 ,0 ,5 ,0 ,5,43459 , 0 
43561.444,10,99 ,14 ,519 ,0 ,0 ,2 ,0 ,0 ,0 ,0 ,2 ,0 ,0 ,0 ,0,22290 , 0 
43561.482,12,99 ,5 ,768 ,0 ,0 ,1 ,0 ,0 ,0 ,0 ,1 ,0 ,6 ,0 ,6,25472 , 0 
43561.596,9,99 ,5 ,790 ,0 ,0 ,2 ,0 ,0 ,0 ,0 ,2 ,0 ,3 ,0 ,3,39361 , 0 
43561.603,5,99 ,19 ,512 ,0 ,0 ,1 ,0 ,1 ,0 ,1 ,3 ,0 ,7 ,3 ,10,39435 , 0 
43561.606,19,99 ,1 ,256 ,0 ,0 ,1 ,0 ,1 ,0 ,1 ,3 ,0 ,2 ,2 ,4,25363 , 0 
43561.696,17,99 ,6 ,768 ,0 ,0 ,2 ,0 ,0 ,1 ,0 ,3 ,0 ,4 ,0 ,4,30300 , 0 
43561.771,13,99 ,1 ,256 ,0 ,0 ,2 ,0 ,0 ,0 ,0 ,2 ,0 ,2 ,0 ,2,22157 , 0 
43561.787,3,99 ,1 ,256 ,0 ,0 ,1 ,0 ,0 ,0 ,0 ,1 ,0 ,1 ,0 ,1,15999 , 0 
43680.96,8,99 ,1 ,256 ,0 ,0 ,1 ,0 ,0 ,1 ,0 ,2 ,0 ,1 ,0 ,1,17721 , 0 
43681.078,11,101 ,9 ,1320 ,0 ,0 ,3 ,1 ,0 ,1 ,1 ,6 ,0 ,5 ,1 ,6,27703 , 0 
43681.124,2,101 ,5 ,1576 ,0 ,0 ,2 ,1 ,0 ,1 ,2 ,6 ,0 ,3 ,2 ,5,32469 , 0 
43681.138,6,99 ,2 ,512 ,0 ,0 ,0 ,0 ,0 ,0 ,1 ,1 ,0 ,2 ,1 ,3,45448 , 0 
43681.216,18,101 ,5 ,1919 ,0 ,0 ,2 ,1 ,0 ,1 ,0 ,4 ,0 ,7 ,0 ,7,22641 , 0 
43681.236,4,99 ,19 ,512 ,0 ,0 ,1 ,0 ,0 ,0 ,0 ,1 ,0 ,0 ,0 ,0,20359 , 0 
43681.29,7,104 ,16 ,65535 ,0 ,0 ,3 ,0 ,3 ,1 ,0 ,7 ,0 ,1 ,9 ,10,33124 , 1 
43681.35,15,101 ,7 ,1064 ,0 ,0 ,3 ,1 ,0 ,1 ,0 ,5 ,0 ,5 ,0 ,5,25053 , 0 
43681.36,20,101 ,11 ,1806 ,0 ,0 ,3 ,1 ,0 ,2 ,0 ,6 ,0 ,5 ,0 ,5,21697 , 0 
43681.36,16,103 ,9 ,1320 ,0 ,0 ,3 ,1 ,0 ,3 ,0 ,7 ,0 ,5 ,4 ,9,46701 , 0 
43681.395,14,101 ,13 ,1850 ,0 ,0 ,1 ,1 ,0 ,1 ,0 ,3 ,0 ,3 ,0 ,3,20343 , 0 
43681.443,10,99 ,0 ,0 ,0 ,0 ,1 ,0 ,0 ,1 ,0 ,2 ,0 ,1 ,0 ,1,23523 , 0 
43681.482,12,101 ,11 ,1806 ,0 ,0 ,4 ,1 ,0 ,2 ,0 ,7 ,0 ,4 ,0 ,4,23947 , 0 
43681.603,5,101 ,9 ,1578 ,0 ,0 ,3 ,1 ,5 ,1 ,7 ,17 ,0 ,7 ,13 ,20,39088 , 0 
43681.607,19,101 ,13 ,1850 ,0 ,0 ,2 ,1 ,0 ,2 ,2 ,7 ,0 ,5 ,3 ,8,24620 , 0 
43681.667,9,101 ,7 ,1064 ,0 ,0 ,2 ,1 ,6 ,1 ,2 ,12 ,0 ,5 ,11 ,16,40770 , 0 
43681.696,17,101 ,7 ,1064 ,0 ,0 ,3 ,1 ,0 ,1 ,0 ,5 ,0 ,1 ,0 ,1,30678 , 0 
43681.771,13,101 ,5 ,1576 ,0 ,0 ,1 ,1 ,1 ,1 ,0 ,4 ,0 ,1 ,1 ,2,22066 , 0 
43681.902,3,99 ,0 ,0 ,0 ,0 ,1 ,0 ,0 ,1 ,0 ,2 ,0 ,1 ,0 ,1,15532 , 0 
43800.961,8,143 ,0 ,0 ,0 ,0 ,17 ,10 ,4 ,10 ,2 ,43 ,0 ,49 ,12 ,61,17966 , 0 
43801.078,11,143 ,5 ,793 ,0 ,0 ,16 ,2 ,4 ,3 ,0 ,25 ,0 ,60 ,12 ,72,29384 , 0 
43801.124,2,143 ,1 ,256 ,0 ,0 ,19 ,3 ,0 ,9 ,1 ,32 ,0 ,69 ,11 ,80,31310 , 0 
43801.138,6,143 ,2 ,512 ,0 ,0 ,19 ,3 ,0 ,9 ,0 ,31 ,0 ,53 ,1 ,54,39290 , 0 
43801.214,18,141 ,19 ,512 ,0 ,0 ,19 ,4 ,0 ,12 ,0 ,35 ,0 ,39 ,0 ,39,25166 , 0 
43801.236,4,143 ,4 ,0 ,0 ,0 ,16 ,8 ,0 ,12 ,0 ,36 ,0 ,31 ,1 ,32,21901 , 0 
43801.29,7,144 ,16 ,65535 ,0 ,0 ,20 ,0 ,0 ,0 ,0 ,20 ,0 ,49 ,8 ,57,33246 , 1 
43801.338,14,143 ,0 ,0 ,0 ,0 ,19 ,8 ,6 ,13 ,6 ,52 ,0 ,58 ,17 ,75,21522 , 0 
43801.35,15,143 ,9 ,2615 ,0 ,0 ,19 ,2 ,0 ,4 ,0 ,25 ,0 ,41 ,0 ,41,26142 , 0 
43801.36,20,143 ,11 ,1029 ,0 ,0 ,17 ,3 ,0 ,3 ,0 ,23 ,0 ,27 ,0 ,27,23691 , 0 
43801.361,16,143 ,2 ,512 ,0 ,0 ,22 ,2 ,0 ,3 ,0 ,27 ,0 ,58 ,5 ,63,43886 , 0 
43801.444,10,143 ,14 ,512 ,0 ,0 ,16 ,5 ,2 ,4 ,2 ,29 ,0 ,25 ,4 ,29,22766 , 0 
43801.482,12,143 ,11 ,1029 ,0 ,0 ,15 ,3 ,0 ,3 ,0 ,21 ,0 ,37 ,0 ,37,25725 , 0 
43801.597,9,143 ,16 ,768 ,0 ,0 ,18 ,2 ,7 ,4 ,2 ,33 ,0 ,56 ,13 ,69,39944 , 0 
43801.607,19,144 ,1 ,256 ,0 ,0 ,20 ,6 ,3 ,16 ,0 ,45 ,0 ,71 ,17 ,88,25902 , 0 
43801.643,5,141 ,0 ,0 ,0 ,0 ,18 ,2 ,5 ,10 ,3 ,38 ,0 ,76 ,12 ,88,39995 , 0 
43801.697,17,143 ,7 ,1064 ,0 ,0 ,18 ,0 ,0 ,1 ,0 ,19 ,0 ,42 ,0 ,42,30545 , 0 
43801.772,13,144 ,1 ,256 ,0 ,0 ,20 ,8 ,6 ,13 ,5 ,52 ,0 ,55 ,15 ,70,22620 , 0 
43801.787,3,143 ,0 ,0 ,0 ,0 ,17 ,11 ,2 ,11 ,2 ,43 ,0 ,34 ,4 ,38,16352 , 0 
43920.961,8,174 ,1 ,256 ,0 ,0 ,13 ,10 ,1 ,9 ,1 ,34 ,0 ,38 ,3 ,41,17996 , 0 
43921.078,11,174 ,5 ,1137 ,0 ,0 ,22 ,4 ,1 ,5 ,1 ,33 ,0 ,59 ,3 ,62,28251 , 0 
43921.124,2,175 ,19 ,512 ,0 ,0 ,19 ,5 ,5 ,11 ,3 ,43 ,0 ,66 ,10 ,76,32976 , 0 
43921.139,6,175 ,10 ,1312 ,0 ,0 ,18 ,4 ,0 ,6 ,0 ,28 ,0 ,44 ,0 ,44,45801 , 0 
43921.224,18,174 ,19 ,512 ,0 ,0 ,18 ,4 ,3 ,6 ,1 ,32 ,0 ,42 ,5 ,47,23140 , 0 
43921.236,4,174 ,19 ,512 ,0 ,0 ,17 ,6 ,0 ,8 ,0 ,31 ,0 ,27 ,0 ,27,20781 , 0 
43921.29,7,186 ,16 ,65535 ,0 ,0 ,21 ,0 ,0 ,0 ,0 ,21 ,0 ,37 ,0 ,37,33347 , 1 
43921.351,15,179 ,11 ,1280 ,0 ,0 ,20 ,1 ,0 ,1 ,0 ,22 ,0 ,49 ,2 ,51,25378 , 0 
43921.36,20,174 ,5 ,1137 ,0 ,0 ,16 ,3 ,1 ,1 ,1 ,22 ,0 ,46 ,2 ,48,22027 , 0 
43921.361,16,175 ,2 ,773 ,0 ,0 ,19 ,1 ,0 ,1 ,0 ,21 ,0 ,39 ,0 ,39,46954 , 0 
43921.387,14,176 ,0 ,0 ,0 ,0 ,19 ,9 ,5 ,13 ,3 ,49 ,0 ,46 ,13 ,59,20968 , 0 
43921.444,10,175 ,0 ,0 ,0 ,0 ,16 ,5 ,1 ,5 ,1 ,28 ,0 ,29 ,4 ,33,23912 , 0 
43921.482,12,174 ,5 ,1137 ,0 ,0 ,17 ,4 ,0 ,3 ,0 ,24 ,0 ,52 ,0 ,52,24323 , 0 
43921.596,9,174 ,5 ,1137 ,0 ,0 ,22 ,3 ,0 ,4 ,0 ,29 ,0 ,63 ,0 ,63,41246 , 0 
43921.603,5,174 ,13 ,800 ,0 ,0 ,21 ,5 ,11 ,8 ,5 ,50 ,0 ,84 ,23 ,107,39802 , 0 
43921.607,19,174 ,19 ,0 ,0 ,0 ,15 ,8 ,15 ,9 ,10 ,57 ,0 ,71 ,39 ,110,25064 , 0 
43921.697,17,175 ,7 ,1064 ,0 ,0 ,17 ,0 ,0 ,0 ,0 ,17 ,0 ,34 ,0 ,34,30863 , 0 
43921.772,13,174 ,13 ,0 ,0 ,0 ,15 ,5 ,9 ,10 ,5 ,44 ,0 ,55 ,23 ,78,22636 , 0 
43921.787,3,174 ,0 ,0 ,0 ,0 ,15 ,10 ,1 ,10 ,1 ,37 ,0 ,33 ,3 ,36,15763 , 0 
44040.96,8,188 ,1 ,256 ,0 ,0 ,7 ,5 ,4 ,1 ,0 ,17 ,0 ,16 ,6 ,22,18128 , 0 
44041.078,11,188 ,5 ,695 ,0 ,0 ,13 ,3 ,4 ,1 ,0 ,21 ,0 ,41 ,5 ,46,29698 , 0 
44041.124,2,188 ,1 ,256 ,0 ,0 ,8 ,4 ,26 ,2 ,4 ,44 ,0 ,34 ,34 ,68,31629 , 0 
44041.139,6,188 ,17 ,1250 ,0 ,0 ,14 ,4 ,4 ,2 ,0 ,24 ,0 ,27 ,4 ,31,39630 , 0 
44041.214,18,188 ,4 ,811 ,0 ,0 ,9 ,3 ,1 ,4 ,0 ,17 ,0 ,22 ,3 ,25,25435 , 0 
44041.236,4,188 ,8 ,512 ,0 ,0 ,9 ,3 ,4 ,4 ,1 ,21 ,0 ,16 ,6 ,22,22232 , 0 
44041.29,7,188 ,16 ,1318 ,0 ,0 ,13 ,4 ,2 ,3 ,1 ,23 ,0 ,22 ,5 ,27,33632 , 0 
44041.338,14,188 ,1 ,256 ,0 ,0 ,7 ,4 ,5 ,4 ,2 ,22 ,0 ,24 ,10 ,34,21733 , 0 
44041.351,15,188 ,11 ,1046 ,0 ,0 ,13 ,5 ,0 ,4 ,0 ,22 ,0 ,27 ,0 ,27,26474 , 0 
44041.36,20,188 ,12 ,1293 ,0 ,0 ,14 ,6 ,0 ,5 ,0 ,25 ,0 ,23 ,1 ,24,24027 , 0 
44041.361,16,188 ,2 ,547 ,0 ,0 ,10 ,3 ,17 ,0 ,3 ,33 ,0 ,35 ,24 ,59,44456 , 0 
44041.444,10,188 ,6 ,1523 ,0 ,0 ,10 ,10 ,0 ,3 ,0 ,23 ,0 ,15 ,1 ,16,23155 , 0 
44041.482,12,188 ,5 ,695 ,0 ,0 ,14 ,7 ,2 ,5 ,0 ,28 ,0 ,31 ,3 ,34,26191 , 0 
44041.596,9,188 ,16 ,951 ,0 ,0 ,10 ,2 ,4 ,2 ,3 ,21 ,0 ,31 ,7 ,38,40307 , 0 
44041.603,5,188 ,19 ,512 ,0 ,0 ,14 ,4 ,10 ,7 ,1 ,36 ,0 ,47 ,17 ,64,40551 , 0 
44041.607,19,188 ,1 ,256 ,0 ,0 ,10 ,4 ,9 ,5 ,1 ,29 ,0 ,31 ,15 ,46,26218 , 0 
44041.697,17,188 ,16 ,1318 ,0 ,0 ,10 ,3 ,0 ,0 ,0 ,13 ,0 ,27 ,4 ,31,30781 , 0 
44041.772,13,188 ,1 ,256 ,0 ,0 ,7 ,4 ,1 ,3 ,1 ,16 ,0 ,27 ,2 ,29,22869 , 0 
44041.787,3,188 ,1 ,256 ,0 ,0 ,7 ,5 ,0 ,2 ,0 ,14 ,0 ,12 ,0 ,12,16491 , 0 
44160.96,8,188 ,1 ,256 ,0 ,0 ,2 ,2 ,2 ,0 ,0 ,6 ,0 ,5 ,3 ,8,18087 , 0 
44161.078,11,188 ,5 ,768 ,0 ,0 ,2 ,2 ,4 ,0 ,0 ,8 ,0 ,16 ,4 ,20,28436 , 0 
44161.124,2,188 ,1 ,256 ,0 ,0 ,2 ,1 ,13 ,2 ,3 ,21 ,0 ,12 ,23 ,35,33120 , 0 
44161.138,6,188 ,2 ,530 ,0 ,0 ,8 ,2 ,9 ,2 ,0 ,21 ,0 ,7 ,9 ,16,46017 , 0 
44161.214,18,188 ,4 ,786 ,0 ,0 ,3 ,2 ,0 ,0 ,0 ,5 ,0 ,7 ,0 ,7,23239 , 0 
44161.236,4,188 ,8 ,512 ,0 ,0 ,3 ,0 ,2 ,1 ,0 ,6 ,0 ,2 ,2 ,4,20873 , 0 
44161.289,7,188 ,16 ,999 ,0 ,0 ,3 ,1 ,0 ,0 ,0 ,4 ,0 ,14 ,0 ,14,33458 , 0 
44161.337,14,188 ,1 ,256 ,0 ,0 ,3 ,2 ,0 ,0 ,0 ,5 ,0 ,6 ,0 ,6,21092 , 0 
44161.35,15,188 ,11 ,1028 ,0 ,0 ,4 ,2 ,0 ,0 ,0 ,6 ,0 ,10 ,0 ,10,25492 , 0 
44161.36,20,188 ,11 ,1028 ,0 ,0 ,6 ,3 ,0 ,1 ,0 ,10 ,0 ,5 ,0 ,5,22144 , 0 
44161.361,16,188 ,2 ,530 ,0 ,0 ,3 ,1 ,5 ,5 ,5 ,19 ,0 ,14 ,10 ,24,47213 , 0 
44161.444,10,188 ,6 ,786 ,0 ,0 ,2 ,7 ,0 ,0 ,0 ,9 ,0 ,9 ,0 ,9,24010 , 0 
44161.482,12,188 ,5 ,768 ,0 ,0 ,2 ,2 ,1 ,1 ,1 ,7 ,0 ,9 ,2 ,11,24468 , 0 
44161.596,9,188 ,5 ,768 ,0 ,0 ,7 ,3 ,0 ,4 ,0 ,14 ,0 ,9 ,0 ,9,41443 , 0 
44161.603,5,188 ,19 ,512 ,0 ,0 ,3 ,0 ,12 ,0 ,1 ,16 ,0 ,17 ,15 ,32,40046 , 0 
44161.607,19,188 ,1 ,256 ,0 ,0 ,2 ,1 ,12 ,0 ,1 ,16 ,0 ,10 ,13 ,23,25190 , 0 
44161.697,17,188 ,6 ,786 ,0 ,0 ,6 ,3 ,0 ,1 ,0 ,10 ,0 ,8 ,2 ,10,31004 , 0 
44161.771,13,188 ,1 ,256 ,0 ,0 ,4 ,2 ,0 ,0 ,0 ,6 ,0 ,8 ,0 ,8,22742 , 0 
44161.787,3,188 ,1 ,256 ,0 ,0 ,2 ,2 ,0 ,0 ,0 ,4 ,0 ,4 ,0 ,4,15831 , 0 
44280.96,8,188 ,1 ,256 ,0 ,0 ,2 ,0 ,1 ,0 ,0 ,3 ,0 ,2 ,1 ,3,18202 , 0 
44281.078,11,188 ,5 ,783 ,0 ,0 ,2 ,1 ,2 ,0 ,0 ,5 ,0 ,6 ,2 ,8,29780 , 0 
44281.124,2,188 ,1 ,256 ,0 ,0 ,3 ,0 ,6 ,0 ,0 ,9 ,0 ,4 ,6 ,10,31725 , 0 
44281.138,6,188 ,2 ,512 ,0 ,0 ,2 ,1 ,3 ,0 ,0 ,6 ,0 ,3 ,3 ,6,39719 , 0 
44281.214,18,188 ,4 ,786 ,0 ,0 ,1 ,0 ,0 ,0 ,0 ,1 ,0 ,4 ,0 ,4,25498 , 0 
44281.236,4,188 ,8 ,512 ,0 ,0 ,1 ,1 ,0 ,0 ,0 ,2 ,0 ,2 ,0 ,2,22312 , 0 
44281.289,7,188 ,16 ,838 ,0 ,0 ,2 ,1 ,0 ,0 ,0 ,3 ,0 ,6 ,0 ,6,33713 , 0 
44281.337,14,188 ,1 ,256 ,0 ,0 ,0 ,0 ,0 ,0 ,0 ,0 ,0 ,7 ,0 ,7,21794 , 0 
44281.35,15,188 ,11 ,1087 ,0 ,0 ,2 ,1 ,0 ,0 ,0 ,3 ,0 ,4 ,0 ,4,26551 , 0 
44281.36,20,188 ,11 ,1087 ,0 ,0 ,2 ,1 ,0 ,0 ,0 ,3 ,0 ,5 ,0 ,5,24094 , 0 
44281.36,16,188 ,2 ,512 ,0 ,0 ,1 ,1 ,1 ,0 ,0 ,3 ,0 ,7 ,1 ,8,44526 , 0 
44281.444,10,188 ,6 ,785 ,0 ,0 ,2 ,2 ,0 ,0 ,0 ,4 ,0 ,2 ,0 ,2,23223 , 0 
44281.482,12,188 ,5 ,768 ,0 ,0 ,2 ,0 ,0 ,0 ,0 ,2 ,0 ,5 ,0 ,5,26258 , 0 
44281.596,9,188 ,5 ,783 ,0 ,0 ,3 ,1 ,0 ,0 ,0 ,4 ,0 ,6 ,0 ,6,40400 , 0 
44281.603,5,188 ,19 ,527 ,0 ,0 ,2 ,1 ,4 ,0 ,0 ,7 ,0 ,8 ,4 ,12,40689 , 0 
44281.607,19,188 ,1 ,256 ,0 ,0 ,2 ,0 ,5 ,0 ,0 ,7 ,0 ,6 ,5 ,11,26326 , 0 
44281.696,17,188 ,6 ,790 ,0 ,0 ,2 ,1 ,0 ,0 ,0 ,3 ,0 ,2 ,0 ,2,30844 , 0 
44281.771,13,188 ,1 ,256 ,0 ,0 ,1 ,0 ,0 ,0 ,0 ,1 ,0 ,3 ,0 ,3,22933 , 0 
44281.787,3,188 ,1 ,256 ,0 ,0 ,3 ,0 ,0 ,0 ,0 ,3 ,0 ,2 ,0 ,2,16562 , 0 
44400.96,8,188 ,1 ,256 ,0 ,0 ,1 ,1 ,1 ,0 ,0 ,3 ,0 ,4 ,1 ,5,18152 , 0 
44401.078,11,188 ,5 ,783 ,0 ,0 ,1 ,0 ,0 ,0 ,1 ,2 ,0 ,3 ,1 ,4,28508 , 0 
44401.123,2,188 ,1 ,256 ,0 ,0 ,1 ,1 ,3 ,0 ,0 ,5 ,0 ,5 ,3 ,8,33219 , 0 
44401.197,6,188 ,2 ,512 ,0 ,0 ,2 ,1 ,1 ,0 ,0 ,4 ,0 ,4 ,1 ,5,46126 , 0 
44401.214,18,188 ,4 ,784 ,0 ,0 ,2 ,1 ,0 ,0 ,0 ,3 ,0 ,2 ,0 ,2,23314 , 0 
44401.236,4,188 ,8 ,512 ,0 ,0 ,2 ,0 ,1 ,0 ,0 ,3 ,0 ,2 ,1 ,3,20961 , 0 
44401.289,7,188 ,16 ,838 ,0 ,0 ,1 ,0 ,0 ,0 ,0 ,1 ,0 ,5 ,0 ,5,33543 , 0 
44401.337,14,188 ,1 ,256 ,0 ,0 ,1 ,1 ,0 ,0 ,0 ,2 ,0 ,5 ,0 ,5,21167 , 0 
44401.35,15,188 ,9 ,300 ,0 ,0 ,3 ,1 ,0 ,1 ,0 ,5 ,0 ,1 ,0 ,1,25594 , 0 
44401.36,20,188 ,11 ,1087 ,0 ,0 ,1 ,0 ,0 ,0 ,0 ,1 ,0 ,0 ,0 ,0,22234 , 0 
44401.36,16,188 ,2 ,512 ,0 ,0 ,1 ,1 ,0 ,0 ,0 ,2 ,0 ,3 ,0 ,3,47307 , 0 
44401.444,10,188 ,6 ,783 ,0 ,0 ,2 ,0 ,0 ,0 ,0 ,2 ,0 ,1 ,0 ,1,24079 , 0 
44401.482,12,188 ,5 ,768 ,0 ,0 ,1 ,0 ,0 ,0 ,0 ,1 ,0 ,2 ,0 ,2,24565 , 0 
44401.596,9,188 ,5 ,783 ,0 ,0 ,1 ,0 ,1 ,0 ,0 ,2 ,0 ,3 ,1 ,4,41532 , 1 
44401.602,5,188 ,19 ,519 ,0 ,0 ,0 ,1 ,1 ,0 ,1 ,3 ,0 ,6 ,2 ,8,40180 , 0 
44401.606,19,188 ,1 ,256 ,0 ,0 ,2 ,1 ,2 ,0 ,1 ,6 ,0 ,8 ,3 ,11,25284 , 0 
44401.696,17,188 ,6 ,779 ,0 ,0 ,2 ,1 ,0 ,0 ,0 ,3 ,0 ,3 ,0 ,3,31091 , 0 
44401.771,13,188 ,1 ,256 ,0 ,0 ,2 ,1 ,0 ,0 ,0 ,3 ,0 ,4 ,0 ,4,22832 , 0 
44401.787,3,188 ,1 ,256 ,0 ,0 ,1 ,1 ,0 ,0 ,0 ,2 ,0 ,2 ,0 ,2,15888 , 0 
44520.96,8,188 ,1 ,256 ,0 ,0 ,2 ,0 ,1 ,0 ,0 ,3 ,0 ,2 ,1 ,3,18270 , 0 
44521.078,11,188 ,5 ,775 ,0 ,0 ,3 ,1 ,2 ,1 ,0 ,7 ,0 ,6 ,2 ,8,29867 , 0 
44521.123,2,188 ,1 ,256 ,0 ,0 ,2 ,0 ,3 ,0 ,0 ,5 ,0 ,3 ,3 ,6,31801 , 0 
44521.138,6,188 ,2 ,512 ,0 ,0 ,1 ,0 ,2 ,0 ,0 ,3 ,0 ,2 ,2 ,4,39809 , 0 
44521.214,18,188 ,4 ,784 ,0 ,0 ,1 ,0 ,0 ,0 ,0 ,1 ,0 ,4 ,0 ,4,25580 , 0 
44521.236,4,188 ,8 ,512 ,0 ,0 ,0 ,1 ,0 ,0 ,0 ,1 ,0 ,1 ,0 ,1,22368 , 0 
44521.289,7,188 ,16 ,813 ,0 ,0 ,2 ,1 ,0 ,0 ,0 ,3 ,0 ,5 ,0 ,5,33794 , 0 
44521.337,14,188 ,1 ,256 ,0 ,0 ,2 ,0 ,0 ,0 ,0 ,2 ,0 ,3 ,0 ,3,21872 , 0 
44521.35,15,188 ,9 ,300 ,0 ,0 ,4 ,0 ,0 ,0 ,0 ,4 ,0 ,3 ,0 ,3,26646 , 0 
44521.36,20,188 ,11 ,1064 ,0 ,0 ,2 ,2 ,0 ,0 ,0 ,4 ,0 ,4 ,0 ,4,24170 , 0 
44521.36,16,188 ,2 ,512 ,0 ,0 ,2 ,0 ,1 ,0 ,0 ,3 ,0 ,2 ,1 ,3,44629 , 0 
44521.444,10,188 ,6 ,775 ,0 ,0 ,2 ,1 ,0 ,0 ,0 ,3 ,0 ,3 ,0 ,3,23299 , 0 
44521.482,12,188 ,5 ,775 ,0 ,0 ,2 ,1 ,0 ,0 ,0 ,3 ,0 ,3 ,0 ,3,26338 , 0 
44521.596,9,188 ,5 ,775 ,0 ,0 ,0 ,1 ,0 ,0 ,0 ,1 ,0 ,9 ,0 ,9,40476 , 1 
44521.603,5,188 ,19 ,519 ,0 ,0 ,2 ,0 ,5 ,0 ,0 ,7 ,0 ,4 ,6 ,10,40821 , 0 
44521.625,19,188 ,1 ,256 ,0 ,0 ,1 ,0 ,5 ,0 ,0 ,6 ,0 ,4 ,5 ,9,26405 , 0 
44521.696,17,188 ,6 ,779 ,0 ,0 ,1 ,1 ,0 ,0 ,0 ,2 ,0 ,2 ,0 ,2,30919 , 0 
44521.771,13,188 ,1 ,256 ,0 ,0 ,1 ,0 ,0 ,0 ,0 ,1 ,0 ,3 ,0 ,3,23012 , 0 
44521.787,3,188 ,1 ,256 ,0 ,0 ,2 ,0 ,0 ,0 ,0 ,2 ,0 ,2 ,0 ,2,16634 , 0 
44640.96,8,188 ,1 ,256 ,0 ,0 ,1 ,0 ,3 ,0 ,1 ,5 ,0 ,1 ,4 ,5,18227 , 0 
44641.078,11,188 ,9 ,300 ,0 ,0 ,9 ,5 ,5 ,9 ,0 ,28 ,0 ,17 ,20 ,37,28850 , 0 
44641.124,2,188 ,1 ,256 ,0 ,0 ,1 ,0 ,0 ,0 ,2 ,3 ,0 ,11 ,2 ,13,33358 , 0 
44641.138,6,188 ,2 ,512 ,0 ,0 ,1 ,0 ,0 ,0 ,1 ,2 ,0 ,7 ,1 ,8,46200 , 0 
44641.214,18,188 ,4 ,777 ,0 ,0 ,5 ,4 ,0 ,2 ,0 ,11 ,0 ,7 ,0 ,7,23488 , 0 
44641.236,4,188 ,8 ,512 ,0 ,0 ,1 ,1 ,2 ,0 ,1 ,5 ,0 ,5 ,3 ,8,21076 , 0 
44641.289,7,188 ,9 ,300 ,0 ,0 ,6 ,8 ,2 ,2 ,1 ,19 ,0 ,16 ,4 ,20,33783 , 0 
44641.337,14,188 ,1 ,256 ,0 ,0 ,2 ,0 ,0 ,0 ,0 ,2 ,0 ,1 ,0 ,1,21263 , 0 
44641.35,15,188 ,9 ,300 ,0 ,0 ,4 ,6 ,0 ,0 ,0 ,10 ,0 ,17 ,2 ,19,25808 , 0 
44641.36,20,188 ,11 ,627 ,0 ,0 ,4 ,8 ,0 ,2 ,0 ,14 ,0 ,16 ,0 ,16,22420 , 0 
44641.361,16,188 ,9 ,300 ,0 ,0 ,5 ,7 ,0 ,1 ,1 ,14 ,0 ,13 ,1 ,14,47476 , 0 
44641.444,10,188 ,6 ,774 ,0 ,0 ,1 ,0 ,0 ,0 ,0 ,1 ,0 ,1 ,0 ,1,24163 , 0 
44641.482,12,188 ,11 ,627 ,0 ,0 ,5 ,3 ,1 ,1 ,1 ,11 ,0 ,17 ,2 ,19,24768 , 0 
44641.597,9,188 ,5 ,65535 ,0 ,0 ,10 ,4 ,10 ,10 ,2 ,36 ,0 ,14 ,49 ,63,42008 , 1 
44641.603,5,188 ,2 ,512 ,0 ,0 ,9 ,7 ,5 ,9 ,4 ,34 ,0 ,22 ,26 ,48,40602 , 0 
44641.607,19,188 ,1 ,256 ,0 ,0 ,1 ,0 ,5 ,1 ,6 ,13 ,0 ,9 ,12 ,21,25442 , 0 
44641.696,17,188 ,16 ,587 ,0 ,0 ,4 ,3 ,0 ,2 ,0 ,9 ,0 ,5 ,0 ,5,31277 , 0 
44641.771,13,188 ,1 ,256 ,0 ,0 ,1 ,0 ,0 ,0 ,0 ,1 ,0 ,5 ,0 ,5,22947 , 0 
44641.787,3,188 ,1 ,256 ,0 ,0 ,2 ,0 ,0 ,0 ,0 ,2 ,0 ,1 ,0 ,1,15960 , 0 
44760.96,8,188 ,1 ,256 ,0 ,0 ,1 ,1 ,2 ,0 ,0 ,4 ,0 ,1 ,2 ,3,18346 , 0 
44761.078,11,188 ,5 ,883 ,0 ,0 ,9 ,6 ,6 ,3 ,1 ,25 ,0 ,19 ,12 ,31,30188 , 0 
44761.124,2,188 ,1 ,256 ,0 ,0 ,1 ,1 ,8 ,3 ,1 ,14 ,0 ,8 ,12 ,20,31925 , 0 
44761.138,6,188 ,2 ,512 ,0 ,0 ,1 ,1 ,1 ,1 ,0 ,4 ,0 ,13 ,1 ,14,40000 , 0 
44761.214,18,188 ,4 ,777 ,0 ,0 ,5 ,0 ,2 ,0 ,0 ,7 ,0 ,10 ,3 ,13,25731 , 0 
44761.236,4,188 ,8 ,512 ,0 ,0 ,1 ,0 ,2 ,0 ,0 ,3 ,0 ,3 ,2 ,5,22500 , 0 
44761.29,7,188 ,16 ,826 ,0 ,0 ,7 ,6 ,0 ,4 ,0 ,17 ,0 ,18 ,2 ,20,34090 , 0 
44761.337,14,188 ,1 ,256 ,0 ,0 ,1 ,1 ,0 ,0 ,0 ,2 ,0 ,2 ,0 ,2,21942 , 0 
44761.35,15,188 ,11 ,1209 ,0 ,0 ,7 ,5 ,0 ,3 ,0 ,15 ,0 ,13 ,4 ,17,26907 , 0 
44761.36,20,188 ,5 ,883 ,0 ,0 ,6 ,6 ,0 ,1 ,0 ,13 ,0 ,18 ,0 ,18,24378 , 0 
44761.361,16,188 ,2 ,512 ,0 ,0 ,6 ,1 ,4 ,2 ,0 ,13 ,0 ,10 ,7 ,17,44844 , 0 
44761.444,10,188 ,6 ,774 ,0 ,0 ,0 ,0 ,0 ,0 ,0 ,0 ,0 ,1 ,0 ,1,23358 , 0 
44761.482,12,188 ,18 ,1106 ,0 ,0 ,5 ,2 ,0 ,2 ,0 ,9 ,0 ,22 ,0 ,22,26549 , 0 
44761.596,9,188 ,5 ,883 ,0 ,0 ,6 ,5 ,0 ,7 ,4 ,22 ,0 ,22 ,7 ,29,40752 , 0 
44761.603,5,188 ,19 ,519 ,0 ,0 ,7 ,2 ,17 ,6 ,4 ,36 ,0 ,20 ,28 ,48,41376 , 0 
44761.607,19,188 ,1 ,256 ,0 ,0 ,0 ,1 ,16 ,2 ,1 ,20 ,0 ,12 ,23 ,35,26597 , 0 
44761.696,17,188 ,6 ,774 ,0 ,0 ,8 ,2 ,0 ,1 ,0 ,11 ,0 ,9 ,0 ,9,31153 , 0 
44761.771,13,188 ,1 ,256 ,0 ,0 ,2 ,1 ,0 ,0 ,0 ,3 ,0 ,5 ,0 ,5,23101 , 0 
44761.787,3,188 ,1 ,256 ,0 ,0 ,1 ,1 ,0 ,0 ,0 ,2 ,0 ,1 ,0 ,1,16695 , 0 
44880.96,8,188 ,1 ,256 ,0 ,0 ,1 ,0 ,2 ,0 ,0 ,3 ,0 ,3 ,2 ,5,18298 , 0 
44881.078,11,188 ,5 ,869 ,0 ,0 ,1 ,1 ,2 ,0 ,0 ,4 ,0 ,7 ,2 ,9,28929 , 0 
44881.123,2,188 ,1 ,256 ,0 ,0 ,3 ,0 ,4 ,0 ,0 ,7 ,0 ,5 ,4 ,9,33467 , 0 
44881.138,6,188 ,2 ,512 ,0 ,0 ,1 ,1 ,1 ,0 ,0 ,3 ,0 ,3 ,1 ,4,46270 , 0 
44881.214,18,188 ,4 ,840 ,0 ,0 ,1 ,1 ,1 ,0 ,0 ,3 ,0 ,3 ,1 ,4,23564 , 0 
44881.236,4,188 ,8 ,512 ,0 ,0 ,1 ,0 ,2 ,0 ,0 ,3 ,0 ,2 ,2 ,4,21153 , 0 
44881.289,7,188 ,16 ,826 ,0 ,0 ,1 ,1 ,0 ,0 ,0 ,2 ,0 ,5 ,0 ,5,33878 , 0 
44881.337,14,188 ,1 ,256 ,0 ,0 ,3 ,0 ,0 ,0 ,0 ,3 ,0 ,5 ,0 ,5,21374 , 0 
44881.35,15,188 ,11 ,1181 ,0 ,0 ,2 ,2 ,0 ,0 ,0 ,4 ,0 ,4 ,0 ,4,25894 , 0 
44881.36,20,188 ,5 ,869 ,0 ,0 ,3 ,1 ,0 ,0 ,0 ,4 ,0 ,2 ,0 ,2,22516 , 0 
44881.36,16,188 ,2 ,512 ,0 ,0 ,1 ,1 ,1 ,0 ,0 ,3 ,0 ,5 ,1 ,6,47571 , 0 
44881.444,10,188 ,6 ,774 ,0 ,0 ,2 ,0 ,0 ,0 ,0 ,2 ,0 ,1 ,0 ,1,24230 , 0 
44881.482,12,188 ,18 ,1161 ,0 ,0 ,1 ,1 ,0 ,0 ,0 ,2 ,0 ,6 ,0 ,6,24845 , 0 
44881.596,9,188 ,5 ,869 ,0 ,0 ,3 ,1 ,0 ,0 ,0 ,4 ,0 ,5 ,0 ,5,42114 , 0 
44881.603,5,188 ,19 ,512 ,0 ,0 ,2 ,1 ,5 ,0 ,0 ,8 ,0 ,10 ,5 ,15,40734 , 0 
44881.607,19,188 ,1 ,256 ,0 ,0 ,3 ,0 ,6 ,0 ,0 ,9 ,0 ,4 ,6 ,10,25548 , 0 
44881.696,17,188 ,6 ,904 ,0 ,0 ,2 ,1 ,0 ,0 ,0 ,3 ,0 ,3 ,0 ,3,31352 , 0 
44881.771,13,188 ,1 ,256 ,0 ,0 ,2 ,0 ,0 ,0 ,0 ,2 ,0 ,7 ,0 ,7,23057 , 0 
44881.787,3,188 ,1 ,256 ,0 ,0 ,2 ,0 ,0 ,0 ,0 ,2 ,0 ,3 ,0 ,3,16023 , 0 
45000.96,8,188 ,1 ,256 ,0 ,0 ,2 ,0 ,2 ,0 ,0 ,4 ,0 ,1 ,2 ,3,18417 , 0 
45001.078,11,188 ,5 ,869 ,0 ,0 ,1 ,0 ,0 ,0 ,0 ,1 ,0 ,3 ,0 ,3,30267 , 0 
45001.123,2,188 ,1 ,256 ,0 ,0 ,1 ,0 ,4 ,0 ,0 ,5 ,0 ,4 ,4 ,8,32025 , 0 
45001.138,6,188 ,2 ,512 ,0 ,0 ,2 ,0 ,2 ,0 ,0 ,4 ,0 ,2 ,2 ,4,40097 , 0 
45001.214,18,188 ,4 ,825 ,0 ,0 ,1 ,1 ,0 ,0 ,0 ,2 ,0 ,2 ,0 ,2,25805 , 0 
45001.236,4,188 ,8 ,512 ,0 ,0 ,2 ,1 ,1 ,0 ,0 ,4 ,0 ,2 ,1 ,3,22582 , 0 
45001.289,7,188 ,16 ,809 ,0 ,0 ,3 ,2 ,0 ,0 ,0 ,5 ,0 ,5 ,0 ,5,34181 , 0 
45001.337,14,188 ,1 ,256 ,0 ,0 ,0 ,0 ,0 ,0 ,0 ,0 ,0 ,3 ,0 ,3,22020 , 0 
45001.35,15,188 ,11 ,1181 ,0 ,0 ,2 ,0 ,0 ,0 ,0 ,2 ,0 ,2 ,0 ,2,26997 , 0 
45001.36,20,188 ,5 ,869 ,0 ,0 ,2 ,0 ,0 ,0 ,0 ,2 ,0 ,1 ,0 ,1,24446 , 0 
45001.36,16,188 ,2 ,512 ,0 ,0 ,2 ,0 ,2 ,0 ,0 ,4 ,0 ,5 ,2 ,7,44960 , 0 
45001.444,10,188 ,6 ,877 ,0 ,0 ,1 ,1 ,0 ,0 ,0 ,2 ,0 ,1 ,0 ,1,23422 , 0 
45001.482,12,188 ,18 ,1161 ,0 ,0 ,2 ,0 ,0 ,0 ,0 ,2 ,0 ,1 ,0 ,1,26611 , 0 
45001.596,9,188 ,5 ,869 ,0 ,0 ,1 ,0 ,0 ,0 ,0 ,1 ,0 ,5 ,0 ,5,40841 , 0 
45001.603,5,188 ,19 ,512 ,0 ,0 ,1 ,0 ,0 ,0 ,0 ,1 ,0 ,2 ,0 ,2,41501 , 0 
45001.606,19,188 ,1 ,256 ,0 ,0 ,1 ,0 ,0 ,0 ,0 ,1 ,0 ,3 ,0 ,3,26678 , 0 
45001.696,17,188 ,6 ,877 ,0 ,0 ,2 ,1 ,0 ,0 ,0 ,3 ,0 ,4 ,0 ,4,31238 , 0 
45001.771,13,188 ,1 ,256 ,0 ,0 ,1 ,0 ,0 ,0 ,0 ,1 ,0 ,1 ,0 ,1,23177 , 0 
45001.787,3,188 ,1 ,256 ,0 ,0 ,1 ,0 ,0 ,0 ,0 ,1 ,0 ,1 ,0 ,1,16768 , 0 
45120.96,8,188 ,1 ,256 ,0 ,0 ,0 ,0 ,0 ,0 ,0 ,0 ,0 ,1 ,0 ,1,18365 , 0 
45121.078,11,188 ,5 ,869 ,0 ,0 ,2 ,0 ,0 ,0 ,0 ,2 ,0 ,3 ,0 ,3,29005 , 0 
45121.124,2,188 ,1 ,256 ,0 ,0 ,25 ,0 ,47 ,0 ,0 ,72 ,114 ,19 ,47 ,180,33774 , 0 
45121.214,18,188 ,4 ,825 ,0 ,0 ,1 ,0 ,0 ,0 ,0 ,1 ,0 ,1 ,0 ,1,23627 , 0 
45121.236,4,188 ,8 ,512 ,0 ,0 ,0 ,0 ,0 ,0 ,0 ,0 ,0 ,1 ,0 ,1,21223 , 0 
45121.27,6,188 ,2 ,512 ,0 ,120 ,1 ,16 ,0 ,0 ,0 ,137 ,0 ,78 ,0 ,78,47163 , 1 
45121.29,7,188 ,16 ,770 ,0 ,0 ,0 ,18 ,0 ,0 ,0 ,18 ,0 ,43 ,0 ,43,34111 , 0 
45121.338,14,188 ,1 ,256 ,0 ,0 ,1 ,0 ,0 ,0 ,0 ,1 ,0 ,34 ,0 ,34,21452 , 0 
45121.35,15,188 ,11 ,1181 ,0 ,0 ,2 ,0 ,0 ,0 ,0 ,2 ,0 ,1 ,0 ,1,25965 , 0 
45121.36,20,188 ,5 ,869 ,0 ,0 ,2 ,0 ,0 ,0 ,0 ,2 ,0 ,1 ,0 ,1,22601 , 0 
45121.361,16,188 ,2 ,512 ,0 ,0 ,25 ,14 ,18 ,0 ,0 ,57 ,116 ,41 ,18 ,175,48111 , 0 
45121.444,10,188 ,6 ,877 ,0 ,0 ,24 ,0 ,0 ,0 ,0 ,24 ,115 ,1 ,0 ,116,24495 , 0 
45121.482,12,188 ,18 ,1161 ,0 ,0 ,2 ,0 ,0 ,0 ,0 ,2 ,0 ,3 ,0 ,3,24942 , 0 
45121.596,9,188 ,5 ,869 ,0 ,0 ,2 ,0 ,0 ,0 ,0 ,2 ,0 ,22 ,0 ,22,42207 , 0 
45121.603,5,188 ,19 ,512 ,0 ,0 ,1 ,0 ,0 ,0 ,0 ,1 ,0 ,24 ,0 ,24,40838 , 0 
45121.607,19,188 ,1 ,256 ,0 ,0 ,1 ,0 ,0 ,0 ,0 ,1 ,0 ,22 ,0 ,22,25635 , 0 
45121.697,17,188 ,6 ,877 ,0 ,0 ,24 ,0 ,0 ,0 ,0 ,24 ,118 ,22 ,0 ,140,31625 , 0 
45121.771,13,188 ,1 ,256 ,0 ,0 ,1 ,0 ,0 ,0 ,0 ,1 ,0 ,21 ,0 ,21,23131 , 0 
45121.787,3,188 ,1 ,256 ,0 ,0 ,1 ,0 ,0 ,0 ,0 ,1 ,0 ,0 ,0 ,0,16099 , 0 
45240.96,8,188 ,1 ,256 ,0 ,0 ,2 ,0 ,3 ,0 ,0 ,5 ,0 ,0 ,3 ,3,18542 , 0 
45241.078,11,188 ,5 ,869 ,0 ,0 ,1 ,0 ,0 ,0 ,0 ,1 ,0 ,3 ,0 ,3,30355 , 0 
45241.124,2,188 ,1 ,256 ,0 ,0 ,26 ,0 ,48 ,0 ,0 ,74 ,109 ,23 ,48 ,180,32378 , 0 
45241.214,18,188 ,4 ,800 ,0 ,0 ,2 ,1 ,1 ,0 ,0 ,4 ,0 ,3 ,1 ,4,25895 , 0 
45241.236,4,188 ,8 ,512 ,0 ,0 ,2 ,1 ,2 ,0 ,0 ,5 ,0 ,2 ,2 ,4,22664 , 0 
45241.27,6,188 ,2 ,512 ,0 ,120 ,2 ,18 ,0 ,0 ,0 ,140 ,0 ,89 ,0 ,89,40996 , 1 
45241.29,7,188 ,16 ,818 ,0 ,0 ,2 ,15 ,0 ,0 ,0 ,17 ,0 ,46 ,0 ,46,34398 , 0 
45241.338,14,188 ,1 ,256 ,0 ,0 ,1 ,0 ,0 ,0 ,0 ,1 ,0 ,38 ,0 ,38,22142 , 0 
45241.35,15,188 ,11 ,1181 ,0 ,0 ,1 ,0 ,0 ,0 ,0 ,1 ,0 ,1 ,0 ,1,27063 , 0 
45241.36,20,188 ,5 ,869 ,0 ,0 ,1 ,0 ,0 ,0 ,0 ,1 ,0 ,1 ,0 ,1,24530 , 0 
45241.361,16,188 ,2 ,512 ,0 ,0 ,27 ,15 ,15 ,0 ,0 ,57 ,107 ,38 ,15 ,160,45487 , 0 
45241.444,10,188 ,6 ,787 ,0 ,0 ,26 ,0 ,0 ,0 ,0 ,26 ,104 ,1 ,0 ,105,23685 , 0 
45241.482,12,188 ,18 ,1122 ,0 ,0 ,2 ,1 ,0 ,0 ,0 ,3 ,0 ,2 ,0 ,2,26704 , 0 
45241.596,9,188 ,5 ,869 ,0 ,0 ,1 ,0 ,0 ,0 ,0 ,1 ,0 ,25 ,0 ,25,40949 , 0 
45241.603,5,188 ,19 ,512 ,0 ,0 ,1 ,0 ,0 ,0 ,0 ,1 ,0 ,25 ,0 ,25,41623 , 0 
45241.607,19,188 ,1 ,256 ,0 ,0 ,1 ,0 ,0 ,0 ,0 ,1 ,0 ,25 ,0 ,25,26815 , 0 
45241.697,17,188 ,6 ,829 ,0 ,0 ,27 ,0 ,0 ,0 ,0 ,27 ,110 ,25 ,0 ,135,31534 , 0 
45241.776,13,188 ,1 ,256 ,0 ,0 ,1 ,0 ,0 ,0 ,0 ,1 ,0 ,25 ,0 ,25,23343 , 0 
45241.787,3,188 ,1 ,256 ,0 ,0 ,1 ,0 ,0 ,0 ,0 ,1 ,0 ,0 ,0 ,0,16844 , 0 
45360.96,8,188 ,1 ,256 ,0 ,0 ,1 ,0 ,1 ,0 ,0 ,2 ,0 ,0 ,1 ,1,18447 , 0 
45361.078,11,188 ,5 ,869 ,0 ,0 ,1 ,0 ,0 ,0 ,0 ,1 ,0 ,2 ,0 ,2,29084 , 0 
45361.124,2,188 ,1 ,256 ,0 ,0 ,26 ,0 ,48 ,0 ,0 ,74 ,106 ,23 ,48 ,177,34145 , 0 
45361.214,18,188 ,4 ,793 ,0 ,0 ,1 ,1 ,0 ,0 ,0 ,2 ,0 ,3 ,0 ,3,23715 , 0 
45361.236,4,188 ,8 ,512 ,0 ,0 ,1 ,0 ,1 ,0 ,0 ,2 ,0 ,0 ,1 ,1,21313 , 0 
45361.274,6,188 ,2 ,512 ,0 ,120 ,1 ,14 ,0 ,0 ,0 ,135 ,0 ,89 ,0 ,89,48098 , 1 
45361.29,7,188 ,16 ,789 ,0 ,0 ,0 ,19 ,0 ,0 ,0 ,19 ,0 ,44 ,0 ,44,34367 , 0 
45361.338,14,188 ,1 ,256 ,0 ,0 ,1 ,0 ,0 ,0 ,0 ,1 ,0 ,43 ,0 ,43,21551 , 0 
45361.35,15,188 ,11 ,1181 ,0 ,0 ,2 ,0 ,0 ,0 ,0 ,2 ,0 ,0 ,0 ,0,26111 , 0 
45361.36,20,188 ,5 ,869 ,0 ,0 ,1 ,0 ,0 ,0 ,0 ,1 ,0 ,0 ,0 ,0,22699 , 0 
45361.361,16,188 ,2 ,512 ,0 ,0 ,26 ,15 ,19 ,0 ,0 ,60 ,107 ,37 ,19 ,163,48795 , 0 
45361.444,10,188 ,6 ,787 ,0 ,0 ,25 ,0 ,0 ,0 ,0 ,25 ,111 ,0 ,0 ,111,24761 , 0 
45361.482,12,188 ,18 ,1071 ,0 ,0 ,2 ,0 ,0 ,0 ,0 ,2 ,0 ,1 ,0 ,1,25004 , 0 
45361.596,9,188 ,5 ,869 ,0 ,0 ,1 ,0 ,0 ,0 ,0 ,1 ,0 ,24 ,0 ,24,42400 , 0 
45361.603,5,188 ,19 ,512 ,0 ,0 ,1 ,0 ,0 ,0 ,0 ,1 ,0 ,23 ,0 ,23,41010 , 0 
45361.607,19,188 ,1 ,256 ,0 ,0 ,1 ,0 ,0 ,0 ,0 ,1 ,0 ,24 ,0 ,24,25821 , 0 
45361.697,17,188 ,6 ,829 ,0 ,0 ,25 ,0 ,0 ,0 ,0 ,25 ,110 ,23 ,0 ,133,31944 , 0 
45361.771,13,188 ,1 ,256 ,0 ,0 ,0 ,0 ,0 ,0 ,0 ,0 ,0 ,23 ,0 ,23,23243 , 0 
45361.787,3,188 ,1 ,256 ,0 ,0 ,1 ,0 ,0 ,0 ,0 ,1 ,0 ,1 ,0 ,1,16156 , 0 
45480.96,8,188 ,1 ,256 ,0 ,0 ,0 ,0 ,1 ,0 ,0 ,1 ,0 ,1 ,1 ,2,18599 , 0 
45481.078,11,188 ,5 ,869 ,0 ,0 ,1 ,0 ,0 ,0 ,0 ,1 ,0 ,1 ,0 ,1,30416 , 0 
45481.124,2,188 ,1 ,256 ,0 ,0 ,5 ,0 ,13 ,0 ,0 ,18 ,1 ,5 ,13 ,19,32490 , 0 
45481.138,6,188 ,2 ,512 ,0 ,0 ,1 ,5 ,0 ,0 ,0 ,6 ,0 ,18 ,0 ,18,41113 , 0 
45481.214,18,188 ,4 ,793 ,0 ,0 ,1 ,0 ,1 ,0 ,0 ,2 ,0 ,0 ,1 ,1,25991 , 0 
45481.236,4,188 ,8 ,512 ,0 ,0 ,1 ,0 ,1 ,0 ,0 ,2 ,0 ,1 ,1 ,2,22725 , 0 
45481.289,7,188 ,16 ,776 ,0 ,0 ,1 ,5 ,0 ,0 ,0 ,6 ,0 ,11 ,0 ,11,34516 , 0 
45481.338,14,188 ,1 ,256 ,0 ,0 ,1 ,0 ,0 ,0 ,0 ,1 ,0 ,10 ,0 ,10,22220 , 0 
45481.35,15,188 ,11 ,1181 ,0 ,0 ,2 ,0 ,0 ,0 ,0 ,2 ,0 ,0 ,0 ,0,27127 , 0 
45481.36,20,188 ,5 ,869 ,0 ,0 ,0 ,0 ,0 ,0 ,0 ,0 ,0 ,1 ,0 ,1,24582 , 0 
45481.36,16,188 ,2 ,512 ,0 ,0 ,5 ,3 ,5 ,0 ,0 ,13 ,0 ,7 ,5 ,12,45638 , 0 
45481.444,10,188 ,6 ,787 ,0 ,0 ,6 ,0 ,0 ,0 ,0 ,6 ,0 ,0 ,0 ,0,23770 , 0 
45481.482,12,188 ,18 ,1071 ,0 ,0 ,1 ,1 ,0 ,0 ,0 ,2 ,0 ,2 ,0 ,2,26806 , 0 
45481.596,9,188 ,5 ,869 ,0 ,0 ,1 ,0 ,0 ,0 ,0 ,1 ,0 ,6 ,0 ,6,41049 , 0 
45481.603,5,188 ,19 ,512 ,0 ,0 ,1 ,0 ,0 ,0 ,0 ,1 ,0 ,7 ,0 ,7,41701 , 0 
45481.606,19,188 ,1 ,256 ,0 ,0 ,1 ,0 ,0 ,0 ,0 ,1 ,0 ,6 ,0 ,6,26880 , 0 
45481.696,17,188 ,6 ,819 ,0 ,0 ,5 ,0 ,0 ,0 ,0 ,5 ,0 ,5 ,0 ,5,31622 , 0 
45481.771,13,188 ,1 ,256 ,0 ,0 ,2 ,0 ,0 ,0 ,0 ,2 ,0 ,4 ,0 ,4,23415 , 0 
45481.787,3,188 ,1 ,256 ,0 ,0 ,1 ,0 ,0 ,0 ,0 ,1 ,0 ,1 ,0 ,1,16908 , 0 
45600.96,8,188 ,1 ,256 ,0 ,0 ,1 ,0 ,0 ,0 ,0 ,1 ,0 ,2 ,0 ,2,18516 , 0 
45601.078,11,188 ,5 ,869 ,0 ,0 ,2 ,0 ,0 ,0 ,0 ,2 ,0 ,5 ,0 ,5,29159 , 0 
45601.123,2,188 ,1 ,256 ,0 ,0 ,2 ,0 ,3 ,0 ,0 ,5 ,0 ,1 ,3 ,4,34221 , 0 
45601.138,6,188 ,2 ,512 ,0 ,0 ,0 ,1 ,0 ,0 ,0 ,1 ,0 ,5 ,0 ,5,48159 , 0 
45601.214,18,188 ,4 ,783 ,0 ,0 ,2 ,0 ,0 ,0 ,0 ,2 ,0 ,3 ,0 ,3,23798 , 0 
45601.236,4,188 ,8 ,512 ,0 ,0 ,1 ,0 ,0 ,0 ,0 ,1 ,0 ,1 ,0 ,1,21372 , 0 
45601.289,7,188 ,16 ,774 ,0 ,0 ,1 ,1 ,0 ,0 ,0 ,2 ,0 ,4 ,0 ,4,34434 , 0 
45601.337,14,188 ,1 ,256 ,0 ,0 ,1 ,0 ,0 ,0 ,0 ,1 ,0 ,5 ,0 ,5,21631 , 0 
45601.35,15,188 ,11 ,1147 ,0 ,0 ,0 ,0 ,0 ,0 ,0 ,0 ,0 ,3 ,0 ,3,26164 , 0 
45601.36,20,188 ,5 ,869 ,0 ,0 ,2 ,0 ,0 ,0 ,0 ,2 ,0 ,4 ,0 ,4,22775 , 0 
45601.36,16,188 ,2 ,512 ,0 ,0 ,2 ,1 ,1 ,0 ,0 ,4 ,0 ,3 ,1 ,4,48870 , 0 
45601.444,10,188 ,6 ,787 ,0 ,0 ,1 ,0 ,0 ,0 ,0 ,1 ,0 ,1 ,0 ,1,24819 , 0 
45601.482,12,188 ,18 ,1058 ,0 ,0 ,3 ,0 ,0 ,0 ,0 ,3 ,0 ,4 ,0 ,4,25079 , 0 
45601.596,9,188 ,5 ,869 ,0 ,0 ,2 ,0 ,0 ,0 ,0 ,2 ,0 ,2 ,0 ,2,42480 , 0 
45601.606,19,188 ,1 ,256 ,0 ,0 ,1 ,0 ,0 ,0 ,0 ,1 ,0 ,3 ,0 ,3,25915 , 0 
45601.696,17,188 ,6 ,819 ,0 ,0 ,2 ,0 ,0 ,0 ,0 ,2 ,0 ,1 ,0 ,1,32006 , 0 
45601.726,5,188 ,19 ,512 ,0 ,0 ,0 ,0 ,1 ,0 ,0 ,1 ,0 ,6 ,1 ,7,41111 , 0 
45601.771,13,188 ,1 ,256 ,0 ,0 ,1 ,0 ,0 ,0 ,0 ,1 ,0 ,1 ,0 ,1,23309 , 0 
45601.787,3,188 ,1 ,256 ,0 ,0 ,2 ,0 ,0 ,0 ,0 ,2 ,0 ,0 ,0 ,0,16225 , 0 
45720.96,8,188 ,1 ,256 ,0 ,0 ,1 ,0 ,0 ,0 ,0 ,1 ,0 ,0 ,0 ,0,18659 , 0 
45721.078,11,188 ,5 ,869 ,0 ,0 ,1 ,0 ,1 ,0 ,0 ,2 ,0 ,1 ,1 ,2,30486 , 0 
45721.123,2,188 ,1 ,256 ,0 ,0 ,1 ,0 ,0 ,0 ,0 ,1 ,0 ,2 ,0 ,2,32593 , 0 
45721.138,6,188 ,2 ,512 ,0 ,0 ,2 ,0 ,0 ,0 ,0 ,2 ,0 ,1 ,0 ,1,41211 , 0 
45721.214,18,188 ,4 ,783 ,0 ,0 ,0 ,0 ,0 ,0 ,0 ,0 ,0 ,0 ,0 ,0,26052 , 0 
45721.236,4,188 ,8 ,512 ,0 ,0 ,1 ,0 ,0 ,0 ,0 ,1 ,0 ,1 ,0 ,1,22813 , 0 
45721.289,7,188 ,16 ,774 ,0 ,0 ,1 ,0 ,0 ,0 ,0 ,1 ,0 ,1 ,0 ,1,34588 , 0 
45721.337,14,188 ,1 ,256 ,0 ,0 ,1 ,0 ,0 ,0 ,0 ,1 ,0 ,0 ,0 ,0,22296 , 0 
45721.35,15,188 ,11 ,1147 ,0 ,0 ,1 ,1 ,0 ,0 ,0 ,2 ,0 ,0 ,0 ,0,27192 , 0 
45721.36,20,188 ,5 ,869 ,0 ,0 ,2 ,0 ,0 ,0 ,0 ,2 ,0 ,0 ,0 ,0,24668 , 0 
45721.36,16,188 ,2 ,512 ,0 ,0 ,1 ,0 ,0 ,0 ,0 ,1 ,0 ,2 ,0 ,2,45758 , 0 
45721.444,10,188 ,6 ,787 ,0 ,0 ,1 ,0 ,0 ,0 ,0 ,1 ,0 ,0 ,0 ,0,23845 , 0 
45721.482,12,188 ,18 ,1058 ,0 ,0 ,0 ,0 ,0 ,0 ,0 ,0 ,0 ,0 ,0 ,0,26870 , 0 
45721.596,9,188 ,5 ,869 ,0 ,0 ,1 ,0 ,0 ,0 ,0 ,1 ,0 ,2 ,0 ,2,41124 , 0 
45721.603,5,188 ,19 ,512 ,0 ,0 ,1 ,0 ,0 ,0 ,0 ,1 ,0 ,1 ,0 ,1,41805 , 0 
45721.606,19,188 ,1 ,256 ,0 ,0 ,1 ,0 ,1 ,0 ,0 ,2 ,0 ,2 ,1 ,3,26968 , 0 
45721.696,17,188 ,6 ,819 ,0 ,0 ,1 ,0 ,0 ,0 ,0 ,1 ,0 ,2 ,0 ,2,31715 , 0 
45721.771,13,188 ,1 ,256 ,0 ,0 ,2 ,0 ,0 ,0 ,0 ,2 ,0 ,3 ,0 ,3,23510 , 0 
45721.787,3,188 ,1 ,256 ,0 ,0 ,1 ,0 ,0 ,0 ,0 ,1 ,0 ,0 ,0 ,0,16958 , 0 
45840.96,8,188 ,1 ,256 ,0 ,0 ,2 ,0 ,1 ,0 ,0 ,3 ,0 ,1 ,1 ,2,18580 , 0 
45841.078,11,188 ,5 ,869 ,0 ,0 ,1 ,0 ,0 ,0 ,0 ,1 ,0 ,2 ,0 ,2,29226 , 0 
45841.124,2,188 ,1 ,256 ,0 ,0 ,2 ,0 ,7 ,0 ,1 ,10 ,0 ,3 ,8 ,11,34302 , 0 
45841.138,6,188 ,2 ,512 ,0 ,0 ,2 ,2 ,3 ,0 ,0 ,7 ,0 ,7 ,3 ,10,48268 , 0 
45841.214,18,188 ,4 ,783 ,0 ,0 ,1 ,0 ,1 ,0 ,0 ,2 ,0 ,2 ,1 ,3,23866 , 0 
45841.236,4,188 ,8 ,512 ,0 ,0 ,0 ,0 ,1 ,0 ,0 ,1 ,0 ,1 ,1 ,2,21439 , 0 
45841.289,7,188 ,9 ,1206 ,0 ,0 ,3 ,2 ,0 ,1 ,0 ,6 ,0 ,7 ,0 ,7,34551 , 0 
45841.337,14,188 ,1 ,256 ,0 ,0 ,1 ,0 ,0 ,0 ,0 ,1 ,0 ,4 ,0 ,4,21711 , 0 
45841.35,15,188 ,11 ,1147 ,0 ,0 ,1 ,0 ,0 ,0 ,0 ,1 ,0 ,5 ,0 ,5,26253 , 0 
45841.36,20,188 ,5 ,869 ,0 ,0 ,1 ,0 ,0 ,0 ,0 ,1 ,0 ,0 ,0 ,0,22828 , 0 
45841.361,16,188 ,2 ,512 ,0 ,0 ,2 ,2 ,0 ,0 ,1 ,5 ,0 ,11 ,1 ,12,48959 , 1 
45841.444,10,188 ,6 ,793 ,0 ,0 ,2 ,1 ,0 ,0 ,0 ,3 ,0 ,2 ,0 ,2,24884 , 0 
45841.482,12,188 ,18 ,1054 ,0 ,0 ,1 ,1 ,0 ,0 ,0 ,2 ,0 ,3 ,0 ,3,25165 , 0 
45841.596,9,188 ,5 ,869 ,0 ,0 ,3 ,0 ,2 ,0 ,0 ,5 ,0 ,5 ,2 ,7,42607 , 0 
45841.602,5,188 ,19 ,512 ,0 ,0 ,1 ,0 ,2 ,0 ,0 ,3 ,0 ,4 ,2 ,6,41209 , 0 
45841.606,19,188 ,1 ,256 ,0 ,0 ,1 ,0 ,2 ,0 ,0 ,3 ,0 ,4 ,2 ,6,25982 , 0 
45841.696,17,188 ,6 ,793 ,0 ,0 ,3 ,2 ,0 ,0 ,0 ,5 ,0 ,5 ,0 ,5,32088 , 0 
45841.771,13,188 ,1 ,256 ,0 ,0 ,0 ,0 ,0 ,0 ,0 ,0 ,0 ,3 ,0 ,3,23380 , 0 
45841.787,3,188 ,1 ,256 ,0 ,0 ,1 ,0 ,0 ,0 ,0 ,1 ,0 ,2 ,0 ,2,16289 , 0 
45960.96,8,188 ,1 ,256 ,0 ,0 ,2 ,0 ,0 ,1 ,2 ,5 ,0 ,1 ,3 ,4,18745 , 0 
45961.078,11,188 ,5 ,869 ,0 ,0 ,1 ,0 ,0 ,0 ,0 ,1 ,0 ,8 ,0 ,8,30559 , 0 
45961.124,2,188 ,1 ,256 ,0 ,0 ,4 ,0 ,11 ,2 ,1 ,18 ,0 ,4 ,14 ,18,32737 , 0 
45961.138,6,188 ,2 ,512 ,0 ,0 ,4 ,3 ,5 ,1 ,1 ,14 ,0 ,9 ,6 ,15,41354 , 0 
45961.214,18,188 ,19 ,512 ,0 ,0 ,4 ,1 ,0 ,2 ,1 ,8 ,0 ,6 ,1 ,7,26153 , 0 
45961.236,4,188 ,8 ,512 ,0 ,0 ,3 ,0 ,0 ,1 ,2 ,6 ,0 ,4 ,2 ,6,22903 , 0 
45961.289,7,188 ,9 ,1170 ,0 ,0 ,6 ,3 ,0 ,0 ,0 ,9 ,0 ,8 ,0 ,8,34697 , 0 
45961.337,14,188 ,1 ,256 ,0 ,0 ,1 ,0 ,1 ,0 ,0 ,2 ,0 ,6 ,1 ,7,22380 , 0 
45961.35,15,188 ,11 ,1147 ,0 ,0 ,1 ,0 ,0 ,0 ,0 ,1 ,0 ,8 ,0 ,8,27270 , 0 
45961.36,20,188 ,5 ,869 ,0 ,0 ,1 ,0 ,0 ,0 ,0 ,1 ,0 ,6 ,0 ,6,24737 , 0 
45961.361,16,188 ,2 ,512 ,0 ,0 ,1 ,3 ,0 ,1 ,0 ,5 ,0 ,19 ,0 ,19,45875 , 1 
45961.444,10,188 ,14 ,512 ,0 ,0 ,5 ,2 ,0 ,1 ,0 ,8 ,0 ,3 ,0 ,3,23941 , 0 
45961.482,12,188 ,5 ,798 ,0 ,0 ,5 ,1 ,0 ,1 ,0 ,7 ,0 ,4 ,0 ,4,26979 , 0 
45961.596,9,188 ,5 ,869 ,0 ,0 ,4 ,0 ,3 ,0 ,0 ,7 ,0 ,5 ,3 ,8,41245 , 0 
45961.603,5,188 ,19 ,512 ,0 ,0 ,1 ,0 ,4 ,0 ,0 ,5 ,0 ,14 ,4 ,18,41943 , 0 
45961.606,19,188 ,1 ,256 ,0 ,0 ,0 ,0 ,5 ,0 ,0 ,5 ,0 ,8 ,6 ,14,27053 , 0 
45961.697,17,188 ,6 ,772 ,0 ,0 ,5 ,4 ,0 ,0 ,0 ,9 ,0 ,10 ,0 ,10,31833 , 0 
45961.771,13,188 ,1 ,256 ,0 ,0 ,1 ,0 ,0 ,0 ,0 ,1 ,0 ,3 ,0 ,3,23575 , 0 
45961.787,3,188 ,1 ,256 ,0 ,0 ,1 ,0 ,0 ,0 ,0 ,1 ,0 ,1 ,0 ,1,17016 , 0 
46080.96,8,188 ,1 ,256 ,0 ,0 ,1 ,0 ,1 ,1 ,0 ,3 ,0 ,1 ,2 ,3,18676 , 0 
46081.078,11,188 ,5 ,869 ,0 ,0 ,1 ,0 ,0 ,0 ,0 ,1 ,0 ,3 ,0 ,3,29290 , 0 
46081.123,2,188 ,1 ,256 ,0 ,0 ,2 ,0 ,3 ,0 ,0 ,5 ,0 ,2 ,3 ,5,34402 , 0 
46081.138,6,188 ,2 ,512 ,0 ,0 ,2 ,1 ,1 ,0 ,0 ,4 ,0 ,4 ,1 ,5,48374 , 0 
46081.214,18,188 ,19 ,512 ,0 ,0 ,3 ,0 ,0 ,0 ,0 ,3 ,0 ,3 ,0 ,3,23949 , 0 
46081.236,4,188 ,8 ,512 ,0 ,0 ,1 ,1 ,0 ,1 ,0 ,3 ,0 ,3 ,0 ,3,21531 , 0 
46081.289,7,188 ,9 ,1165 ,0 ,0 ,4 ,1 ,0 ,0 ,0 ,5 ,0 ,3 ,0 ,3,34641 , 0 
46081.337,14,188 ,1 ,256 ,0 ,0 ,1 ,0 ,0 ,0 ,0 ,1 ,0 ,3 ,0 ,3,21772 , 0 
46081.35,15,188 ,11 ,1147 ,0 ,0 ,1 ,0 ,0 ,0 ,0 ,1 ,0 ,6 ,0 ,6,26318 , 0 
46081.36,20,188 ,5 ,869 ,0 ,0 ,1 ,0 ,0 ,0 ,0 ,1 ,0 ,1 ,0 ,1,22903 , 0 
46081.36,16,188 ,2 ,512 ,0 ,0 ,0 ,1 ,0 ,0 ,0 ,1 ,0 ,8 ,0 ,8,49034 , 1 
46081.444,10,188 ,14 ,512 ,0 ,0 ,2 ,0 ,0 ,0 ,0 ,2 ,0 ,1 ,0 ,1,24949 , 0 
46081.482,12,188 ,5 ,798 ,0 ,0 ,3 ,0 ,0 ,0 ,0 ,3 ,0 ,3 ,0 ,3,25240 , 0 
46081.596,9,188 ,5 ,869 ,0 ,0 ,2 ,0 ,0 ,0 ,0 ,2 ,0 ,4 ,0 ,4,42686 , 0 
46081.603,5,188 ,19 ,512 ,0 ,0 ,1 ,0 ,0 ,0 ,0 ,1 ,0 ,5 ,0 ,5,41318 , 0 
46081.606,19,188 ,1 ,256 ,0 ,0 ,2 ,0 ,0 ,0 ,0 ,2 ,0 ,4 ,0 ,4,26089 , 0 
46081.696,17,188 ,6 ,771 ,0 ,0 ,1 ,1 ,0 ,0 ,0 ,2 ,0 ,4 ,0 ,4,32169 , 0 
46081.771,13,188 ,1 ,256 ,0 ,0 ,1 ,0 ,0 ,0 ,0 ,1 ,0 ,3 ,0 ,3,23467 , 0 
46081.787,3,188 ,1 ,256 ,0 ,0 ,1 ,0 ,0 ,0 ,0 ,1 ,0 ,1 ,0 ,1,16351 , 0 
46200.96,8,188 ,1 ,256 ,0 ,0 ,1 ,0 ,0 ,0 ,0 ,1 ,0 ,2 ,0 ,2,18806 , 0 
46201.078,11,188 ,5 ,869 ,0 ,0 ,1 ,0 ,0 ,0 ,0 ,1 ,0 ,2 ,0 ,2,30628 , 0 
46201.13,2,188 ,1 ,256 ,0 ,0 ,2 ,0 ,0 ,0 ,0 ,2 ,0 ,3 ,0 ,3,32827 , 0 
46201.138,6,188 ,2 ,512 ,0 ,0 ,1 ,0 ,0 ,0 ,0 ,1 ,0 ,1 ,0 ,1,41414 , 0 
46201.214,18,188 ,19 ,512 ,0 ,0 ,2 ,0 ,0 ,0 ,0 ,2 ,0 ,2 ,0 ,2,26224 , 0 
46201.236,4,188 ,8 ,512 ,0 ,0 ,1 ,0 ,0 ,0 ,0 ,1 ,0 ,1 ,0 ,1,22970 , 0 
46201.289,7,188 ,9 ,1165 ,0 ,0 ,2 ,0 ,0 ,0 ,0 ,2 ,0 ,1 ,0 ,1,34781 , 0 
46201.337,14,188 ,1 ,256 ,0 ,0 ,2 ,0 ,0 ,0 ,0 ,2 ,0 ,5 ,0 ,5,22474 , 0 
46201.35,15,188 ,11 ,1147 ,0 ,0 ,1 ,0 ,0 ,0 ,0 ,1 ,0 ,1 ,0 ,1,27334 , 0 
46201.36,20,188 ,5 ,869 ,0 ,0 ,1 ,0 ,0 ,0 ,0 ,1 ,0 ,1 ,0 ,1,24791 , 0 
46201.36,16,188 ,2 ,512 ,0 ,0 ,2 ,0 ,0 ,0 ,0 ,2 ,0 ,3 ,0 ,3,45956 , 0 
46201.444,10,188 ,14 ,512 ,0 ,0 ,3 ,0 ,0 ,0 ,0 ,3 ,0 ,1 ,0 ,1,24021 , 0 
46201.482,12,188 ,5 ,798 ,0 ,0 ,2 ,0 ,0 ,0 ,0 ,2 ,0 ,3 ,0 ,3,27061 , 0 
46201.596,9,188 ,5 ,869 ,0 ,0 ,1 ,0 ,1 ,0 ,0 ,2 ,0 ,3 ,1 ,4,41332 , 0 
46201.603,5,188 ,19 ,512 ,0 ,0 ,2 ,0 ,1 ,0 ,0 ,3 ,0 ,3 ,1 ,4,42036 , 0 
46201.606,19,188 ,1 ,256 ,0 ,0 ,1 ,0 ,1 ,0 ,0 ,2 ,0 ,2 ,1 ,3,27125 , 0 
46201.696,17,188 ,6 ,771 ,0 ,0 ,1 ,0 ,0 ,0 ,0 ,1 ,0 ,2 ,0 ,2,31899 , 0 
46201.771,13,188 ,1 ,256 ,0 ,0 ,1 ,0 ,0 ,0 ,0 ,1 ,0 ,0 ,0 ,0,23648 , 0 
46201.787,3,188 ,1 ,256 ,0 ,0 ,1 ,0 ,0 ,0 ,0 ,1 ,0 ,1 ,0 ,1,17084 , 0 
46320.96,8,188 ,1 ,256 ,0 ,0 ,1 ,0 ,0 ,0 ,0 ,1 ,0 ,0 ,0 ,0,18737 , 0 
46321.078,11,188 ,5 ,869 ,0 ,0 ,2 ,0 ,1 ,0 ,0 ,3 ,0 ,5 ,1 ,6,29376 , 0 
46321.123,2,188 ,1 ,256 ,0 ,0 ,2 ,0 ,4 ,0 ,0 ,6 ,0 ,1 ,4 ,5,34494 , 0 
46321.138,6,188 ,2 ,512 ,0 ,0 ,2 ,1 ,1 ,0 ,0 ,4 ,0 ,3 ,1 ,4,48464 , 0 
46321.214,18,188 ,19 ,512 ,0 ,0 ,2 ,0 ,0 ,0 ,0 ,2 ,0 ,2 ,0 ,2,24030 , 0 
46321.236,4,188 ,8 ,512 ,0 ,0 ,1 ,0 ,0 ,0 ,0 ,1 ,0 ,1 ,0 ,1,21586 , 0 
46321.289,7,188 ,16 ,783 ,0 ,0 ,5 ,2 ,0 ,1 ,0 ,8 ,0 ,2 ,0 ,2,34734 , 0 
46321.337,14,188 ,1 ,256 ,0 ,0 ,1 ,0 ,0 ,0 ,0 ,1 ,0 ,1 ,0 ,1,21839 , 0 
46321.35,15,188 ,11 ,1136 ,0 ,0 ,1 ,1 ,0 ,0 ,0 ,2 ,0 ,6 ,0 ,6,26393 , 0 
46321.36,20,188 ,5 ,777 ,0 ,0 ,2 ,1 ,0 ,0 ,0 ,3 ,0 ,5 ,0 ,5,22997 , 0 
46321.36,16,188 ,2 ,512 ,0 ,0 ,2 ,1 ,1 ,0 ,0 ,4 ,0 ,8 ,1 ,9,49122 , 0 
46321.444,10,188 ,14 ,512 ,0 ,0 ,0 ,0 ,0 ,0 ,0 ,0 ,0 ,1 ,0 ,1,25000 , 0 
46321.482,12,188 ,5 ,798 ,0 ,0 ,2 ,0 ,0 ,0 ,0 ,2 ,0 ,3 ,0 ,3,25323 , 0 
46321.596,9,188 ,5 ,869 ,0 ,0 ,2 ,0 ,1 ,0 ,1 ,4 ,0 ,5 ,2 ,7,42785 , 0 
46321.603,5,188 ,19 ,512 ,0 ,0 ,1 ,0 ,3 ,0 ,1 ,5 ,0 ,5 ,4 ,9,41497 , 0 
46321.606,19,188 ,1 ,256 ,0 ,0 ,0 ,0 ,3 ,0 ,1 ,4 ,0 ,3 ,4 ,7,26182 , 0 
46321.696,17,188 ,6 ,768 ,0 ,0 ,1 ,1 ,0 ,0 ,0 ,2 ,0 ,7 ,0 ,7,32242 , 0 
46321.771,13,188 ,1 ,256 ,0 ,0 ,1 ,0 ,0 ,0 ,0 ,1 ,0 ,2 ,0 ,2,23545 , 0 
46321.787,3,188 ,1 ,256 ,0 ,0 ,1 ,0 ,0 ,0 ,0 ,1 ,0 ,0 ,0 ,0,16400 , 0 
46440.96,8,188 ,1 ,256 ,0 ,0 ,1 ,0 ,0 ,0 ,0 ,1 ,0 ,2 ,0 ,2,18879 , 0 
46441.078,11,188 ,5 ,869 ,0 ,0 ,0 ,0 ,0 ,0 ,0 ,0 ,0 ,1 ,0 ,1,30683 , 0 
46441.123,2,188 ,1 ,256 ,0 ,0 ,2 ,0 ,1 ,0 ,0 ,3 ,0 ,2 ,1 ,3,32915 , 0 
46441.138,6,188 ,2 ,512 ,0 ,0 ,1 ,1 ,0 ,0 ,0 ,2 ,0 ,4 ,0 ,4,41488 , 0 
46441.214,18,188 ,19 ,512 ,0 ,0 ,3 ,0 ,0 ,0 ,0 ,3 ,0 ,1 ,0 ,1,26293 , 0 
46441.236,4,188 ,8 ,512 ,0 ,0 ,1 ,0 ,0 ,0 ,0 ,1 ,0 ,3 ,0 ,3,23035 , 0 
46441.289,7,188 ,16 ,783 ,0 ,0 ,3 ,0 ,0 ,0 ,0 ,3 ,0 ,4 ,0 ,4,34859 , 0 
46441.337,14,188 ,1 ,256 ,0 ,0 ,1 ,0 ,0 ,0 ,0 ,1 ,0 ,3 ,0 ,3,22542 , 0 
46441.35,15,188 ,11 ,1136 ,0 ,0 ,2 ,0 ,0 ,0 ,0 ,2 ,0 ,1 ,0 ,1,27403 , 0 
46441.36,20,188 ,5 ,777 ,0 ,0 ,1 ,0 ,0 ,0 ,0 ,1 ,0 ,0 ,0 ,0,24858 , 0 
46441.36,16,188 ,2 ,512 ,0 ,0 ,1 ,0 ,0 ,0 ,0 ,1 ,0 ,4 ,0 ,4,46023 , 0 
46441.444,10,188 ,14 ,512 ,0 ,0 ,3 ,0 ,0 ,0 ,0 ,3 ,0 ,0 ,0 ,0,24086 , 0 
46441.482,12,188 ,5 ,798 ,0 ,0 ,1 ,0 ,0 ,0 ,0 ,1 ,0 ,3 ,0 ,3,27129 , 0 
46441.596,9,188 ,5 ,869 ,0 ,0 ,1 ,0 ,0 ,1 ,0 ,2 ,0 ,3 ,0 ,3,41403 , 0 
46441.602,5,188 ,19 ,512 ,0 ,0 ,1 ,0 ,0 ,1 ,0 ,2 ,0 ,2 ,1 ,3,42125 , 0 
46441.606,19,188 ,1 ,256 ,0 ,0 ,1 ,0 ,0 ,1 ,0 ,2 ,0 ,2 ,1 ,3,27223 , 0 
46441.696,17,188 ,6 ,768 ,0 ,0 ,2 ,0 ,0 ,0 ,0 ,2 ,0 ,3 ,0 ,3,31995 , 0 
46441.771,13,188 ,1 ,256 ,0 ,0 ,2 ,0 ,0 ,0 ,0 ,2 ,0 ,1 ,0 ,1,23759 , 0 
46441.787,3,188 ,1 ,256 ,0 ,0 ,1 ,0 ,0 ,0 ,0 ,1 ,0 ,0 ,0 ,0,17149 , 0 
46560.96,8,188 ,1 ,256 ,0 ,0 ,1 ,0 ,0 ,0 ,0 ,1 ,0 ,1 ,0 ,1,18802 , 0 
46561.078,11,188 ,5 ,774 ,0 ,0 ,1 ,1 ,0 ,0 ,0 ,2 ,0 ,10 ,0 ,10,29468 , 0 
46561.123,2,188 ,1 ,256 ,0 ,0 ,1 ,0 ,1 ,1 ,1 ,4 ,0 ,4 ,3 ,7,34594 , 0 
46561.138,6,188 ,2 ,512 ,0 ,0 ,1 ,0 ,1 ,0 ,0 ,2 ,0 ,9 ,1 ,10,48546 , 0 
46561.214,18,188 ,19 ,512 ,0 ,0 ,0 ,0 ,0 ,0 ,0 ,0 ,0 ,1 ,0 ,1,24094 , 0 
46561.236,4,188 ,8 ,512 ,0 ,0 ,1 ,0 ,0 ,0 ,0 ,1 ,0 ,1 ,0 ,1,21677 , 0 
46561.29,7,188 ,9 ,1177 ,0 ,0 ,6 ,4 ,0 ,1 ,0 ,11 ,0 ,12 ,0 ,12,34858 , 0 
46561.337,14,188 ,1 ,256 ,0 ,0 ,1 ,0 ,0 ,0 ,0 ,1 ,0 ,1 ,0 ,1,21961 , 0 
46561.35,15,188 ,11 ,1136 ,0 ,0 ,5 ,0 ,0 ,0 ,0 ,5 ,0 ,10 ,0 ,10,26510 , 0 
46561.36,20,188 ,5 ,777 ,0 ,0 ,1 ,0 ,0 ,0 ,0 ,1 ,0 ,0 ,0 ,0,23061 , 0 
46561.361,16,188 ,2 ,512 ,0 ,0 ,5 ,0 ,0 ,1 ,1 ,7 ,0 ,12 ,1 ,13,49249 , 1 
46561.444,10,188 ,14 ,512 ,0 ,0 ,1 ,0 ,0 ,0 ,0 ,1 ,0 ,0 ,0 ,0,25082 , 0 
46561.482,12,188 ,5 ,798 ,0 ,0 ,1 ,0 ,0 ,0 ,0 ,1 ,0 ,0 ,0 ,0,25401 , 0 
46561.596,9,188 ,5 ,869 ,0 ,0 ,5 ,0 ,4 ,0 ,0 ,9 ,0 ,12 ,4 ,16,43002 , 0 
46561.603,5,188 ,19 ,512 ,0 ,0 ,1 ,0 ,5 ,0 ,0 ,6 ,0 ,4 ,5 ,9,41641 , 0 
46561.606,19,188 ,1 ,256 ,0 ,0 ,1 ,0 ,5 ,0 ,0 ,6 ,0 ,1 ,5 ,6,26288 , 0 
46561.696,17,188 ,6 ,768 ,0 ,0 ,5 ,1 ,0 ,0 ,0 ,6 ,0 ,9 ,0 ,9,32337 , 0 
46561.771,13,188 ,1 ,256 ,0 ,0 ,1 ,0 ,0 ,0 ,0 ,1 ,0 ,0 ,0 ,0,23625 , 0 
46561.787,3,188 ,1 ,256 ,0 ,0 ,1 ,0 ,0 ,0 ,0 ,1 ,0 ,2 ,0 ,2,16467 , 0 
46680.96,8,188 ,1 ,256 ,0 ,0 ,1 ,0 ,0 ,0 ,0 ,1 ,0 ,2 ,0 ,2,18942 , 0 
46681.078,11,188 ,5 ,774 ,0 ,0 ,1 ,0 ,0 ,0 ,0 ,1 ,0 ,3 ,0 ,3,30755 , 0 
46681.123,2,188 ,1 ,256 ,0 ,0 ,1 ,0 ,0 ,0 ,0 ,1 ,0 ,3 ,0 ,3,32997 , 0 
46681.138,6,188 ,2 ,512 ,0 ,0 ,1 ,0 ,0 ,0 ,0 ,1 ,0 ,5 ,0 ,5,41571 , 0 
46681.214,18,188 ,19 ,512 ,0 ,0 ,2 ,0 ,0 ,0 ,0 ,2 ,0 ,3 ,0 ,3,26374 , 0 
46681.236,4,188 ,8 ,512 ,0 ,0 ,2 ,0 ,0 ,0 ,0 ,2 ,0 ,0 ,0 ,0,23105 , 0 
46681.289,7,188 ,9 ,1224 ,0 ,0 ,2 ,2 ,0 ,0 ,0 ,4 ,0 ,9 ,0 ,9,34936 , 0 
46681.337,14,188 ,1 ,256 ,0 ,0 ,1 ,0 ,0 ,0 ,0 ,1 ,0 ,2 ,0 ,2,22615 , 0 
46681.35,15,188 ,11 ,1136 ,0 ,0 ,2 ,0 ,0 ,0 ,0 ,2 ,0 ,3 ,0 ,3,27477 , 0 
46681.36,20,188 ,5 ,777 ,0 ,0 ,1 ,0 ,0 ,0 ,0 ,1 ,0 ,1 ,0 ,1,24932 , 0 
46681.36,16,188 ,2 ,512 ,0 ,0 ,3 ,0 ,0 ,0 ,0 ,3 ,0 ,5 ,0 ,5,46118 , 1 
46681.444,10,188 ,14 ,512 ,0 ,0 ,2 ,0 ,0 ,0 ,0 ,2 ,0 ,0 ,0 ,0,24145 , 0 
46681.482,12,188 ,5 ,798 ,0 ,0 ,0 ,0 ,0 ,0 ,0 ,0 ,0 ,2 ,0 ,2,27193 , 0 
46681.596,9,188 ,5 ,869 ,0 ,0 ,3 ,0 ,2 ,0 ,0 ,5 ,0 ,4 ,2 ,6,41492 , 0 
46681.603,5,188 ,19 ,512 ,0 ,0 ,1 ,0 ,2 ,0 ,0 ,3 ,0 ,4 ,2 ,6,42254 , 0 
46681.606,19,188 ,1 ,256 ,0 ,0 ,2 ,0 ,2 ,0 ,0 ,4 ,0 ,5 ,2 ,7,27324 , 0 
46681.696,17,188 ,6 ,768 ,0 ,0 ,2 ,0 ,0 ,0 ,0 ,2 ,0 ,5 ,0 ,5,32071 , 0 
46681.771,13,188 ,1 ,256 ,0 ,0 ,2 ,0 ,0 ,0 ,0 ,2 ,0 ,2 ,0 ,2,23827 , 0 
46681.787,3,188 ,1 ,256 ,0 ,0 ,1 ,0 ,0 ,0 ,0 ,1 ,0 ,0 ,0 ,0,17199 , 0 
46800.96,8,188 ,1 ,256 ,0 ,0 ,1 ,0 ,0 ,0 ,0 ,1 ,0 ,0 ,0 ,0,18858 , 0 
46801.078,11,188 ,5 ,774 ,0 ,0 ,1 ,0 ,0 ,0 ,0 ,1 ,0 ,3 ,0 ,3,29525 , 0 
46801.123,2,188 ,1 ,256 ,0 ,0 ,1 ,0 ,0 ,0 ,0 ,1 ,0 ,1 ,0 ,1,34666 , 0 
46801.138,6,188 ,2 ,512 ,0 ,0 ,1 ,0 ,0 ,0 ,0 ,1 ,0 ,2 ,0 ,2,48612 , 0 
46801.214,18,188 ,19 ,512 ,0 ,0 ,0 ,0 ,0 ,0 ,0 ,0 ,0 ,1 ,0 ,1,24147 , 0 
46801.236,4,188 ,8 ,512 ,0 ,0 ,1 ,0 ,0 ,0 ,0 ,1 ,0 ,0 ,0 ,0,21735 , 0 
46801.289,7,188 ,9 ,1224 ,0 ,0 ,2 ,0 ,0 ,0 ,0 ,2 ,0 ,3 ,0 ,3,34954 , 0 
46801.337,14,188 ,1 ,256 ,0 ,0 ,1 ,0 ,0 ,0 ,0 ,1 ,0 ,1 ,0 ,1,22015 , 0 
46801.35,15,188 ,11 ,1136 ,0 ,0 ,1 ,0 ,0 ,0 ,0 ,1 ,0 ,2 ,0 ,2,26580 , 0 
46801.36,20,188 ,5 ,777 ,0 ,0 ,0 ,0 ,0 ,0 ,0 ,0 ,0 ,2 ,0 ,2,23128 , 0 
46801.36,16,188 ,2 ,512 ,0 ,0 ,1 ,0 ,0 ,0 ,0 ,1 ,0 ,3 ,0 ,3,49318 , 1 
46801.444,10,188 ,14 ,512 ,0 ,0 ,1 ,0 ,0 ,0 ,0 ,1 ,0 ,1 ,0 ,1,25133 , 0 
46801.482,12,188 ,5 ,798 ,0 ,0 ,2 ,0 ,0 ,0 ,0 ,2 ,0 ,0 ,0 ,0,25471 , 0 
46801.596,9,188 ,5 ,869 ,0 ,0 ,1 ,0 ,0 ,0 ,0 ,1 ,0 ,3 ,0 ,3,43070 , 0 
46801.603,5,188 ,19 ,512 ,0 ,0 ,1 ,0 ,0 ,0 ,0 ,1 ,0 ,2 ,0 ,2,41706 , 0 
46801.606,19,188 ,1 ,256 ,0 ,0 ,1 ,0 ,0 ,0 ,0 ,1 ,0 ,1 ,0 ,1,26354 , 0 
46801.696,17,188 ,6 ,768 ,0 ,0 ,2 ,0 ,0 ,0 ,0 ,2 ,0 ,1 ,0 ,1,32403 , 0 
46801.771,13,188 ,1 ,256 ,0 ,0 ,0 ,0 ,0 ,0 ,0 ,0 ,0 ,1 ,0 ,1,23678 , 0 
46801.787,3,188 ,1 ,256 ,0 ,0 ,1 ,0 ,0 ,0 ,0 ,1 ,0 ,2 ,0 ,2,16525 , 0 
46920.96,8,188 ,1 ,256 ,0 ,0 ,1 ,1 ,0 ,0 ,0 ,2 ,0 ,3 ,0 ,3,19014 , 0 
46921.078,11,188 ,5 ,774 ,0 ,0 ,2 ,0 ,1 ,0 ,0 ,3 ,0 ,4 ,1 ,5,30827 , 0 
46921.123,2,188 ,1 ,256 ,0 ,0 ,2 ,1 ,0 ,0 ,0 ,3 ,0 ,3 ,0 ,3,33094 , 0 
46921.138,6,188 ,2 ,512 ,0 ,0 ,1 ,0 ,0 ,0 ,0 ,1 ,0 ,3 ,0 ,3,41647 , 0 
46921.214,18,188 ,19 ,512 ,0 ,0 ,2 ,0 ,0 ,0 ,0 ,2 ,0 ,1 ,0 ,1,26450 , 0 
46921.236,4,188 ,8 ,512 ,0 ,0 ,1 ,0 ,0 ,0 ,0 ,1 ,0 ,3 ,0 ,3,23177 , 0 
46921.289,7,188 ,9 ,1224 ,0 ,0 ,1 ,0 ,0 ,0 ,0 ,1 ,0 ,1 ,0 ,1,34998 , 0 
46921.337,14,188 ,1 ,256 ,0 ,0 ,1 ,1 ,0 ,0 ,0 ,2 ,0 ,6 ,0 ,6,22724 , 0 
46921.35,15,188 ,11 ,1033 ,0 ,0 ,3 ,1 ,0 ,0 ,0 ,4 ,0 ,1 ,0 ,1,27556 , 0 
46921.36,20,188 ,5 ,777 ,0 ,0 ,1 ,0 ,0 ,0 ,0 ,1 ,0 ,0 ,0 ,0,24983 , 0 
46921.36,16,188 ,2 ,512 ,0 ,0 ,1 ,0 ,0 ,0 ,0 ,1 ,0 ,1 ,0 ,1,46189 , 0 
46921.444,10,188 ,14 ,512 ,0 ,0 ,2 ,0 ,0 ,0 ,0 ,2 ,0 ,0 ,0 ,0,24222 , 0 
46921.482,12,188 ,5 ,798 ,0 ,0 ,1 ,0 ,0 ,0 ,0 ,1 ,0 ,1 ,0 ,1,27272 , 0 
46921.596,9,188 ,5 ,869 ,0 ,0 ,0 ,0 ,0 ,0 ,0 ,0 ,0 ,3 ,0 ,3,41563 , 0 
46921.603,5,188 ,19 ,512 ,0 ,0 ,1 ,0 ,1 ,0 ,0 ,2 ,0 ,3 ,1 ,4,42377 , 0 
46921.606,19,188 ,1 ,256 ,0 ,0 ,0 ,0 ,1 ,0 ,0 ,1 ,0 ,3 ,1 ,4,27394 , 0 
46921.696,17,188 ,6 ,768 ,0 ,0 ,1 ,0 ,0 ,0 ,0 ,1 ,0 ,1 ,0 ,1,32133 , 0 
46921.771,13,188 ,1 ,256 ,0 ,0 ,2 ,1 ,0 ,0 ,0 ,3 ,0 ,3 ,0 ,3,23933 , 0 
46921.787,3,188 ,1 ,256 ,0 ,0 ,2 ,1 ,0 ,0 ,0 ,3 ,0 ,2 ,0 ,2,17281 , 0 
47040.96,8,188 ,1 ,256 ,0 ,0 ,1 ,0 ,1 ,0 ,0 ,2 ,0 ,1 ,1 ,2,18921 , 0 
47041.078,11,188 ,5 ,774 ,0 ,0 ,1 ,0 ,0 ,0 ,0 ,1 ,0 ,1 ,0 ,1,29599 , 0 
47041.123,2,188 ,1 ,256 ,0 ,0 ,1 ,0 ,2 ,0 ,0 ,3 ,0 ,2 ,2 ,4,34761 , 0 
47041.138,6,188 ,2 ,512 ,0 ,0 ,1 ,0 ,0 ,0 ,0 ,1 ,0 ,2 ,0 ,2,48696 , 0 
47041.214,18,188 ,19 ,512 ,0 ,0 ,2 ,0 ,0 ,0 ,0 ,2 ,0 ,0 ,0 ,0,24213 , 0 
47041.236,4,188 ,8 ,512 ,0 ,0 ,0 ,1 ,0 ,0 ,0 ,1 ,0 ,2 ,0 ,2,21813 , 0 
47041.289,7,188 ,16 ,769 ,0 ,0 ,6 ,2 ,0 ,1 ,0 ,9 ,0 ,5 ,0 ,5,35058 , 0 
47041.337,14,188 ,1 ,256 ,0 ,0 ,1 ,0 ,0 ,0 ,0 ,1 ,0 ,1 ,0 ,1,22079 , 0 
47041.35,15,188 ,11 ,1033 ,0 ,0 ,0 ,0 ,0 ,0 ,0 ,0 ,0 ,7 ,0 ,7,26669 , 0 
47041.36,20,188 ,5 ,777 ,0 ,0 ,1 ,0 ,0 ,0 ,0 ,1 ,0 ,1 ,0 ,1,23207 , 0 
47041.36,16,188 ,2 ,512 ,0 ,0 ,3 ,0 ,2 ,0 ,0 ,5 ,0 ,8 ,2 ,10,49434 , 0 
47041.444,10,188 ,14 ,512 ,0 ,0 ,1 ,0 ,0 ,0 ,0 ,1 ,0 ,1 ,0 ,1,25188 , 0 
47041.482,12,188 ,5 ,798 ,0 ,0 ,0 ,0 ,0 ,0 ,0 ,0 ,0 ,2 ,0 ,2,25537 , 0 
47041.596,9,188 ,5 ,869 ,0 ,0 ,2 ,0 ,0 ,1 ,1 ,4 ,0 ,6 ,1 ,7,43174 , 0 
47041.603,5,188 ,19 ,512 ,0 ,0 ,1 ,0 ,0 ,1 ,1 ,3 ,0 ,2 ,2 ,4,41829 , 0 
47041.606,19,188 ,1 ,256 ,0 ,0 ,1 ,0 ,0 ,1 ,1 ,3 ,0 ,2 ,2 ,4,26466 , 0 
47041.696,17,188 ,6 ,768 ,0 ,0 ,2 ,0 ,0 ,0 ,0 ,2 ,0 ,7 ,0 ,7,32488 , 0 
47041.771,13,188 ,1 ,256 ,0 ,0 ,1 ,0 ,0 ,0 ,0 ,1 ,0 ,1 ,0 ,1,23753 , 0 
47041.787,3,188 ,1 ,256 ,0 ,0 ,1 ,0 ,0 ,0 ,0 ,1 ,0 ,0 ,0 ,0,16582 , 0 
47160.96,8,188 ,1 ,256 ,0 ,0 ,2 ,0 ,0 ,0 ,0 ,2 ,0 ,0 ,0 ,0,19076 , 0 
47161.078,11,188 ,5 ,774 ,0 ,0 ,1 ,0 ,0 ,0 ,0 ,1 ,0 ,2 ,0 ,2,30887 , 0 
47161.123,2,188 ,1 ,256 ,0 ,0 ,0 ,0 ,0 ,0 ,0 ,0 ,0 ,0 ,0 ,0,33151 , 0 
47161.138,6,188 ,2 ,512 ,0 ,0 ,1 ,0 ,0 ,0 ,0 ,1 ,0 ,2 ,0 ,2,41707 , 0 
47161.214,18,188 ,19 ,520 ,0 ,0 ,1 ,0 ,0 ,0 ,0 ,1 ,0 ,2 ,0 ,2,26507 , 0 
47161.236,4,188 ,8 ,512 ,0 ,0 ,1 ,0 ,0 ,0 ,0 ,1 ,0 ,1 ,0 ,1,23232 , 0 
47161.289,7,188 ,16 ,769 ,0 ,0 ,2 ,0 ,0 ,0 ,0 ,2 ,0 ,2 ,0 ,2,35090 , 0 
47161.337,14,188 ,1 ,256 ,0 ,0 ,1 ,0 ,1 ,0 ,0 ,2 ,0 ,1 ,1 ,2,22781 , 0 
47161.35,15,188 ,11 ,1033 ,0 ,0 ,2 ,0 ,0 ,0 ,0 ,2 ,0 ,2 ,0 ,2,27628 , 0 
47161.36,20,188 ,5 ,777 ,0 ,0 ,2 ,0 ,0 ,0 ,0 ,2 ,0 ,1 ,0 ,1,25052 , 0 
47161.36,16,188 ,2 ,512 ,0 ,0 ,1 ,0 ,0 ,0 ,0 ,1 ,0 ,2 ,0 ,2,46261 , 0 
47161.444,10,188 ,14 ,512 ,0 ,0 ,1 ,1 ,0 ,0 ,0 ,2 ,0 ,1 ,0 ,1,24283 , 0 
47161.482,12,188 ,5 ,798 ,0 ,0 ,2 ,0 ,0 ,0 ,0 ,2 ,0 ,0 ,0 ,0,27341 , 0 
47161.596,9,188 ,5 ,869 ,0 ,0 ,1 ,0 ,0 ,0 ,0 ,1 ,0 ,3 ,0 ,3,41641 , 0 
47161.603,5,188 ,19 ,512 ,0 ,0 ,1 ,0 ,0 ,0 ,0 ,1 ,0 ,3 ,0 ,3,42449 , 0 
47161.606,19,188 ,1 ,256 ,0 ,0 ,1 ,0 ,0 ,0 ,0 ,1 ,0 ,1 ,0 ,1,27478 , 0 
47161.696,17,188 ,6 ,768 ,0 ,0 ,1 ,0 ,0 ,0 ,0 ,1 ,0 ,1 ,0 ,1,32192 , 0 
47161.771,13,188 ,1 ,256 ,0 ,0 ,1 ,0 ,0 ,0 ,0 ,1 ,0 ,1 ,0 ,1,23988 , 0 
47161.787,3,188 ,1 ,256 ,0 ,0 ,1 ,0 ,0 ,0 ,0 ,1 ,0 ,1 ,0 ,1,17334 , 0 
47280.96,8,188 ,1 ,256 ,0 ,0 ,1 ,0 ,0 ,0 ,0 ,1 ,0 ,1 ,0 ,1,18992 , 0 
47281.078,11,188 ,5 ,774 ,0 ,0 ,1 ,0 ,0 ,0 ,0 ,1 ,0 ,2 ,0 ,2,29677 , 0 
47281.123,2,188 ,1 ,256 ,0 ,0 ,1 ,0 ,0 ,0 ,0 ,1 ,0 ,1 ,0 ,1,34853 , 0 
47281.138,6,188 ,2 ,512 ,0 ,0 ,0 ,0 ,0 ,0 ,0 ,0 ,0 ,1 ,0 ,1,48760 , 0 
47281.214,18,188 ,19 ,520 ,0 ,0 ,1 ,0 ,0 ,0 ,0 ,1 ,0 ,1 ,0 ,1,24278 , 0 
47281.236,4,188 ,8 ,512 ,0 ,0 ,1 ,0 ,0 ,0 ,0 ,1 ,0 ,1 ,0 ,1,21866 , 0 
47281.289,7,189 ,16 ,769 ,0 ,0 ,1 ,0 ,0 ,0 ,0 ,1 ,0 ,0 ,0 ,0,35115 , 1 
47281.337,14,188 ,1 ,256 ,0 ,0 ,1 ,0 ,0 ,0 ,0 ,1 ,0 ,0 ,0 ,0,22165 , 0 
47281.35,15,188 ,11 ,1033 ,0 ,0 ,1 ,0 ,0 ,0 ,0 ,1 ,0 ,1 ,0 ,1,26741 , 0 
47281.36,20,188 ,5 ,777 ,0 ,0 ,1 ,0 ,0 ,0 ,0 ,1 ,0 ,0 ,0 ,0,23264 , 0 
47281.36,16,188 ,2 ,512 ,0 ,0 ,1 ,0 ,0 ,0 ,0 ,1 ,0 ,3 ,0 ,3,49500 , 0 
47281.444,10,188 ,14 ,512 ,0 ,0 ,0 ,0 ,0 ,0 ,0 ,0 ,0 ,0 ,0 ,0,25243 , 0 
47281.482,12,188 ,5 ,798 ,0 ,0 ,1 ,0 ,0 ,0 ,0 ,1 ,0 ,2 ,0 ,2,25622 , 0 
47281.596,9,188 ,5 ,869 ,0 ,0 ,1 ,0 ,0 ,0 ,0 ,1 ,0 ,2 ,0 ,2,43255 , 0 
47281.603,5,188 ,19 ,518 ,0 ,0 ,1 ,1 ,0 ,0 ,0 ,2 ,0 ,3 ,0 ,3,41971 , 0 
47281.606,19,188 ,1 ,256 ,0 ,0 ,1 ,0 ,1 ,0 ,0 ,2 ,0 ,1 ,1 ,2,26547 , 0 
47281.696,17,188 ,6 ,768 ,0 ,0 ,1 ,0 ,0 ,0 ,0 ,1 ,0 ,1 ,0 ,1,32552 , 0 
47281.771,13,188 ,1 ,256 ,0 ,0 ,1 ,0 ,0 ,0 ,0 ,1 ,0 ,0 ,0 ,0,23825 , 0 
47281.787,3,188 ,1 ,256 ,0 ,0 ,1 ,0 ,0 ,0 ,0 ,1 ,0 ,1 ,0 ,1,16648 , 0 
47400.961,8,217 ,1 ,256 ,0 ,0 ,17 ,8 ,2 ,14 ,3 ,44 ,0 ,38 ,6 ,44,19677 , 0 
47401.078,11,222 ,5 ,819 ,0 ,0 ,16 ,1 ,0 ,3 ,1 ,21 ,0 ,48 ,1 ,49,31192 , 0 
47401.124,2,222 ,1 ,256 ,0 ,0 ,16 ,6 ,3 ,8 ,4 ,37 ,0 ,51 ,15 ,66,33658 , 0 
47401.138,6,222 ,2 ,512 ,0 ,0 ,17 ,3 ,0 ,5 ,1 ,26 ,0 ,40 ,4 ,44,42198 , 0 
47401.214,18,217 ,4 ,768 ,0 ,0 ,16 ,4 ,3 ,8 ,1 ,32 ,0 ,33 ,6 ,39,27096 , 0 
47401.236,4,217 ,19 ,512 ,0 ,0 ,15 ,6 ,0 ,8 ,0 ,29 ,0 ,27 ,4 ,31,23707 , 0 
47401.29,7,225 ,16 ,65535 ,0 ,0 ,18 ,0 ,0 ,1 ,0 ,19 ,0 ,32 ,7 ,39,35373 , 1 
47401.338,14,217 ,1 ,256 ,0 ,0 ,11 ,5 ,2 ,9 ,3 ,30 ,0 ,38 ,5 ,43,23028 , 0 
47401.35,15,222 ,7 ,1041 ,0 ,0 ,18 ,1 ,0 ,2 ,0 ,21 ,0 ,33 ,2 ,35,27893 , 0 
47401.36,20,222 ,12 ,2346 ,0 ,0 ,16 ,2 ,0 ,4 ,0 ,22 ,0 ,24 ,0 ,24,25397 , 0 
47401.361,16,222 ,2 ,512 ,0 ,0 ,15 ,2 ,0 ,4 ,0 ,21 ,0 ,40 ,3 ,43,46582 , 0 
47401.444,10,222 ,14 ,512 ,0 ,0 ,14 ,3 ,0 ,4 ,0 ,21 ,0 ,22 ,0 ,22,24742 , 0 
47401.482,12,222 ,18 ,1834 ,0 ,0 ,16 ,2 ,0 ,3 ,0 ,21 ,0 ,31 ,0 ,31,27646 , 0 
47401.596,9,222 ,7 ,1041 ,0 ,0 ,18 ,1 ,0 ,2 ,0 ,21 ,0 ,47 ,6 ,53,41930 , 0 
47401.603,5,218 ,2 ,512 ,0 ,0 ,15 ,2 ,6 ,7 ,6 ,36 ,0 ,50 ,16 ,66,43029 , 0 
47401.607,19,218 ,1 ,256 ,0 ,0 ,16 ,6 ,4 ,13 ,4 ,43 ,0 ,55 ,16 ,71,27979 , 0 
47401.697,17,222 ,7 ,1041 ,0 ,0 ,13 ,1 ,0 ,3 ,0 ,17 ,0 ,32 ,0 ,32,32490 , 0 
47401.78,13,217 ,0 ,0 ,0 ,0 ,12 ,5 ,6 ,12 ,2 ,37 ,0 ,45 ,10 ,55,24497 , 0 
47401.801,3,217 ,0 ,0 ,0 ,0 ,11 ,6 ,0 ,8 ,0 ,25 ,0 ,25 ,2 ,27,17549 , 0 
47520.961,8,3 ,1 ,256 ,0 ,0 ,18 ,13 ,3 ,12 ,2 ,48 ,0 ,43 ,13 ,56,19390 , 0 
47521.078,11,3 ,12 ,1024 ,0 ,0 ,23 ,2 ,2 ,3 ,1 ,31 ,0 ,73 ,6 ,79,30068 , 0 
47521.124,2,3 ,1 ,256 ,0 ,0 ,18 ,6 ,13 ,12 ,2 ,51 ,0 ,67 ,22 ,89,35237 , 0 
47521.138,6,3 ,10 ,768 ,0 ,0 ,17 ,3 ,1 ,2 ,0 ,23 ,0 ,43 ,4 ,47,49022 , 0 
47521.214,18,3 ,19 ,563 ,0 ,0 ,16 ,4 ,1 ,3 ,0 ,24 ,0 ,46 ,2 ,48,24685 , 0 
47521.236,4,3 ,8 ,512 ,0 ,0 ,16 ,6 ,0 ,10 ,0 ,32 ,0 ,33 ,0 ,33,22250 , 0 
47521.29,7,9 ,16 ,65535 ,0 ,0 ,20 ,0 ,0 ,0 ,0 ,20 ,0 ,42 ,0 ,42,35325 , 1 
47521.338,14,3 ,1 ,256 ,0 ,0 ,16 ,12 ,9 ,10 ,4 ,51 ,0 ,51 ,21 ,72,22576 , 0 
47521.35,15,8 ,11 ,1075 ,0 ,0 ,21 ,1 ,0 ,1 ,0 ,23 ,0 ,44 ,0 ,44,26996 , 0 
47521.36,20,3 ,12 ,1024 ,0 ,0 ,19 ,3 ,0 ,5 ,0 ,27 ,0 ,45 ,0 ,45,23623 , 0 
47521.361,16,3 ,6 ,1043 ,0 ,0 ,18 ,2 ,0 ,4 ,0 ,24 ,0 ,35 ,0 ,35,49804 , 0 
47521.444,10,3 ,14 ,512 ,0 ,0 ,15 ,7 ,1 ,5 ,0 ,28 ,0 ,25 ,1 ,26,25612 , 0 
47521.482,12,3 ,18 ,768 ,0 ,0 ,18 ,3 ,0 ,4 ,0 ,25 ,0 ,50 ,1 ,51,25981 , 0 
47521.596,9,6 ,11 ,1075 ,0 ,0 ,20 ,1 ,0 ,2 ,0 ,23 ,0 ,67 ,0 ,67,43550 , 0 
47521.603,5,3 ,13 ,512 ,0 ,0 ,21 ,5 ,9 ,8 ,4 ,47 ,0 ,74 ,20 ,94,42500 , 0 
47521.607,19,3 ,1 ,256 ,0 ,0 ,18 ,6 ,3 ,8 ,1 ,36 ,0 ,71 ,8 ,79,26884 , 0 
47521.7,17,4 ,7 ,1041 ,0 ,0 ,17 ,0 ,0 ,0 ,0 ,17 ,0 ,39 ,0 ,39,32737 , 0 
47521.772,13,3 ,1 ,256 ,0 ,0 ,17 ,9 ,2 ,10 ,1 ,39 ,0 ,54 ,10 ,64,24192 , 0 
47521.787,3,3 ,1 ,256 ,0 ,0 ,18 ,13 ,2 ,12 ,2 ,47 ,0 ,41 ,5 ,46,17008 , 0 
47640.96,8,11 ,1 ,256 ,0 ,0 ,7 ,4 ,6 ,3 ,3 ,23 ,0 ,14 ,9 ,23,19914 , 0 
47641.078,11,11 ,5 ,855 ,0 ,0 ,11 ,5 ,3 ,1 ,0 ,20 ,0 ,41 ,5 ,46,31462 , 0 
47641.124,2,11 ,1 ,256 ,0 ,0 ,12 ,2 ,31 ,2 ,4 ,51 ,0 ,36 ,36 ,72,33976 , 0 
47641.139,6,11 ,16 ,822 ,0 ,0 ,16 ,6 ,7 ,7 ,1 ,37 ,0 ,28 ,11 ,39,42647 , 0 
47641.214,18,11 ,19 ,512 ,0 ,0 ,10 ,5 ,2 ,5 ,2 ,24 ,0 ,20 ,4 ,24,27408 , 0 
47641.236,4,11 ,8 ,560 ,0 ,0 ,8 ,4 ,2 ,3 ,1 ,18 ,0 ,17 ,5 ,22,23941 , 0 
47641.29,7,11 ,16 ,860 ,0 ,0 ,14 ,5 ,1 ,4 ,1 ,25 ,0 ,27 ,2 ,29,35757 , 0 
47641.338,14,11 ,1 ,256 ,0 ,0 ,8 ,3 ,0 ,7 ,2 ,20 ,0 ,29 ,4 ,33,23227 , 0 
47641.35,15,11 ,9 ,1163 ,0 ,0 ,14 ,5 ,0 ,1 ,0 ,20 ,0 ,24 ,0 ,24,28169 , 0 
47641.36,20,11 ,5 ,855 ,0 ,0 ,10 ,5 ,1 ,1 ,0 ,17 ,0 ,20 ,1 ,21,25680 , 0 
47641.361,16,11 ,2 ,523 ,0 ,0 ,10 ,4 ,25 ,1 ,3 ,43 ,0 ,36 ,31 ,67,47166 , 0 
47641.444,10,11 ,6 ,1078 ,0 ,0 ,12 ,8 ,0 ,5 ,1 ,26 ,0 ,20 ,2 ,22,25061 , 0 
47641.482,12,11 ,11 ,1286 ,0 ,0 ,9 ,5 ,2 ,8 ,1 ,25 ,0 ,26 ,4 ,30,28037 , 0 
47641.596,9,11 ,16 ,860 ,0 ,0 ,11 ,4 ,5 ,1 ,1 ,22 ,0 ,35 ,6 ,41,42305 , 0 
47641.603,5,11 ,13 ,512 ,0 ,0 ,8 ,4 ,11 ,2 ,1 ,26 ,0 ,40 ,15 ,55,43401 , 0 
47641.607,19,11 ,1 ,256 ,0 ,0 ,7 ,3 ,5 ,5 ,2 ,22 ,0 ,32 ,10 ,42,28215 , 0 
47641.697,17,11 ,16 ,860 ,0 ,0 ,12 ,5 ,5 ,1 ,1 ,24 ,0 ,32 ,9 ,41,32786 , 0 
47641.772,13,11 ,1 ,256 ,0 ,0 ,8 ,3 ,15 ,3 ,2 ,31 ,0 ,20 ,18 ,38,24712 , 0 
47641.787,3,11 ,1 ,256 ,0 ,0 ,7 ,5 ,0 ,3 ,0 ,15 ,0 ,13 ,0 ,13,17673 , 0 
47760.96,8,11 ,1 ,256 ,0 ,0 ,3 ,1 ,2 ,1 ,0 ,7 ,0 ,4 ,3 ,7,19496 , 0 
47761.078,11,11 ,5 ,818 ,0 ,0 ,3 ,1 ,1 ,0 ,0 ,5 ,0 ,6 ,1 ,7,30148 , 0 
47761.124,2,11 ,1 ,256 ,0 ,0 ,3 ,1 ,8 ,0 ,0 ,12 ,0 ,10 ,8 ,18,35377 , 0 
47761.138,6,11 ,16 ,822 ,0 ,0 ,3 ,0 ,3 ,0 ,0 ,6 ,0 ,5 ,3 ,8,49127 , 0 
47761.214,18,11 ,19 ,512 ,0 ,0 ,5 ,0 ,0 ,0 ,0 ,5 ,0 ,4 ,0 ,4,24782 , 0 
47761.236,4,11 ,8 ,530 ,0 ,0 ,2 ,2 ,0 ,1 ,0 ,5 ,0 ,5 ,0 ,5,22326 , 0 
47761.289,7,11 ,16 ,813 ,0 ,0 ,4 ,1 ,0 ,0 ,0 ,5 ,0 ,5 ,0 ,5,35414 , 0 
47761.337,14,11 ,1 ,256 ,0 ,0 ,3 ,1 ,0 ,0 ,0 ,4 ,0 ,7 ,0 ,7,22653 , 0 
47761.35,15,11 ,9 ,1134 ,0 ,0 ,2 ,1 ,0 ,0 ,0 ,3 ,0 ,6 ,0 ,6,27066 , 0 
47761.36,20,11 ,5 ,818 ,0 ,0 ,2 ,1 ,0 ,0 ,0 ,3 ,0 ,4 ,0 ,4,23713 , 0 
47761.36,16,11 ,2 ,512 ,0 ,0 ,1 ,1 ,7 ,0 ,0 ,9 ,0 ,8 ,9 ,17,49946 , 0 
47761.444,10,11 ,6 ,1078 ,0 ,0 ,2 ,3 ,0 ,0 ,0 ,5 ,0 ,5 ,0 ,5,25699 , 0 
47761.482,12,11 ,11 ,1200 ,0 ,0 ,2 ,1 ,0 ,0 ,0 ,3 ,0 ,9 ,0 ,9,26055 , 0 
47761.596,9,11 ,16 ,813 ,0 ,0 ,2 ,1 ,1 ,1 ,0 ,5 ,0 ,7 ,1 ,8,43662 , 0 
47761.603,5,11 ,13 ,512 ,0 ,0 ,2 ,1 ,3 ,0 ,0 ,6 ,0 ,12 ,3 ,15,42612 , 0 
47761.606,19,11 ,1 ,256 ,0 ,0 ,2 ,1 ,0 ,0 ,0 ,3 ,0 ,14 ,0 ,14,26966 , 0 
47761.696,17,11 ,16 ,813 ,0 ,0 ,2 ,1 ,0 ,1 ,0 ,4 ,0 ,6 ,0 ,6,32816 , 0 
47761.771,13,11 ,1 ,256 ,0 ,0 ,3 ,0 ,4 ,0 ,0 ,7 ,0 ,6 ,4 ,10,24282 , 0 
47761.787,3,11 ,1 ,256 ,0 ,0 ,2 ,1 ,0 ,0 ,0 ,3 ,0 ,4 ,0 ,4,17086 , 0 
47880.96,8,11 ,1 ,256 ,0 ,0 ,0 ,1 ,0 ,0 ,0 ,1 ,0 ,5 ,0 ,5,19972 , 0 
47881.078,11,11 ,5 ,790 ,0 ,0 ,1 ,1 ,2 ,0 ,0 ,4 ,0 ,7 ,2 ,9,31544 , 0 
47881.123,2,11 ,1 ,256 ,0 ,0 ,0 ,1 ,6 ,0 ,0 ,7 ,0 ,6 ,6 ,12,34045 , 0 
47881.138,6,11 ,16 ,793 ,0 ,0 ,2 ,1 ,1 ,0 ,0 ,4 ,0 ,3 ,1 ,4,42737 , 0 
47881.214,18,11 ,19 ,512 ,0 ,0 ,2 ,1 ,0 ,0 ,0 ,3 ,0 ,4 ,0 ,4,27483 , 0 
47881.236,4,11 ,8 ,530 ,0 ,0 ,2 ,0 ,0 ,0 ,0 ,2 ,0 ,3 ,0 ,3,24033 , 0 
47881.289,7,11 ,16 ,793 ,0 ,0 ,2 ,1 ,0 ,0 ,0 ,3 ,0 ,4 ,0 ,4,35833 , 0 
47881.337,14,11 ,1 ,256 ,0 ,0 ,0 ,1 ,0 ,0 ,0 ,1 ,0 ,7 ,0 ,7,23298 , 0 
47881.35,15,11 ,9 ,1127 ,0 ,0 ,2 ,1 ,0 ,0 ,0 ,3 ,0 ,3 ,0 ,3,28242 , 0 
47881.36,20,11 ,5 ,790 ,0 ,0 ,2 ,1 ,0 ,0 ,0 ,3 ,0 ,3 ,0 ,3,25758 , 0 
47881.36,16,11 ,2 ,512 ,0 ,0 ,2 ,0 ,6 ,0 ,0 ,8 ,0 ,4 ,6 ,10,47284 , 0 
47881.444,10,11 ,6 ,1049 ,0 ,0 ,3 ,1 ,0 ,0 ,0 ,4 ,0 ,1 ,0 ,1,25139 , 0 
47881.482,12,11 ,11 ,1147 ,0 ,0 ,2 ,2 ,0 ,0 ,0 ,4 ,0 ,4 ,0 ,4,28107 , 0 
47881.596,9,11 ,16 ,813 ,0 ,0 ,2 ,0 ,1 ,0 ,0 ,3 ,0 ,5 ,1 ,6,42378 , 0 
47881.603,5,11 ,13 ,512 ,0 ,0 ,2 ,1 ,4 ,0 ,0 ,7 ,0 ,8 ,4 ,12,43507 , 0 
47881.606,19,11 ,1 ,256 ,0 ,0 ,2 ,1 ,1 ,0 ,0 ,4 ,0 ,4 ,1 ,5,28324 , 0 
47881.696,17,11 ,16 ,787 ,0 ,0 ,1 ,2 ,0 ,0 ,0 ,3 ,0 ,4 ,0 ,4,32858 , 0 
47881.771,13,11 ,1 ,256 ,0 ,0 ,1 ,1 ,5 ,0 ,0 ,7 ,0 ,4 ,5 ,9,24803 , 0 
47881.787,3,11 ,1 ,256 ,0 ,0 ,2 ,1 ,0 ,0 ,0 ,3 ,0 ,1 ,0 ,1,17738 , 0 
48000.96,8,11 ,1 ,256 ,0 ,0 ,2 ,0 ,1 ,0 ,0 ,3 ,0 ,3 ,1 ,4,19614 , 0 
48001.08,11,11 ,9 ,300 ,0 ,0 ,12 ,8 ,7 ,8 ,1 ,36 ,0 ,29 ,26 ,55,30693 , 0 
48001.136,2,11 ,1 ,256 ,0 ,0 ,4 ,0 ,10 ,2 ,8 ,24 ,0 ,13 ,20 ,33,35653 , 0 
48001.138,6,11 ,17 ,1082 ,0 ,0 ,3 ,7 ,0 ,1 ,0 ,11 ,0 ,19 ,3 ,22,49389 , 0 
48001.214,18,11 ,19 ,512 ,0 ,0 ,1 ,1 ,0 ,0 ,0 ,2 ,0 ,10 ,0 ,10,24873 , 0 
48001.236,4,11 ,8 ,524 ,0 ,0 ,1 ,1 ,0 ,0 ,0 ,2 ,0 ,2 ,0 ,2,22435 , 0 
48001.29,7,11 ,9 ,300 ,0 ,0 ,11 ,8 ,7 ,10 ,3 ,39 ,0 ,33 ,27 ,60,35946 , 0 
48001.337,14,11 ,1 ,256 ,0 ,0 ,2 ,0 ,0 ,0 ,0 ,2 ,0 ,6 ,0 ,6,22743 , 0 
48001.351,15,11 ,9 ,65535 ,0 ,0 ,14 ,9 ,6 ,10 ,2 ,41 ,0 ,22 ,19 ,41,27735 , 0 
48001.36,20,11 ,12 ,1054 ,0 ,0 ,6 ,4 ,0 ,2 ,1 ,13 ,0 ,14 ,1 ,15,24022 , 0 
48001.361,16,11 ,2 ,512 ,0 ,0 ,13 ,6 ,9 ,8 ,5 ,41 ,0 ,20 ,22 ,42,50550 , 0 
48001.444,10,11 ,6 ,65535 ,0 ,0 ,3 ,0 ,0 ,1 ,0 ,4 ,0 ,2 ,0 ,2,25793 , 0 
48001.482,12,11 ,11 ,773 ,0 ,0 ,6 ,7 ,0 ,2 ,0 ,15 ,0 ,16 ,0 ,16,26346 , 0 
48001.602,9,11 ,9 ,0 ,0 ,0 ,15 ,8 ,15 ,20 ,4 ,62 ,0 ,35 ,56 ,91,44413 , 1 
48001.603,5,11 ,2 ,512 ,0 ,0 ,6 ,4 ,4 ,2 ,2 ,18 ,0 ,21 ,9 ,30,43009 , 0 
48001.607,19,11 ,1 ,256 ,0 ,0 ,2 ,0 ,1 ,0 ,0 ,3 ,0 ,10 ,1 ,11,27139 , 0 
48001.697,17,11 ,16 ,969 ,0 ,0 ,12 ,6 ,0 ,7 ,0 ,25 ,0 ,19 ,1 ,20,33235 , 0 
48001.771,13,11 ,1 ,256 ,0 ,0 ,1 ,0 ,3 ,1 ,2 ,7 ,0 ,7 ,5 ,12,24391 , 0 
48001.787,3,11 ,1 ,256 ,0 ,0 ,2 ,0 ,0 ,0 ,0 ,2 ,0 ,3 ,0 ,3,17153 , 0 
48120.96,8,11 ,1 ,256 ,0 ,0 ,2 ,0 ,0 ,0 ,0 ,2 ,0 ,1 ,0 ,1,20061 , 0 
48121.079,11,11 ,9 ,300 ,0 ,0 ,20 ,14 ,21 ,23 ,5 ,83 ,0 ,42 ,63 ,105,32404 , 0 
48121.124,2,11 ,1 ,256 ,0 ,0 ,5 ,1 ,30 ,0 ,9 ,45 ,0 ,10 ,44 ,54,34339 , 0 
48121.138,6,11 ,16 ,892 ,0 ,0 ,5 ,4 ,4 ,1 ,0 ,14 ,0 ,20 ,4 ,24,42954 , 0 
48121.215,18,11 ,19 ,512 ,0 ,0 ,1 ,1 ,0 ,0 ,0 ,2 ,0 ,14 ,0 ,14,27664 , 0 
48121.236,4,11 ,8 ,524 ,0 ,0 ,2 ,0 ,0 ,0 ,0 ,2 ,0 ,2 ,0 ,2,24151 , 0 
48121.29,7,11 ,9 ,300 ,0 ,0 ,10 ,13 ,7 ,6 ,5 ,41 ,0 ,27 ,18 ,45,36408 , 0 
48121.337,14,11 ,1 ,256 ,0 ,0 ,1 ,0 ,0 ,0 ,0 ,1 ,0 ,5 ,0 ,5,23391 , 0 
48121.351,15,11 ,9 ,300 ,0 ,0 ,16 ,14 ,3 ,13 ,2 ,48 ,0 ,34 ,21 ,55,28836 , 0 
48121.36,20,11 ,5 ,768 ,0 ,0 ,15 ,14 ,0 ,10 ,0 ,39 ,0 ,26 ,2 ,28,26307 , 0 
48121.361,16,11 ,2 ,512 ,0 ,0 ,5 ,0 ,20 ,2 ,5 ,32 ,0 ,22 ,29 ,51,47772 , 0 
48121.444,10,11 ,6 ,1444 ,0 ,0 ,5 ,4 ,0 ,0 ,0 ,9 ,0 ,4 ,0 ,4,25264 , 0 
48121.482,12,11 ,11 ,1168 ,0 ,0 ,6 ,16 ,1 ,4 ,1 ,28 ,0 ,34 ,4 ,38,28632 , 0 
48121.597,9,11 ,5 ,768 ,0 ,0 ,19 ,11 ,25 ,28 ,7 ,90 ,0 ,37 ,80 ,117,43345 , 1 
48121.603,5,11 ,19 ,512 ,0 ,0 ,9 ,1 ,13 ,2 ,7 ,32 ,0 ,36 ,38 ,74,44090 , 0 
48121.606,19,11 ,1 ,256 ,0 ,0 ,2 ,1 ,5 ,0 ,1 ,9 ,0 ,6 ,7 ,13,28468 , 0 
48121.697,17,11 ,16 ,892 ,0 ,0 ,12 ,8 ,0 ,5 ,1 ,26 ,0 ,13 ,1 ,14,33260 , 0 
48121.787,3,11 ,1 ,256 ,0 ,0 ,1 ,1 ,0 ,0 ,0 ,2 ,0 ,2 ,0 ,2,17866 , 0 
48121.819,13,11 ,1 ,256 ,0 ,0 ,2 ,1 ,0 ,1 ,0 ,4 ,0 ,6 ,0 ,6,25033 , 0 
48240.96,8,11 ,1 ,256 ,0 ,0 ,1 ,0 ,1 ,0 ,0 ,2 ,0 ,0 ,1 ,1,19705 , 0 
48241.078,11,11 ,5 ,803 ,0 ,0 ,18 ,13 ,9 ,19 ,0 ,59 ,0 ,49 ,32 ,81,31288 , 0 
48241.123,2,11 ,1 ,256 ,0 ,0 ,2 ,0 ,4 ,3 ,0 ,9 ,0 ,2 ,4 ,6,35768 , 0 
48241.138,6,11 ,16 ,873 ,0 ,0 ,3 ,1 ,2 ,0 ,0 ,6 ,0 ,7 ,2 ,9,49520 , 0 
48241.214,18,11 ,19 ,512 ,0 ,0 ,5 ,0 ,0 ,0 ,0 ,5 ,0 ,9 ,0 ,9,25006 , 0 
48241.236,4,11 ,8 ,521 ,0 ,0 ,2 ,1 ,0 ,0 ,0 ,3 ,0 ,3 ,0 ,3,22519 , 0 
48241.289,7,11 ,9 ,300 ,0 ,0 ,3 ,14 ,1 ,4 ,1 ,23 ,0 ,34 ,4 ,38,36307 , 0 
48241.337,14,11 ,1 ,256 ,0 ,0 ,1 ,0 ,0 ,0 ,0 ,1 ,0 ,2 ,0 ,2,22811 , 0 
48241.36,20,11 ,5 ,803 ,0 ,0 ,8 ,4 ,0 ,0 ,0 ,12 ,0 ,22 ,1 ,23,24237 , 0 
48241.36,16,11 ,2 ,526 ,0 ,0 ,2 ,1 ,3 ,0 ,0 ,6 ,0 ,25 ,3 ,28,50695 , 0 
48241.412,15,11 ,7 ,810 ,0 ,0 ,17 ,13 ,0 ,14 ,0 ,44 ,0 ,32 ,17 ,49,28216 , 0 
48241.444,10,11 ,6 ,1334 ,0 ,0 ,2 ,2 ,0 ,0 ,0 ,4 ,0 ,2 ,0 ,2,25863 , 0 
48241.482,12,11 ,11 ,1091 ,0 ,0 ,6 ,12 ,0 ,2 ,0 ,20 ,0 ,28 ,0 ,28,26533 , 0 
48241.599,9,11 ,5 ,803 ,0 ,0 ,20 ,10 ,19 ,25 ,3 ,77 ,0 ,36 ,68 ,104,45152 , 1 
48241.603,5,11 ,19 ,512 ,0 ,0 ,6 ,0 ,16 ,2 ,2 ,26 ,0 ,42 ,41 ,83,43429 , 0 
48241.607,19,11 ,1 ,256 ,0 ,0 ,1 ,0 ,16 ,0 ,2 ,19 ,0 ,11 ,20 ,31,27358 , 0 
48241.696,17,11 ,16 ,892 ,0 ,0 ,4 ,0 ,0 ,0 ,0 ,4 ,0 ,4 ,0 ,4,33343 , 0 
48241.771,13,11 ,1 ,256 ,0 ,0 ,0 ,0 ,0 ,0 ,0 ,0 ,0 ,7 ,0 ,7,24492 , 0 
48241.787,3,11 ,1 ,256 ,0 ,0 ,1 ,0 ,0 ,0 ,0 ,1 ,0 ,0 ,0 ,0,17208 , 0 
48360.96,8,11 ,1 ,256 ,0 ,0 ,1 ,0 ,0 ,0 ,0 ,1 ,0 ,4 ,0 ,4,20145 , 0 
48361.078,11,11 ,5 ,792 ,0 ,0 ,6 ,1 ,7 ,0 ,0 ,14 ,0 ,12 ,8 ,20,32566 , 0 
48361.123,2,11 ,1 ,256 ,0 ,0 ,1 ,0 ,2 ,0 ,1 ,4 ,0 ,4 ,3 ,7,34441 , 0 
48361.138,6,11 ,16 ,873 ,0 ,0 ,1 ,0 ,1 ,0 ,1 ,3 ,0 ,3 ,2 ,5,43046 , 0 
48361.214,18,11 ,19 ,512 ,0 ,0 ,3 ,1 ,0 ,0 ,0 ,4 ,0 ,7 ,0 ,7,27770 , 0 
48361.236,4,11 ,8 ,521 ,0 ,0 ,2 ,0 ,0 ,0 ,0 ,2 ,0 ,3 ,0 ,3,24228 , 0 
48361.289,7,11 ,16 ,882 ,0 ,0 ,7 ,2 ,1 ,2 ,0 ,12 ,0 ,8 ,3 ,11,36595 , 0 
48361.337,14,11 ,1 ,256 ,0 ,0 ,2 ,0 ,2 ,0 ,0 ,4 ,0 ,6 ,2 ,8,23491 , 0 
48361.35,15,11 ,11 ,1059 ,0 ,0 ,6 ,4 ,0 ,2 ,0 ,12 ,0 ,15 ,2 ,17,29013 , 0 
48361.36,20,11 ,5 ,792 ,0 ,0 ,3 ,1 ,0 ,0 ,0 ,4 ,0 ,7 ,0 ,7,26417 , 0 
48361.36,16,11 ,2 ,526 ,0 ,0 ,0 ,0 ,2 ,0 ,1 ,3 ,0 ,11 ,3 ,14,47905 , 0 
48361.444,10,11 ,14 ,512 ,0 ,0 ,4 ,3 ,0 ,1 ,0 ,8 ,0 ,2 ,0 ,2,25360 , 0 
48361.482,12,11 ,11 ,1059 ,0 ,0 ,4 ,4 ,0 ,0 ,0 ,8 ,0 ,11 ,0 ,11,28812 , 0 
48361.596,9,11 ,5 ,792 ,0 ,0 ,5 ,1 ,0 ,1 ,1 ,8 ,0 ,16 ,2 ,18,43533 , 0 
48361.603,5,11 ,19 ,512 ,0 ,0 ,3 ,1 ,10 ,2 ,1 ,17 ,0 ,14 ,12 ,26,44353 , 0 
48361.607,19,11 ,1 ,256 ,0 ,0 ,2 ,0 ,12 ,2 ,1 ,17 ,0 ,6 ,15 ,21,28592 , 0 
48361.696,17,11 ,16 ,892 ,0 ,0 ,2 ,0 ,0 ,0 ,0 ,2 ,0 ,8 ,0 ,8,33343 , 0 
48361.771,13,11 ,1 ,256 ,0 ,0 ,2 ,0 ,0 ,0 ,0 ,2 ,0 ,3 ,0 ,3,25117 , 0 
48361.787,3,11 ,1 ,256 ,0 ,0 ,2 ,0 ,0 ,0 ,0 ,2 ,0 ,3 ,0 ,3,17935 , 0 
48480.96,8,11 ,1 ,256 ,0 ,0 ,1 ,1 ,0 ,0 ,0 ,2 ,0 ,1 ,0 ,1,19775 , 0 
48481.078,11,11 ,5 ,791 ,0 ,0 ,2 ,1 ,0 ,0 ,0 ,3 ,0 ,6 ,0 ,6,31366 , 0 
48481.123,2,11 ,1 ,256 ,0 ,0 ,2 ,1 ,4 ,1 ,0 ,8 ,0 ,6 ,5 ,11,35893 , 0 
48481.138,6,11 ,16 ,818 ,0 ,0 ,2 ,0 ,0 ,1 ,0 ,3 ,0 ,5 ,0 ,5,49603 , 0 
48481.214,18,11 ,19 ,512 ,0 ,0 ,2 ,0 ,0 ,0 ,0 ,2 ,0 ,4 ,0 ,4,25080 , 0 
48481.236,4,11 ,8 ,521 ,0 ,0 ,1 ,0 ,0 ,0 ,0 ,1 ,0 ,2 ,0 ,2,22608 , 0 
48481.289,7,11 ,16 ,823 ,0 ,0 ,2 ,2 ,0 ,0 ,0 ,4 ,0 ,5 ,0 ,5,36383 , 0 
48481.337,14,11 ,1 ,256 ,0 ,0 ,0 ,1 ,0 ,0 ,0 ,1 ,0 ,4 ,0 ,4,22869 , 0 
48481.35,15,11 ,11 ,1079 ,0 ,0 ,3 ,1 ,0 ,0 ,0 ,4 ,0 ,2 ,0 ,2,28292 , 0 
48481.36,20,11 ,5 ,791 ,0 ,0 ,2 ,1 ,0 ,0 ,0 ,3 ,0 ,4 ,0 ,4,24310 , 0 
48481.36,16,11 ,2 ,513 ,0 ,0 ,3 ,1 ,3 ,1 ,0 ,8 ,0 ,2 ,4 ,6,50831 , 0 
48481.444,10,11 ,14 ,512 ,0 ,0 ,3 ,0 ,0 ,0 ,0 ,3 ,0 ,0 ,0 ,0,25934 , 0 
48481.482,12,11 ,11 ,1079 ,0 ,0 ,2 ,1 ,0 ,0 ,0 ,3 ,0 ,4 ,0 ,4,26611 , 0 
48481.596,9,11 ,5 ,791 ,0 ,0 ,0 ,1 ,0 ,0 ,0 ,1 ,0 ,6 ,0 ,6,45219 , 0 
48481.603,5,11 ,19 ,512 ,0 ,0 ,2 ,0 ,5 ,0 ,0 ,7 ,0 ,6 ,5 ,11,43569 , 0 
48481.606,19,11 ,1 ,256 ,0 ,0 ,1 ,1 ,3 ,0 ,0 ,5 ,0 ,5 ,3 ,8,27461 , 0 
48481.696,17,11 ,16 ,818 ,0 ,0 ,1 ,1 ,0 ,0 ,0 ,2 ,0 ,4 ,0 ,4,33425 , 0 
48481.771,13,11 ,1 ,256 ,0 ,0 ,1 ,1 ,0 ,0 ,0 ,2 ,0 ,3 ,0 ,3,24565 , 0 
48481.787,3,11 ,1 ,256 ,0 ,0 ,0 ,1 ,0 ,0 ,0 ,1 ,0 ,1 ,0 ,1,17259 , 0 
48600.96,8,11 ,1 ,256 ,0 ,0 ,2 ,0 ,2 ,0 ,0 ,4 ,0 ,3 ,2 ,5,20225 , 0 
48601.078,11,11 ,5 ,791 ,0 ,0 ,1 ,0 ,3 ,0 ,0 ,4 ,0 ,1 ,3 ,4,32646 , 0 
48601.123,2,11 ,1 ,256 ,0 ,0 ,1 ,0 ,0 ,0 ,0 ,1 ,0 ,2 ,0 ,2,34512 , 0 
48601.138,6,11 ,16 ,818 ,0 ,0 ,2 ,0 ,0 ,0 ,0 ,2 ,0 ,3 ,0 ,3,43126 , 0 
48601.214,18,11 ,19 ,512 ,0 ,0 ,0 ,0 ,0 ,0 ,0 ,0 ,0 ,0 ,0 ,0,27827 , 0 
48601.236,4,11 ,8 ,516 ,0 ,0 ,2 ,2 ,0 ,0 ,0 ,4 ,0 ,3 ,0 ,3,24320 , 0 
48601.289,7,11 ,16 ,823 ,0 ,0 ,2 ,0 ,0 ,0 ,0 ,2 ,0 ,3 ,0 ,3,36658 , 0 
48601.337,14,11 ,1 ,256 ,0 ,0 ,1 ,0 ,0 ,0 ,0 ,1 ,0 ,4 ,0 ,4,23554 , 0 
48601.35,15,11 ,11 ,1079 ,0 ,0 ,0 ,0 ,0 ,0 ,0 ,0 ,0 ,4 ,0 ,4,29072 , 0 
48601.36,20,11 ,5 ,791 ,0 ,0 ,1 ,0 ,0 ,0 ,0 ,1 ,0 ,0 ,0 ,0,26487 , 0 
48601.36,16,11 ,2 ,513 ,0 ,0 ,0 ,0 ,0 ,0 ,0 ,0 ,0 ,4 ,0 ,4,47967 , 0 
48601.444,10,11 ,14 ,512 ,0 ,0 ,2 ,0 ,0 ,0 ,0 ,2 ,0 ,2 ,0 ,2,25426 , 0 
48601.482,12,11 ,11 ,1066 ,0 ,0 ,0 ,1 ,0 ,0 ,0 ,1 ,0 ,2 ,0 ,2,28882 , 0 
48601.596,9,11 ,5 ,791 ,0 ,0 ,2 ,0 ,0 ,0 ,0 ,2 ,0 ,1 ,0 ,1,43609 , 0 
48601.602,5,11 ,19 ,512 ,0 ,0 ,1 ,0 ,1 ,0 ,0 ,2 ,0 ,2 ,1 ,3,44482 , 0 
48601.606,19,11 ,1 ,256 ,0 ,0 ,1 ,0 ,3 ,0 ,0 ,4 ,0 ,4 ,3 ,7,28690 , 0 
48601.696,17,11 ,16 ,818 ,0 ,0 ,2 ,0 ,0 ,0 ,0 ,2 ,0 ,2 ,0 ,2,33416 , 0 
48601.771,13,11 ,1 ,256 ,0 ,0 ,2 ,0 ,0 ,0 ,0 ,2 ,0 ,2 ,0 ,2,25200 , 0 
48601.787,3,11 ,1 ,256 ,0 ,0 ,2 ,0 ,0 ,0 ,0 ,2 ,0 ,1 ,0 ,1,18004 , 0 
48720.96,8,11 ,1 ,256 ,0 ,0 ,1 ,0 ,0 ,0 ,0 ,1 ,0 ,1 ,0 ,1,19849 , 0 
48721.078,11,11 ,5 ,825 ,0 ,0 ,2 ,1 ,1 ,0 ,0 ,4 ,0 ,6 ,1 ,7,31468 , 0 
48721.124,2,11 ,1 ,256 ,0 ,0 ,24 ,0 ,63 ,0 ,0 ,87 ,100 ,22 ,63 ,185,36273 , 0 
48721.214,18,11 ,19 ,512 ,0 ,0 ,2 ,0 ,0 ,0 ,0 ,2 ,0 ,3 ,0 ,3,25171 , 0 
48721.236,4,11 ,8 ,516 ,0 ,0 ,1 ,0 ,0 ,0 ,0 ,1 ,0 ,1 ,0 ,1,22686 , 0 
48721.273,6,11 ,16 ,786 ,0 ,120 ,0 ,18 ,0 ,0 ,0 ,138 ,0 ,82 ,0 ,82,50504 , 1 
48721.29,7,11 ,16 ,786 ,0 ,0 ,3 ,17 ,0 ,0 ,0 ,20 ,0 ,43 ,0 ,43,36680 , 0 
48721.337,14,11 ,1 ,256 ,0 ,0 ,2 ,0 ,1 ,0 ,0 ,3 ,0 ,39 ,1 ,40,23014 , 0 
48721.35,15,11 ,11 ,1079 ,0 ,0 ,2 ,0 ,0 ,0 ,0 ,2 ,0 ,2 ,0 ,2,28430 , 0 
48721.36,20,11 ,5 ,825 ,0 ,0 ,2 ,1 ,0 ,0 ,0 ,3 ,0 ,4 ,0 ,4,24423 , 0 
48721.361,16,11 ,2 ,512 ,0 ,0 ,26 ,14 ,49 ,0 ,0 ,89 ,105 ,34 ,49 ,188,51662 , 0 
48721.444,10,11 ,14 ,512 ,0 ,0 ,26 ,1 ,0 ,0 ,0 ,27 ,109 ,1 ,0 ,110,26203 , 0 
48721.482,12,11 ,11 ,1096 ,0 ,0 ,2 ,1 ,0 ,0 ,0 ,3 ,0 ,4 ,0 ,4,26695 , 0 
48721.596,9,11 ,5 ,825 ,0 ,0 ,2 ,1 ,0 ,0 ,0 ,3 ,0 ,26 ,0 ,26,45404 , 0 
48721.603,5,11 ,19 ,512 ,0 ,0 ,1 ,0 ,4 ,0 ,0 ,5 ,0 ,27 ,4 ,31,43736 , 0 
48721.606,19,11 ,1 ,256 ,0 ,0 ,1 ,0 ,4 ,0 ,0 ,5 ,0 ,26 ,4 ,30,27575 , 0 
48721.697,17,11 ,16 ,784 ,0 ,0 ,25 ,14 ,0 ,0 ,0 ,39 ,106 ,23 ,0 ,129,33799 , 0 
48721.771,13,11 ,1 ,256 ,0 ,0 ,1 ,0 ,0 ,0 ,0 ,1 ,0 ,21 ,0 ,21,24680 , 0 
48721.787,3,11 ,1 ,256 ,0 ,0 ,2 ,0 ,0 ,0 ,0 ,2 ,0 ,0 ,0 ,0,17346 , 0 
48840.96,8,11 ,1 ,256 ,0 ,0 ,1 ,0 ,0 ,0 ,0 ,1 ,0 ,0 ,0 ,0,20312 , 0 
48841.078,11,11 ,5 ,825 ,0 ,0 ,1 ,0 ,1 ,0 ,0 ,2 ,0 ,3 ,1 ,4,32781 , 0 
48841.124,2,11 ,1 ,256 ,0 ,0 ,25 ,0 ,67 ,0 ,0 ,92 ,104 ,20 ,67 ,191,34924 , 0 
48841.214,18,11 ,19 ,512 ,0 ,0 ,1 ,0 ,0 ,0 ,0 ,1 ,0 ,1 ,0 ,1,27924 , 0 
48841.236,4,11 ,8 ,516 ,0 ,0 ,1 ,0 ,0 ,0 ,0 ,1 ,0 ,0 ,0 ,0,24381 , 0 
48841.27,6,11 ,16 ,803 ,0 ,120 ,1 ,17 ,0 ,0 ,0 ,138 ,0 ,81 ,0 ,81,44010 , 1 
48841.29,7,11 ,16 ,803 ,0 ,0 ,0 ,19 ,0 ,0 ,0 ,19 ,0 ,45 ,0 ,45,36947 , 0 
48841.338,14,11 ,1 ,256 ,0 ,0 ,1 ,0 ,0 ,0 ,0 ,1 ,0 ,32 ,0 ,32,23633 , 0 
48841.35,15,11 ,11 ,1079 ,0 ,0 ,2 ,0 ,0 ,0 ,0 ,2 ,0 ,0 ,0 ,0,29149 , 0 
48841.36,20,11 ,5 ,825 ,0 ,0 ,2 ,0 ,0 ,0 ,0 ,2 ,0 ,0 ,0 ,0,26579 , 0 
48841.361,16,11 ,2 ,520 ,0 ,0 ,25 ,16 ,51 ,0 ,0 ,92 ,111 ,39 ,51 ,201,48810 , 0 
48841.445,10,11 ,14 ,512 ,0 ,0 ,25 ,0 ,0 ,0 ,0 ,25 ,111 ,0 ,0 ,111,25701 , 0 
48841.482,12,11 ,11 ,1094 ,0 ,0 ,1 ,1 ,0 ,0 ,0 ,2 ,0 ,4 ,0 ,4,29015 , 0 
48841.596,9,11 ,5 ,825 ,0 ,0 ,1 ,0 ,0 ,0 ,0 ,1 ,0 ,20 ,0 ,20,43732 , 0 
48841.607,19,11 ,1 ,256 ,0 ,0 ,1 ,0 ,1 ,0 ,0 ,2 ,0 ,25 ,1 ,26,28804 , 0 
48841.697,17,11 ,16 ,803 ,0 ,0 ,26 ,16 ,0 ,0 ,0 ,42 ,109 ,19 ,0 ,128,33819 , 0 
48841.739,5,11 ,19 ,512 ,0 ,0 ,2 ,0 ,1 ,0 ,0 ,3 ,0 ,22 ,1 ,23,44678 , 0 
48841.771,13,11 ,1 ,256 ,0 ,0 ,1 ,0 ,0 ,0 ,0 ,1 ,0 ,22 ,0 ,22,25293 , 0 
48841.787,3,11 ,1 ,256 ,0 ,0 ,0 ,0 ,0 ,0 ,0 ,0 ,0 ,1 ,0 ,1,18055 , 0 
48960.96,8,11 ,1 ,256 ,0 ,0 ,1 ,0 ,0 ,0 ,0 ,1 ,0 ,1 ,0 ,1,19922 , 0 
48961.078,11,11 ,5 ,825 ,0 ,0 ,1 ,0 ,1 ,0 ,0 ,2 ,0 ,0 ,1 ,1,31581 , 0 
48961.124,2,11 ,1 ,256 ,0 ,0 ,24 ,0 ,67 ,0 ,0 ,91 ,103 ,23 ,67 ,193,36640 , 0 
48961.14,6,11 ,16 ,812 ,0 ,120 ,1 ,18 ,0 ,0 ,0 ,139 ,0 ,85 ,0 ,85,51424 , 1 
48961.214,18,11 ,19 ,512 ,0 ,0 ,1 ,0 ,0 ,0 ,0 ,1 ,0 ,0 ,0 ,0,25265 , 0 
48961.236,4,11 ,8 ,513 ,0 ,0 ,1 ,0 ,0 ,0 ,0 ,1 ,0 ,2 ,0 ,2,22794 , 0 
48961.29,7,11 ,16 ,801 ,0 ,0 ,2 ,18 ,0 ,0 ,0 ,20 ,0 ,42 ,0 ,42,36972 , 0 
48961.338,14,11 ,1 ,256 ,0 ,0 ,1 ,0 ,0 ,0 ,0 ,1 ,0 ,31 ,0 ,31,23115 , 0 
48961.35,15,11 ,11 ,1136 ,0 ,0 ,1 ,1 ,0 ,0 ,0 ,2 ,0 ,2 ,0 ,2,28525 , 0 
48961.36,20,11 ,5 ,825 ,0 ,0 ,0 ,0 ,0 ,0 ,0 ,0 ,0 ,0 ,0 ,0,24488 , 0 
48961.361,16,11 ,2 ,512 ,0 ,0 ,26 ,14 ,54 ,0 ,0 ,94 ,105 ,35 ,54 ,194,52574 , 0 
48961.444,10,11 ,14 ,512 ,0 ,0 ,25 ,0 ,0 ,0 ,0 ,25 ,110 ,0 ,0 ,110,26463 , 0 
48961.482,12,11 ,11 ,1094 ,0 ,0 ,1 ,0 ,0 ,0 ,0 ,1 ,0 ,0 ,0 ,0,26770 , 0 
48961.596,9,11 ,5 ,825 ,0 ,0 ,1 ,0 ,0 ,0 ,0 ,1 ,0 ,23 ,0 ,23,45515 , 0 
48961.603,5,11 ,19 ,512 ,0 ,0 ,1 ,0 ,1 ,0 ,0 ,2 ,0 ,18 ,1 ,19,43882 , 0 
48961.607,19,11 ,1 ,256 ,0 ,0 ,1 ,0 ,1 ,0 ,0 ,2 ,0 ,22 ,1 ,23,27688 , 0 
48961.697,17,11 ,16 ,801 ,0 ,0 ,26 ,18 ,0 ,0 ,0 ,44 ,112 ,20 ,0 ,132,34245 , 0 
48961.771,13,11 ,1 ,256 ,0 ,0 ,0 ,0 ,0 ,0 ,0 ,0 ,0 ,19 ,0 ,19,24771 , 0 
48961.787,3,11 ,1 ,256 ,0 ,0 ,1 ,0 ,0 ,0 ,0 ,1 ,0 ,1 ,0 ,1,17429 , 0 
49080.96,8,11 ,1 ,256 ,0 ,0 ,1 ,0 ,0 ,0 ,0 ,1 ,0 ,0 ,0 ,0,20381 , 0 
49081.078,11,11 ,5 ,825 ,0 ,0 ,1 ,0 ,0 ,0 ,0 ,1 ,0 ,3 ,0 ,3,32850 , 0 
49081.124,2,11 ,1 ,256 ,0 ,0 ,6 ,0 ,15 ,0 ,0 ,21 ,1 ,3 ,15 ,19,35038 , 0 
49081.138,6,11 ,16 ,777 ,0 ,0 ,1 ,4 ,0 ,0 ,0 ,5 ,0 ,17 ,0 ,17,44129 , 0 
49081.214,18,11 ,19 ,512 ,0 ,0 ,1 ,0 ,0 ,0 ,0 ,1 ,0 ,2 ,0 ,2,27985 , 0 
49081.236,4,11 ,8 ,513 ,0 ,0 ,1 ,0 ,0 ,0 ,0 ,1 ,0 ,0 ,0 ,0,24447 , 0 
49081.289,7,11 ,16 ,777 ,0 ,0 ,0 ,4 ,0 ,0 ,0 ,4 ,0 ,9 ,0 ,9,37034 , 0 
49081.337,14,11 ,1 ,256 ,0 ,0 ,1 ,0 ,0 ,0 ,0 ,1 ,0 ,13 ,0 ,13,23718 , 0 
49081.35,15,11 ,11 ,1136 ,0 ,0 ,1 ,0 ,0 ,0 ,0 ,1 ,0 ,1 ,0 ,1,29236 , 0 
49081.36,20,11 ,5 ,825 ,0 ,0 ,2 ,0 ,0 ,0 ,0 ,2 ,0 ,2 ,0 ,2,26650 , 0 
49081.361,16,11 ,2 ,512 ,0 ,0 ,5 ,3 ,11 ,0 ,0 ,19 ,1 ,8 ,11 ,20,49012 , 0 
49081.444,10,11 ,14 ,512 ,0 ,0 ,6 ,0 ,0 ,0 ,0 ,6 ,0 ,1 ,0 ,1,25798 , 0 
49081.482,12,11 ,11 ,1094 ,0 ,0 ,2 ,0 ,0 ,0 ,0 ,2 ,0 ,3 ,0 ,3,29076 , 0 
49081.596,9,11 ,5 ,825 ,0 ,0 ,2 ,0 ,0 ,0 ,0 ,2 ,0 ,5 ,0 ,5,43822 , 0 
49081.602,5,11 ,19 ,512 ,0 ,0 ,1 ,0 ,0 ,0 ,0 ,1 ,0 ,6 ,0 ,6,44758 , 0 
49081.606,19,11 ,1 ,256 ,0 ,0 ,1 ,0 ,0 ,0 ,0 ,1 ,0 ,4 ,0 ,4,28875 , 0 
49081.696,17,11 ,16 ,777 ,0 ,0 ,4 ,3 ,0 ,0 ,0 ,7 ,0 ,4 ,0 ,4,33921 , 0 
49081.771,13,11 ,1 ,256 ,0 ,0 ,1 ,0 ,0 ,0 ,0 ,1 ,0 ,6 ,0 ,6,25370 , 0 
49081.787,3,11 ,1 ,256 ,0 ,0 ,1 ,0 ,0 ,0 ,0 ,1 ,0 ,1 ,0 ,1,18116 , 0 
49200.96,8,11 ,1 ,256 ,0 ,0 ,1 ,0 ,0 ,0 ,0 ,1 ,0 ,1 ,0 ,1,19976 , 0 
49201.078,11,11 ,5 ,825 ,0 ,0 ,1 ,0 ,0 ,0 ,0 ,1 ,0 ,1 ,0 ,1,31651 , 0 
49201.123,2,11 ,1 ,256 ,0 ,0 ,2 ,0 ,6 ,0 ,0 ,8 ,0 ,4 ,6 ,10,36741 , 0 
49201.138,6,11 ,16 ,791 ,0 ,0 ,2 ,1 ,0 ,0 ,0 ,3 ,0 ,5 ,0 ,5,51489 , 0 
49201.214,18,11 ,19 ,512 ,0 ,0 ,2 ,0 ,0 ,0 ,0 ,2 ,0 ,1 ,0 ,1,25338 , 0 
49201.236,4,11 ,8 ,512 ,0 ,0 ,1 ,0 ,0 ,0 ,0 ,1 ,0 ,2 ,0 ,2,22849 , 0 
49201.289,7,11 ,16 ,791 ,0 ,0 ,1 ,1 ,0 ,0 ,0 ,2 ,0 ,3 ,0 ,3,37042 , 0 
49201.337,14,11 ,1 ,256 ,0 ,0 ,0 ,0 ,0 ,0 ,0 ,0 ,0 ,4 ,0 ,4,23177 , 0 
49201.35,15,11 ,11 ,1136 ,0 ,0 ,2 ,0 ,0 ,0 ,0 ,2 ,0 ,0 ,0 ,0,28588 , 0 
49201.36,20,11 ,5 ,825 ,0 ,0 ,0 ,0 ,0 ,0 ,0 ,0 ,0 ,0 ,0 ,0,24538 , 0 
49201.36,16,11 ,2 ,512 ,0 ,0 ,2 ,2 ,4 ,0 ,0 ,8 ,0 ,3 ,4 ,7,52701 , 0 
49201.444,10,11 ,14 ,512 ,0 ,0 ,3 ,0 ,0 ,0 ,0 ,3 ,0 ,1 ,0 ,1,26557 , 0 
49201.482,12,11 ,11 ,1094 ,0 ,0 ,1 ,0 ,0 ,0 ,0 ,1 ,0 ,1 ,0 ,1,26836 , 0 
49201.596,9,11 ,5 ,825 ,0 ,0 ,1 ,0 ,0 ,0 ,0 ,1 ,0 ,2 ,0 ,2,45596 , 0 
49201.602,5,11 ,19 ,512 ,0 ,0 ,1 ,0 ,0 ,0 ,0 ,1 ,0 ,5 ,0 ,5,44004 , 0 
49201.606,19,11 ,1 ,256 ,0 ,0 ,1 ,0 ,0 ,0 ,0 ,1 ,0 ,2 ,0 ,2,27773 , 0 
49201.696,17,11 ,16 ,784 ,0 ,0 ,3 ,2 ,0 ,0 ,0 ,5 ,0 ,4 ,0 ,4,34329 , 0 
49201.771,13,11 ,1 ,256 ,0 ,0 ,2 ,0 ,0 ,0 ,0 ,2 ,0 ,1 ,0 ,1,24850 , 0 
49201.787,3,11 ,1 ,256 ,0 ,0 ,1 ,0 ,0 ,0 ,0 ,1 ,0 ,0 ,0 ,0,17479 , 0 
49320.96,8,11 ,1 ,256 ,0 ,0 ,1 ,0 ,0 ,0 ,0 ,1 ,0 ,1 ,0 ,1,20441 , 0 
49321.078,11,11 ,5 ,825 ,0 ,0 ,2 ,0 ,0 ,0 ,0 ,2 ,0 ,3 ,0 ,3,32924 , 0 
49321.123,2,11 ,1 ,256 ,0 ,0 ,1 ,0 ,3 ,0 ,0 ,4 ,0 ,2 ,3 ,5,35132 , 0 
49321.138,6,11 ,16 ,806 ,0 ,0 ,1 ,1 ,0 ,0 ,0 ,2 ,0 ,3 ,0 ,3,44209 , 0 
49321.214,18,11 ,19 ,512 ,0 ,0 ,1 ,1 ,0 ,0 ,0 ,2 ,0 ,1 ,0 ,1,28072 , 0 
49321.236,4,11 ,8 ,512 ,0 ,0 ,1 ,0 ,0 ,0 ,0 ,1 ,0 ,1 ,0 ,1,24516 , 0 
49321.289,7,11 ,16 ,806 ,0 ,0 ,2 ,1 ,0 ,0 ,0 ,3 ,0 ,4 ,0 ,4,37127 , 0 
49321.337,14,11 ,1 ,256 ,0 ,0 ,2 ,0 ,0 ,0 ,0 ,2 ,0 ,0 ,0 ,0,23801 , 0 
49321.35,15,11 ,11 ,1135 ,0 ,0 ,2 ,0 ,0 ,0 ,0 ,2 ,0 ,4 ,0 ,4,29308 , 0 
49321.36,20,11 ,5 ,825 ,0 ,0 ,2 ,0 ,0 ,0 ,0 ,2 ,0 ,1 ,0 ,1,26725 , 0 
49321.36,16,11 ,2 ,512 ,0 ,0 ,1 ,0 ,3 ,0 ,0 ,4 ,0 ,1 ,3 ,4,49135 , 0 
49321.444,10,11 ,14 ,512 ,0 ,0 ,1 ,0 ,0 ,0 ,0 ,1 ,0 ,0 ,0 ,0,25856 , 0 
49321.482,12,11 ,11 ,1135 ,0 ,0 ,1 ,0 ,0 ,0 ,0 ,1 ,0 ,2 ,0 ,2,29156 , 0 
49321.596,9,11 ,5 ,825 ,0 ,0 ,1 ,0 ,0 ,0 ,0 ,1 ,0 ,4 ,0 ,4,43926 , 0 
49321.602,5,11 ,19 ,512 ,0 ,0 ,1 ,0 ,0 ,0 ,0 ,1 ,0 ,5 ,0 ,5,44871 , 0 
49321.606,19,11 ,1 ,256 ,0 ,0 ,1 ,0 ,1 ,0 ,0 ,2 ,0 ,2 ,1 ,3,28945 , 0 
49321.696,17,11 ,16 ,806 ,0 ,0 ,1 ,1 ,0 ,0 ,0 ,2 ,0 ,1 ,0 ,1,33992 , 0 
49321.771,13,11 ,1 ,256 ,0 ,0 ,0 ,0 ,0 ,0 ,0 ,0 ,0 ,3 ,0 ,3,25452 , 0 
49321.787,3,11 ,1 ,256 ,0 ,0 ,1 ,0 ,0 ,0 ,0 ,1 ,0 ,1 ,0 ,1,18174 , 0 
49440.965,8,11 ,1 ,256 ,0 ,0 ,2 ,0 ,0 ,0 ,0 ,2 ,0 ,2 ,0 ,2,20061 , 0 
49441.078,11,11 ,5 ,795 ,0 ,0 ,1 ,0 ,0 ,0 ,0 ,1 ,0 ,14 ,0 ,14,31728 , 0 
49441.124,2,11 ,1 ,256 ,0 ,0 ,10 ,0 ,22 ,1 ,3 ,36 ,0 ,14 ,28 ,42,36920 , 0 
49441.138,6,11 ,2 ,512 ,0 ,0 ,12 ,8 ,9 ,1 ,0 ,30 ,0 ,21 ,9 ,30,51784 , 0 
49441.214,18,11 ,19 ,512 ,0 ,0 ,0 ,0 ,0 ,0 ,0 ,0 ,0 ,0 ,0 ,0,25404 , 0 
49441.236,4,11 ,8 ,512 ,0 ,0 ,2 ,0 ,0 ,0 ,0 ,2 ,0 ,1 ,0 ,1,22933 , 0 
49441.289,7,11 ,9 ,1117 ,0 ,0 ,9 ,9 ,0 ,1 ,0 ,19 ,0 ,23 ,0 ,23,37222 , 0 
49441.337,14,11 ,1 ,256 ,0 ,0 ,1 ,0 ,0 ,0 ,0 ,1 ,0 ,10 ,0 ,10,23246 , 0 
49441.35,15,11 ,11 ,1135 ,0 ,0 ,1 ,0 ,0 ,0 ,0 ,1 ,0 ,17 ,0 ,17,28660 , 0 
49441.36,20,11 ,5 ,825 ,0 ,0 ,1 ,0 ,0 ,0 ,0 ,1 ,0 ,1 ,0 ,1,24618 , 0 
49441.36,16,11 ,2 ,512 ,0 ,0 ,6 ,5 ,0 ,3 ,3 ,17 ,0 ,41 ,3 ,44,52899 , 1 
49441.444,10,11 ,14 ,512 ,0 ,0 ,2 ,0 ,0 ,0 ,0 ,2 ,0 ,10 ,0 ,10,26643 , 0 
49441.482,12,11 ,11 ,1135 ,0 ,0 ,1 ,0 ,0 ,0 ,0 ,1 ,0 ,0 ,0 ,0,26907 , 0 
49441.596,9,11 ,5 ,825 ,0 ,0 ,13 ,0 ,9 ,0 ,0 ,22 ,0 ,13 ,9 ,22,45826 , 0 
49441.603,5,11 ,19 ,512 ,0 ,0 ,1 ,0 ,9 ,0 ,0 ,10 ,0 ,18 ,9 ,27,44174 , 0 
49441.607,19,11 ,1 ,256 ,0 ,0 ,1 ,0 ,9 ,0 ,0 ,10 ,0 ,10 ,9 ,19,27886 , 0 
49441.697,17,11 ,6 ,848 ,0 ,0 ,11 ,9 ,0 ,1 ,0 ,21 ,0 ,21 ,0 ,21,34547 , 0 
49441.771,13,11 ,1 ,256 ,0 ,0 ,1 ,0 ,0 ,0 ,0 ,1 ,0 ,8 ,0 ,8,24923 , 0 
49441.831,3,11 ,1 ,256 ,0 ,0 ,1 ,0 ,0 ,0 ,0 ,1 ,0 ,2 ,0 ,2,17556 , 0 
49560.96,8,11 ,1 ,256 ,0 ,0 ,2 ,0 ,1 ,0 ,0 ,3 ,0 ,2 ,1 ,3,20504 , 0 
49561.078,11,11 ,5 ,795 ,0 ,0 ,1 ,1 ,1 ,0 ,0 ,3 ,0 ,4 ,1 ,5,33011 , 0 
49561.124,2,11 ,1 ,256 ,0 ,0 ,6 ,0 ,11 ,0 ,0 ,17 ,0 ,6 ,11 ,17,35281 , 0 
49561.138,6,11 ,2 ,512 ,0 ,0 ,5 ,3 ,4 ,0 ,0 ,12 ,0 ,7 ,4 ,11,44351 , 0 
49561.214,18,11 ,19 ,512 ,0 ,0 ,2 ,0 ,0 ,0 ,0 ,2 ,0 ,2 ,0 ,2,28170 , 0 
49561.236,4,11 ,8 ,512 ,0 ,0 ,1 ,1 ,0 ,0 ,0 ,2 ,0 ,1 ,0 ,1,24583 , 0 
49561.289,7,11 ,9 ,1129 ,0 ,0 ,6 ,4 ,0 ,0 ,0 ,10 ,0 ,7 ,0 ,7,37258 , 0 
49561.337,14,11 ,1 ,256 ,0 ,0 ,1 ,0 ,0 ,0 ,0 ,1 ,0 ,8 ,0 ,8,23875 , 0 
49561.35,15,11 ,11 ,1135 ,0 ,0 ,2 ,0 ,0 ,0 ,0 ,2 ,0 ,8 ,0 ,8,29408 , 0 
49561.36,20,11 ,5 ,825 ,0 ,0 ,1 ,0 ,0 ,0 ,0 ,1 ,0 ,0 ,0 ,0,26782 , 0 
49561.36,16,11 ,2 ,512 ,0 ,0 ,2 ,4 ,0 ,0 ,0 ,6 ,0 ,16 ,0 ,16,49249 , 1 
49561.444,10,11 ,14 ,512 ,0 ,0 ,1 ,0 ,0 ,0 ,0 ,1 ,0 ,4 ,0 ,4,25910 , 0 
49561.482,12,11 ,11 ,1089 ,0 ,0 ,1 ,1 ,0 ,0 ,0 ,2 ,0 ,2 ,0 ,2,29256 , 0 
49561.596,9,11 ,5 ,825 ,0 ,0 ,4 ,0 ,4 ,0 ,0 ,8 ,0 ,3 ,4 ,7,44074 , 0 
49561.603,5,11 ,19 ,512 ,0 ,0 ,1 ,0 ,6 ,0 ,0 ,7 ,0 ,11 ,6 ,17,45043 , 0 
49561.606,19,11 ,1 ,256 ,0 ,0 ,1 ,0 ,6 ,0 ,0 ,7 ,0 ,7 ,6 ,13,29041 , 0 
49561.696,17,11 ,6 ,842 ,0 ,0 ,2 ,5 ,0 ,0 ,0 ,7 ,0 ,9 ,0 ,9,34132 , 0 
49561.771,13,11 ,1 ,256 ,0 ,0 ,2 ,0 ,0 ,0 ,0 ,2 ,0 ,6 ,0 ,6,25560 , 0 
49561.787,3,11 ,1 ,256 ,0 ,0 ,2 ,0 ,0 ,0 ,0 ,2 ,0 ,1 ,0 ,1,18232 , 0 
49680.96,8,11 ,1 ,256 ,0 ,0 ,0 ,0 ,0 ,0 ,0 ,0 ,0 ,1 ,0 ,1,20122 , 0 
49681.078,11,11 ,5 ,795 ,0 ,0 ,1 ,0 ,0 ,0 ,0 ,1 ,0 ,5 ,0 ,5,31800 , 0 
49681.124,2,11 ,1 ,256 ,0 ,0 ,5 ,0 ,12 ,0 ,0 ,17 ,0 ,7 ,12 ,19,37051 , 0 
49681.138,6,11 ,2 ,512 ,0 ,0 ,8 ,5 ,5 ,0 ,0 ,18 ,0 ,12 ,5 ,17,51996 , 0 
49681.214,18,11 ,19 ,512 ,0 ,0 ,1 ,0 ,0 ,0 ,0 ,1 ,0 ,2 ,0 ,2,25486 , 0 
49681.236,4,11 ,8 ,512 ,0 ,0 ,2 ,0 ,0 ,0 ,0 ,2 ,0 ,2 ,0 ,2,23008 , 0 
49681.289,7,11 ,9 ,1134 ,0 ,0 ,4 ,4 ,0 ,0 ,0 ,8 ,0 ,10 ,0 ,10,37346 , 0 
49681.337,14,11 ,1 ,256 ,0 ,0 ,1 ,0 ,0 ,0 ,0 ,1 ,0 ,4 ,0 ,4,23332 , 0 
49681.35,15,11 ,11 ,1135 ,0 ,0 ,1 ,0 ,0 ,0 ,0 ,1 ,0 ,8 ,0 ,8,28730 , 0 
49681.36,20,11 ,5 ,825 ,0 ,0 ,1 ,0 ,0 ,0 ,0 ,1 ,0 ,1 ,0 ,1,24730 , 0 
49681.36,16,11 ,2 ,512 ,0 ,0 ,2 ,2 ,0 ,0 ,0 ,4 ,0 ,21 ,0 ,21,53035 , 1 
49681.444,10,11 ,14 ,512 ,0 ,0 ,1 ,0 ,0 ,0 ,0 ,1 ,0 ,8 ,0 ,8,26714 , 0 
49681.482,12,11 ,11 ,1089 ,0 ,0 ,2 ,0 ,0 ,0 ,0 ,2 ,0 ,1 ,0 ,1,27026 , 0 
49681.596,9,11 ,5 ,825 ,0 ,0 ,6 ,0 ,4 ,0 ,0 ,10 ,0 ,5 ,4 ,9,45983 , 0 
49681.603,5,11 ,19 ,512 ,0 ,0 ,1 ,0 ,4 ,0 ,0 ,5 ,0 ,8 ,4 ,12,44331 , 0 
49681.606,19,11 ,1 ,256 ,0 ,0 ,1 ,0 ,4 ,0 ,0 ,5 ,0 ,3 ,4 ,7,27962 , 0 
49681.696,17,11 ,6 ,824 ,0 ,0 ,6 ,5 ,0 ,0 ,0 ,11 ,0 ,9 ,0 ,9,34699 , 0 
49681.771,13,11 ,1 ,256 ,0 ,0 ,2 ,0 ,0 ,0 ,0 ,2 ,0 ,4 ,0 ,4,25006 , 0 
49681.787,3,11 ,1 ,256 ,0 ,0 ,1 ,0 ,0 ,0 ,0 ,1 ,0 ,0 ,0 ,0,17610 , 0 
49800.96,8,11 ,1 ,256 ,0 ,0 ,1 ,0 ,0 ,0 ,0 ,1 ,0 ,0 ,0 ,0,20571 , 0 
49801.078,11,11 ,5 ,798 ,0 ,0 ,1 ,0 ,0 ,0 ,0 ,1 ,0 ,4 ,0 ,4,33099 , 0 
49801.123,2,11 ,1 ,256 ,0 ,0 ,3 ,0 ,6 ,0 ,0 ,9 ,0 ,3 ,6 ,9,35380 , 0 
49801.138,6,11 ,2 ,512 ,0 ,0 ,3 ,2 ,2 ,0 ,0 ,7 ,0 ,2 ,2 ,4,44465 , 0 
49801.214,18,11 ,19 ,512 ,0 ,0 ,1 ,0 ,0 ,0 ,0 ,1 ,0 ,1 ,0 ,1,28239 , 0 
49801.236,4,11 ,8 ,512 ,0 ,0 ,1 ,0 ,0 ,0 ,0 ,1 ,0 ,0 ,0 ,0,24649 , 0 
49801.289,7,11 ,16 ,794 ,0 ,0 ,7 ,1 ,0 ,1 ,0 ,9 ,0 ,2 ,0 ,2,37390 , 0 
49801.337,14,11 ,1 ,256 ,0 ,0 ,1 ,0 ,0 ,0 ,0 ,1 ,0 ,4 ,0 ,4,23944 , 0 
49801.35,15,11 ,11 ,1135 ,0 ,0 ,1 ,0 ,0 ,0 ,0 ,1 ,0 ,6 ,0 ,6,29474 , 0 
49801.36,20,11 ,5 ,825 ,0 ,0 ,1 ,0 ,0 ,0 ,0 ,1 ,0 ,0 ,0 ,0,26849 , 0 
49801.36,16,11 ,2 ,512 ,0 ,0 ,1 ,1 ,1 ,0 ,0 ,3 ,0 ,10 ,1 ,11,49342 , 0 
49801.444,10,11 ,14 ,512 ,0 ,0 ,1 ,0 ,0 ,0 ,0 ,1 ,0 ,2 ,0 ,2,25966 , 0 
49801.482,12,11 ,11 ,1089 ,0 ,0 ,1 ,0 ,0 ,0 ,0 ,1 ,0 ,1 ,0 ,1,29313 , 0 
49801.596,9,11 ,5 ,825 ,0 ,0 ,1 ,0 ,0 ,1 ,1 ,3 ,0 ,5 ,1 ,6,44170 , 0 
49801.602,5,11 ,19 ,512 ,0 ,0 ,1 ,0 ,0 ,1 ,1 ,3 ,0 ,3 ,2 ,5,45146 , 0 
49801.606,19,11 ,1 ,256 ,0 ,0 ,0 ,0 ,0 ,1 ,1 ,2 ,0 ,3 ,2 ,5,29146 , 0 
49801.696,17,11 ,6 ,800 ,0 ,0 ,1 ,2 ,0 ,0 ,0 ,3 ,0 ,8 ,0 ,8,34224 , 0 
49801.771,13,11 ,1 ,256 ,0 ,0 ,1 ,0 ,0 ,0 ,0 ,1 ,0 ,3 ,0 ,3,25636 , 0 
49801.787,3,11 ,1 ,256 ,0 ,0 ,1 ,0 ,0 ,0 ,0 ,1 ,0 ,0 ,0 ,0,18287 , 0 
49920.96,8,11 ,1 ,256 ,0 ,0 ,2 ,0 ,0 ,0 ,0 ,2 ,0 ,1 ,0 ,1,20198 , 0 
49921.078,11,11 ,5 ,798 ,0 ,0 ,2 ,0 ,0 ,0 ,0 ,2 ,0 ,2 ,0 ,2,31873 , 0 
49921.123,2,11 ,1 ,256 ,0 ,0 ,1 ,0 ,4 ,0 ,1 ,6 ,0 ,2 ,6 ,8,37134 , 0 
49921.138,6,11 ,2 ,512 ,0 ,0 ,2 ,0 ,1 ,1 ,1 ,5 ,0 ,6 ,2 ,8,52100 , 0 
49921.214,18,11 ,19 ,512 ,0 ,0 ,1 ,0 ,0 ,0 ,0 ,1 ,0 ,1 ,0 ,1,25562 , 0 
49921.236,4,11 ,8 ,512 ,0 ,0 ,1 ,0 ,0 ,0 ,0 ,1 ,0 ,1 ,0 ,1,23065 , 0 
49921.289,7,11 ,16 ,788 ,0 ,0 ,1 ,1 ,0 ,0 ,0 ,2 ,0 ,6 ,0 ,6,37415 , 0 
49921.337,14,11 ,1 ,256 ,0 ,0 ,1 ,0 ,0 ,0 ,0 ,1 ,0 ,1 ,0 ,1,23410 , 0 
49921.35,15,11 ,11 ,1078 ,0 ,0 ,1 ,0 ,0 ,0 ,0 ,1 ,0 ,4 ,0 ,4,28799 , 0 
49921.36,20,11 ,5 ,825 ,0 ,0 ,1 ,0 ,0 ,0 ,0 ,1 ,0 ,0 ,0 ,0,24796 , 0 
49921.36,16,11 ,2 ,512 ,0 ,0 ,2 ,0 ,3 ,0 ,0 ,5 ,0 ,7 ,3 ,10,53135 , 0 
49921.444,10,11 ,14 ,512 ,0 ,0 ,2 ,0 ,0 ,0 ,0 ,2 ,0 ,1 ,0 ,1,26788 , 0 
49921.482,12,11 ,11 ,1078 ,0 ,0 ,1 ,0 ,0 ,0 ,0 ,1 ,0 ,1 ,0 ,1,27100 , 0 
49921.596,9,11 ,5 ,825 ,0 ,0 ,2 ,0 ,0 ,0 ,0 ,2 ,0 ,2 ,0 ,2,46067 , 0 
49921.602,5,11 ,19 ,512 ,0 ,0 ,1 ,0 ,0 ,0 ,0 ,1 ,0 ,4 ,0 ,4,44430 , 0 
49921.606,19,11 ,1 ,256 ,0 ,0 ,1 ,0 ,0 ,0 ,0 ,1 ,0 ,2 ,0 ,2,28033 , 0 
49921.696,17,11 ,16 ,784 ,0 ,0 ,6 ,3 ,0 ,1 ,0 ,10 ,0 ,5 ,0 ,5,34810 , 0 
49921.771,13,11 ,1 ,256 ,0 ,0 ,1 ,0 ,0 ,0 ,0 ,1 ,0 ,1 ,0 ,1,25079 , 0 
49921.787,3,11 ,1 ,256 ,0 ,0 ,1 ,0 ,0 ,0 ,0 ,1 ,0 ,2 ,0 ,2,17679 , 0 
50040.96,8,11 ,1 ,256 ,0 ,0 ,1 ,0 ,0 ,0 ,0 ,1 ,0 ,1 ,0 ,1,20638 , 0 
50041.078,11,11 ,5 ,798 ,0 ,0 ,0 ,0 ,1 ,0 ,0 ,1 ,0 ,1 ,1 ,2,33159 , 0 
50041.123,2,11 ,1 ,256 ,0 ,0 ,1 ,0 ,0 ,0 ,0 ,1 ,0 ,1 ,0 ,1,35483 , 0 
50041.138,6,11 ,2 ,512 ,0 ,0 ,2 ,0 ,0 ,0 ,0 ,2 ,0 ,3 ,0 ,3,44539 , 0 
50041.214,18,11 ,19 ,512 ,0 ,0 ,1 ,0 ,0 ,0 ,0 ,1 ,0 ,0 ,0 ,0,28308 , 0 
50041.236,4,11 ,8 ,512 ,0 ,0 ,1 ,0 ,0 ,0 ,0 ,1 ,0 ,1 ,0 ,1,24734 , 0 
50041.289,7,11 ,16 ,788 ,0 ,0 ,2 ,0 ,0 ,0 ,0 ,2 ,0 ,4 ,0 ,4,37465 , 0 
50041.337,14,11 ,1 ,256 ,0 ,0 ,1 ,0 ,0 ,0 ,0 ,1 ,0 ,0 ,0 ,0,24030 , 0 
50041.35,15,11 ,11 ,1078 ,0 ,0 ,1 ,1 ,0 ,0 ,0 ,2 ,0 ,2 ,0 ,2,29538 , 0 
50041.36,20,11 ,5 ,825 ,0 ,0 ,1 ,0 ,0 ,0 ,0 ,1 ,0 ,1 ,0 ,1,26914 , 0 
50041.36,16,11 ,2 ,512 ,0 ,0 ,1 ,0 ,0 ,0 ,0 ,1 ,0 ,4 ,0 ,4,49444 , 0 
50041.444,10,11 ,14 ,512 ,0 ,0 ,1 ,0 ,0 ,0 ,0 ,1 ,0 ,0 ,0 ,0,26024 , 0 
50041.482,12,11 ,11 ,1078 ,0 ,0 ,1 ,0 ,0 ,0 ,0 ,1 ,0 ,2 ,0 ,2,29396 , 0 
50041.596,9,11 ,5 ,825 ,0 ,0 ,2 ,0 ,0 ,0 ,0 ,2 ,0 ,2 ,0 ,2,44267 , 0 
50041.602,5,11 ,19 ,512 ,0 ,0 ,1 ,0 ,1 ,0 ,0 ,2 ,0 ,2 ,1 ,3,45246 , 0 
50041.606,19,11 ,1 ,256 ,0 ,0 ,1 ,0 ,1 ,0 ,0 ,2 ,0 ,2 ,1 ,3,29234 , 0 
50041.696,17,11 ,16 ,784 ,0 ,0 ,2 ,0 ,0 ,0 ,0 ,2 ,0 ,3 ,0 ,3,34294 , 0 
50041.771,13,11 ,1 ,256 ,0 ,0 ,0 ,0 ,0 ,0 ,0 ,0 ,0 ,1 ,0 ,1,25705 , 0 
50041.787,3,11 ,1 ,256 ,0 ,0 ,1 ,0 ,0 ,0 ,0 ,1 ,0 ,0 ,0 ,0,18348 , 0 
50160.96,8,11 ,1 ,256 ,0 ,0 ,0 ,0 ,0 ,0 ,0 ,0 ,0 ,1 ,0 ,1,20260 , 0 
50161.078,11,11 ,5 ,807 ,0 ,0 ,2 ,0 ,0 ,0 ,0 ,2 ,0 ,7 ,0 ,7,31964 , 0 
50161.123,2,11 ,1 ,256 ,0 ,0 ,2 ,0 ,5 ,0 ,2 ,9 ,0 ,3 ,7 ,10,37238 , 0 
50161.138,6,11 ,2 ,512 ,0 ,0 ,2 ,1 ,3 ,0 ,0 ,6 ,0 ,6 ,3 ,9,52204 , 0 
50161.214,18,11 ,19 ,512 ,0 ,0 ,2 ,0 ,0 ,0 ,0 ,2 ,0 ,3 ,0 ,3,25641 , 0 
50161.236,4,11 ,8 ,512 ,0 ,0 ,1 ,0 ,0 ,0 ,0 ,1 ,0 ,1 ,0 ,1,23136 , 0 
50161.289,7,11 ,17 ,1118 ,0 ,0 ,3 ,2 ,0 ,1 ,0 ,6 ,0 ,5 ,0 ,5,37529 , 0 
50161.337,14,11 ,1 ,256 ,0 ,0 ,1 ,0 ,0 ,0 ,0 ,1 ,0 ,3 ,0 ,3,23477 , 0 
50161.35,15,11 ,11 ,1078 ,0 ,0 ,2 ,0 ,0 ,0 ,0 ,2 ,0 ,3 ,0 ,3,28873 , 0 
50161.36,20,11 ,5 ,825 ,0 ,0 ,2 ,0 ,0 ,0 ,0 ,2 ,0 ,1 ,0 ,1,24869 , 0 
50161.36,16,11 ,2 ,512 ,0 ,0 ,2 ,1 ,0 ,0 ,2 ,5 ,0 ,7 ,2 ,9,53244 , 1 
50161.444,10,11 ,14 ,512 ,0 ,0 ,1 ,0 ,0 ,0 ,0 ,1 ,0 ,2 ,0 ,2,26844 , 0 
50161.482,12,11 ,11 ,1084 ,0 ,0 ,3 ,0 ,0 ,0 ,0 ,3 ,0 ,3 ,0 ,3,27174 , 0 
50161.596,9,11 ,5 ,825 ,0 ,0 ,1 ,0 ,0 ,0 ,0 ,1 ,0 ,5 ,0 ,5,46137 , 0 
50161.602,5,11 ,19 ,512 ,0 ,0 ,1 ,0 ,0 ,0 ,0 ,1 ,0 ,6 ,0 ,6,44531 , 0 
50161.606,19,11 ,1 ,256 ,0 ,0 ,1 ,0 ,0 ,0 ,0 ,1 ,0 ,2 ,0 ,2,28130 , 0 
50161.696,17,11 ,6 ,806 ,0 ,0 ,4 ,1 ,2 ,1 ,0 ,8 ,0 ,4 ,2 ,6,34926 , 0 
50161.771,13,11 ,1 ,256 ,0 ,0 ,2 ,0 ,0 ,0 ,0 ,2 ,0 ,1 ,0 ,1,25170 , 0 
50161.787,3,11 ,1 ,256 ,0 ,0 ,0 ,0 ,0 ,0 ,0 ,0 ,0 ,1 ,0 ,1,17729 , 0 
50280.96,8,11 ,1 ,256 ,0 ,0 ,1 ,1 ,0 ,0 ,0 ,2 ,0 ,2 ,0 ,2,20712 , 0 
50281.078,11,11 ,5 ,807 ,0 ,0 ,2 ,0 ,0 ,0 ,0 ,2 ,0 ,0 ,0 ,0,33239 , 0 
50281.123,2,11 ,1 ,256 ,0 ,0 ,2 ,1 ,3 ,0 ,0 ,6 ,0 ,1 ,5 ,6,35578 , 0 
50281.138,6,11 ,2 ,512 ,0 ,0 ,1 ,0 ,3 ,0 ,0 ,4 ,0 ,5 ,3 ,8,44634 , 0 
50281.214,18,11 ,19 ,512 ,0 ,0 ,1 ,0 ,0 ,0 ,0 ,1 ,0 ,1 ,0 ,1,28370 , 0 
50281.236,4,11 ,8 ,512 ,0 ,0 ,1 ,0 ,0 ,0 ,0 ,1 ,0 ,0 ,0 ,0,24798 , 0 
50281.289,7,11 ,17 ,1098 ,0 ,0 ,3 ,3 ,0 ,0 ,0 ,6 ,0 ,4 ,0 ,4,37548 , 0 
50281.337,14,11 ,1 ,256 ,0 ,0 ,1 ,1 ,1 ,0 ,0 ,3 ,0 ,2 ,1 ,3,24104 , 0 
50281.35,15,11 ,11 ,1104 ,0 ,0 ,1 ,0 ,0 ,0 ,0 ,1 ,0 ,6 ,0 ,6,29623 , 0 
50281.36,20,11 ,5 ,825 ,0 ,0 ,1 ,0 ,0 ,0 ,0 ,1 ,0 ,1 ,0 ,1,26975 , 0 
50281.36,16,11 ,2 ,512 ,0 ,0 ,0 ,0 ,0 ,2 ,0 ,2 ,0 ,7 ,0 ,7,49535 , 1 
50281.444,10,11 ,14 ,512 ,0 ,0 ,2 ,1 ,0 ,0 ,0 ,3 ,0 ,2 ,0 ,2,26119 , 0 
50281.482,12,11 ,11 ,1104 ,0 ,0 ,0 ,0 ,0 ,0 ,0 ,0 ,0 ,2 ,0 ,2,29462 , 0 
50281.596,9,11 ,5 ,825 ,0 ,0 ,1 ,0 ,0 ,0 ,0 ,1 ,0 ,4 ,0 ,4,44342 , 0 
50281.606,19,11 ,1 ,256 ,0 ,0 ,1 ,1 ,0 ,0 ,0 ,2 ,0 ,4 ,0 ,4,29303 , 0 
50281.628,5,11 ,19 ,512 ,0 ,0 ,2 ,0 ,0 ,0 ,0 ,2 ,0 ,2 ,0 ,2,45332 , 0 
50281.696,17,11 ,6 ,806 ,0 ,0 ,4 ,0 ,3 ,0 ,0 ,7 ,0 ,3 ,3 ,6,34383 , 0 
50281.771,13,11 ,1 ,256 ,0 ,0 ,1 ,1 ,0 ,0 ,0 ,2 ,0 ,2 ,0 ,2,25767 , 0 
50281.786,3,11 ,1 ,256 ,0 ,0 ,1 ,1 ,0 ,0 ,0 ,2 ,0 ,2 ,0 ,2,18409 , 0 
50400.96,8,11 ,1 ,256 ,0 ,0 ,1 ,0 ,0 ,0 ,0 ,1 ,0 ,0 ,0 ,0,20319 , 0 
50401.078,11,11 ,5 ,807 ,0 ,0 ,1 ,0 ,0 ,0 ,0 ,1 ,0 ,2 ,0 ,2,32029 , 0 
50401.123,2,11 ,1 ,256 ,0 ,0 ,1 ,0 ,3 ,0 ,0 ,4 ,0 ,2 ,3 ,5,37331 , 0 
50401.138,6,11 ,2 ,512 ,0 ,0 ,1 ,0 ,3 ,0 ,0 ,4 ,0 ,1 ,3 ,4,52294 , 0 
50401.214,18,11 ,19 ,512 ,0 ,0 ,2 ,0 ,0 ,0 ,0 ,2 ,0 ,0 ,0 ,0,25721 , 0 
50401.236,4,11 ,8 ,512 ,0 ,0 ,1 ,0 ,0 ,0 ,0 ,1 ,0 ,0 ,0 ,0,23203 , 0 
50401.289,7,11 ,17 ,1063 ,0 ,0 ,2 ,2 ,0 ,0 ,0 ,4 ,0 ,4 ,0 ,4,37616 , 0 
50401.337,14,11 ,1 ,256 ,0 ,0 ,0 ,0 ,0 ,0 ,0 ,0 ,0 ,3 ,0 ,3,23550 , 0 
50401.35,15,11 ,11 ,1104 ,0 ,0 ,1 ,0 ,0 ,0 ,0 ,1 ,0 ,2 ,0 ,2,28932 , 0 
50401.36,20,11 ,5 ,825 ,0 ,0 ,1 ,0 ,0 ,0 ,0 ,1 ,0 ,1 ,0 ,1,24927 , 0 
50401.36,16,11 ,2 ,512 ,0 ,0 ,1 ,0 ,0 ,0 ,0 ,1 ,0 ,4 ,0 ,4,53321 , 1 
50401.444,10,11 ,14 ,512 ,0 ,0 ,0 ,0 ,0 ,0 ,0 ,0 ,0 ,0 ,0 ,0,26893 , 0 
50401.482,12,11 ,11 ,1104 ,0 ,0 ,1 ,0 ,0 ,0 ,0 ,1 ,0 ,2 ,0 ,2,27242 , 0 
50401.596,9,11 ,5 ,825 ,0 ,0 ,2 ,0 ,0 ,0 ,0 ,2 ,0 ,3 ,0 ,3,46231 , 0 
50401.602,5,11 ,19 ,512 ,0 ,0 ,1 ,0 ,0 ,0 ,0 ,1 ,0 ,3 ,0 ,3,44636 , 0 
50401.606,19,11 ,1 ,256 ,0 ,0 ,1 ,0 ,0 ,0 ,0 ,1 ,0 ,2 ,0 ,2,28214 , 0 
50401.696,17,11 ,6 ,782 ,0 ,0 ,2 ,1 ,2 ,0 ,0 ,5 ,0 ,2 ,2 ,4,35010 , 0 
50401.771,13,11 ,1 ,256 ,0 ,0 ,1 ,0 ,0 ,0 ,0 ,1 ,0 ,0 ,0 ,0,25242 , 0 
50401.786,3,11 ,1 ,256 ,0 ,0 ,1 ,0 ,0 ,0 ,0 ,1 ,0 ,0 ,0 ,0,17794 , 0 
50520.96,8,11 ,1 ,256 ,0 ,0 ,1 ,0 ,0 ,0 ,0 ,1 ,0 ,2 ,0 ,2,20771 , 0 
50521.078,11,11 ,5 ,807 ,0 ,0 ,1 ,0 ,0 ,0 ,0 ,1 ,0 ,0 ,0 ,0,33309 , 0 
50521.123,2,11 ,1 ,256 ,0 ,0 ,1 ,0 ,1 ,0 ,1 ,3 ,0 ,3 ,3 ,6,35672 , 0 
50521.138,6,11 ,2 ,512 ,0 ,0 ,3 ,0 ,0 ,1 ,1 ,5 ,0 ,1 ,2 ,3,44742 , 0 
50521.214,18,11 ,19 ,512 ,0 ,0 ,0 ,0 ,0 ,0 ,0 ,0 ,0 ,2 ,0 ,2,28434 , 0 
50521.236,4,11 ,8 ,512 ,0 ,0 ,1 ,0 ,0 ,0 ,0 ,1 ,0 ,0 ,0 ,0,24858 , 0 
50521.289,7,11 ,16 ,771 ,0 ,0 ,5 ,1 ,0 ,1 ,0 ,7 ,0 ,1 ,0 ,1,37666 , 0 
50521.337,14,11 ,1 ,256 ,0 ,0 ,2 ,0 ,0 ,0 ,0 ,2 ,0 ,2 ,0 ,2,24171 , 0 
50521.35,15,11 ,11 ,1104 ,0 ,0 ,1 ,0 ,0 ,0 ,0 ,1 ,0 ,6 ,0 ,6,29690 , 0 
50521.36,20,11 ,5 ,825 ,0 ,0 ,1 ,0 ,0 ,0 ,0 ,1 ,0 ,1 ,0 ,1,27038 , 0 
50521.36,16,11 ,2 ,512 ,0 ,0 ,1 ,0 ,1 ,0 ,0 ,2 ,0 ,6 ,1 ,7,49615 , 0 
50521.444,10,11 ,14 ,512 ,0 ,0 ,2 ,0 ,0 ,0 ,0 ,2 ,0 ,2 ,0 ,2,26177 , 0 
50521.482,12,11 ,11 ,1104 ,0 ,0 ,2 ,0 ,0 ,0 ,0 ,2 ,0 ,0 ,0 ,0,29546 , 0 
50521.596,9,11 ,5 ,825 ,0 ,0 ,1 ,0 ,0 ,0 ,0 ,1 ,0 ,5 ,0 ,5,44417 , 0 
50521.602,5,11 ,19 ,512 ,0 ,0 ,1 ,0 ,0 ,0 ,0 ,1 ,0 ,2 ,0 ,2,45427 , 0 
50521.606,19,11 ,1 ,256 ,0 ,0 ,1 ,0 ,0 ,0 ,0 ,1 ,0 ,2 ,0 ,2,29386 , 0 
50521.696,17,11 ,6 ,801 ,0 ,0 ,1 ,0 ,0 ,1 ,1 ,3 ,0 ,4 ,1 ,5,34458 , 0 
50521.771,13,11 ,1 ,256 ,0 ,0 ,2 ,0 ,0 ,0 ,0 ,2 ,0 ,2 ,0 ,2,25865 , 0 
50521.787,3,11 ,1 ,256 ,0 ,0 ,2 ,0 ,0 ,0 ,0 ,2 ,0 ,1 ,0 ,1,18460 , 0 
50640.96,8,11 ,1 ,256 ,0 ,0 ,3 ,0 ,1 ,0 ,0 ,4 ,0 ,0 ,1 ,1,20406 , 0 
50641.078,11,11 ,5 ,807 ,0 ,0 ,0 ,0 ,0 ,0 ,0 ,0 ,0 ,0 ,0 ,0,32093 , 0 
50641.123,2,11 ,1 ,256 ,0 ,0 ,2 ,0 ,2 ,0 ,0 ,4 ,0 ,1 ,2 ,3,37409 , 0 
50641.138,6,11 ,2 ,512 ,0 ,0 ,0 ,1 ,0 ,0 ,0 ,1 ,0 ,4 ,0 ,4,52364 , 0 
50641.214,18,11 ,19 ,512 ,0 ,0 ,2 ,1 ,0 ,0 ,0 ,3 ,0 ,1 ,0 ,1,25801 , 0 
50641.236,4,11 ,8 ,512 ,0 ,0 ,1 ,1 ,0 ,0 ,0 ,2 ,0 ,2 ,0 ,2,23285 , 0 
50641.289,7,11 ,16 ,771 ,0 ,0 ,3 ,0 ,0 ,0 ,0 ,3 ,0 ,3 ,0 ,3,37691 , 0 
50641.337,14,11 ,1 ,256 ,0 ,0 ,1 ,0 ,0 ,0 ,0 ,1 ,0 ,4 ,0 ,4,23627 , 0 
50641.35,15,11 ,11 ,1104 ,0 ,0 ,0 ,0 ,0 ,0 ,0 ,0 ,0 ,2 ,0 ,2,28993 , 0 
50641.36,20,11 ,5 ,825 ,0 ,0 ,0 ,0 ,0 ,0 ,0 ,0 ,0 ,0 ,0 ,0,24986 , 0 
50641.36,16,11 ,2 ,512 ,0 ,0 ,1 ,1 ,0 ,0 ,0 ,2 ,0 ,4 ,0 ,4,53401 , 0 
50641.444,10,11 ,14 ,512 ,0 ,0 ,2 ,0 ,0 ,0 ,0 ,2 ,0 ,0 ,0 ,0,26954 , 0 
50641.482,12,11 ,11 ,1104 ,0 ,0 ,0 ,0 ,0 ,0 ,0 ,0 ,0 ,1 ,0 ,1,27310 , 0 
50641.596,9,11 ,5 ,825 ,0 ,0 ,1 ,0 ,0 ,0 ,0 ,1 ,0 ,3 ,0 ,3,46313 , 0 
50641.602,5,11 ,19 ,512 ,0 ,0 ,1 ,0 ,0 ,0 ,0 ,1 ,0 ,3 ,0 ,3,44727 , 0 
50641.606,19,11 ,1 ,256 ,0 ,0 ,1 ,0 ,1 ,0 ,0 ,2 ,0 ,4 ,1 ,5,28307 , 0 
50641.696,17,11 ,6 ,801 ,0 ,0 ,2 ,0 ,0 ,0 ,0 ,2 ,0 ,2 ,0 ,2,35089 , 0 
50641.771,13,11 ,1 ,256 ,0 ,0 ,1 ,0 ,0 ,0 ,0 ,1 ,0 ,1 ,0 ,1,25308 , 0 
50641.787,3,11 ,1 ,256 ,0 ,0 ,1 ,0 ,0 ,0 ,0 ,1 ,0 ,2 ,0 ,2,17853 , 0 
50760.96,8,11 ,1 ,256 ,0 ,0 ,1 ,0 ,1 ,0 ,0 ,2 ,0 ,3 ,1 ,4,20844 , 0 
50761.078,11,11 ,5 ,807 ,0 ,0 ,1 ,0 ,0 ,0 ,0 ,1 ,0 ,1 ,0 ,1,33380 , 0 
50761.123,2,11 ,1 ,256 ,0 ,0 ,1 ,0 ,1 ,0 ,0 ,2 ,0 ,2 ,1 ,3,35754 , 0 
50761.138,6,11 ,2 ,512 ,0 ,0 ,1 ,0 ,1 ,0 ,0 ,2 ,0 ,1 ,1 ,2,44831 , 0 
50761.214,18,11 ,19 ,512 ,0 ,0 ,1 ,0 ,0 ,0 ,0 ,1 ,0 ,3 ,0 ,3,28509 , 0 
50761.236,4,11 ,8 ,512 ,0 ,0 ,2 ,1 ,0 ,0 ,0 ,3 ,0 ,2 ,0 ,2,24929 , 0 
50761.289,7,11 ,16 ,771 ,0 ,0 ,1 ,0 ,0 ,0 ,0 ,1 ,0 ,1 ,0 ,1,37735 , 0 
50761.337,14,11 ,1 ,256 ,0 ,0 ,1 ,0 ,0 ,0 ,0 ,1 ,0 ,4 ,0 ,4,24237 , 0 
50761.35,15,11 ,11 ,1104 ,0 ,0 ,2 ,0 ,0 ,0 ,0 ,2 ,0 ,0 ,0 ,0,29764 , 0 
50761.36,20,11 ,5 ,825 ,0 ,0 ,2 ,0 ,0 ,0 ,0 ,2 ,0 ,1 ,0 ,1,27118 , 0 
50761.36,16,11 ,2 ,512 ,0 ,0 ,0 ,0 ,0 ,0 ,0 ,0 ,0 ,2 ,0 ,2,49684 , 0 
50761.444,10,11 ,14 ,512 ,0 ,0 ,2 ,0 ,0 ,0 ,0 ,2 ,0 ,0 ,0 ,0,26244 , 0 
50761.482,12,11 ,11 ,1104 ,0 ,0 ,1 ,0 ,0 ,0 ,0 ,1 ,0 ,1 ,0 ,1,29618 , 0 
50761.596,9,11 ,5 ,825 ,0 ,0 ,0 ,0 ,0 ,0 ,0 ,0 ,0 ,1 ,0 ,1,44481 , 0 
50761.602,5,11 ,19 ,512 ,0 ,0 ,1 ,0 ,0 ,0 ,0 ,1 ,0 ,1 ,0 ,1,45507 , 0 
50761.606,19,11 ,1 ,256 ,0 ,0 ,1 ,0 ,0 ,0 ,0 ,1 ,0 ,1 ,0 ,1,29455 , 0 
50761.696,17,11 ,6 ,788 ,0 ,0 ,1 ,1 ,0 ,0 ,0 ,2 ,0 ,1 ,0 ,1,34524 , 0 
50761.771,13,11 ,1 ,256 ,0 ,0 ,1 ,0 ,0 ,0 ,0 ,1 ,0 ,1 ,0 ,1,25958 , 0 
50761.787,3,11 ,1 ,256 ,0 ,0 ,2 ,0 ,0 ,0 ,0 ,2 ,0 ,0 ,0 ,0,18527 , 0 
50880.96,8,11 ,1 ,256 ,0 ,0 ,1 ,0 ,0 ,0 ,0 ,1 ,0 ,0 ,0 ,0,20469 , 0 
50881.078,11,11 ,5 ,807 ,0 ,0 ,1 ,0 ,0 ,1 ,1 ,3 ,0 ,5 ,1 ,6,32167 , 0 
50881.123,2,11 ,1 ,256 ,0 ,0 ,1 ,0 ,0 ,0 ,0 ,1 ,0 ,1 ,0 ,1,37493 , 0 
50881.138,6,11 ,2 ,512 ,0 ,0 ,1 ,0 ,0 ,0 ,0 ,1 ,0 ,1 ,0 ,1,52432 , 0 
50881.214,18,11 ,19 ,512 ,0 ,0 ,1 ,0 ,0 ,0 ,0 ,1 ,0 ,6 ,0 ,6,25870 , 0 
50881.236,4,11 ,8 ,512 ,0 ,0 ,1 ,0 ,0 ,0 ,0 ,1 ,0 ,1 ,0 ,1,23364 , 0 
50881.289,7,11 ,16 ,771 ,0 ,0 ,0 ,0 ,0 ,0 ,0 ,0 ,0 ,0 ,0 ,0,37742 , 1 
50881.337,14,11 ,1 ,256 ,0 ,0 ,1 ,0 ,0 ,0 ,0 ,1 ,0 ,1 ,0 ,1,23709 , 0 
50881.35,15,11 ,11 ,1104 ,0 ,0 ,1 ,0 ,0 ,0 ,0 ,1 ,0 ,0 ,0 ,0,29048 , 0 
50881.36,20,11 ,5 ,825 ,0 ,0 ,1 ,0 ,0 ,0 ,0 ,1 ,0 ,5 ,0 ,5,25046 , 0 
50881.36,16,11 ,2 ,512 ,0 ,0 ,1 ,0 ,0 ,0 ,0 ,1 ,0 ,2 ,0 ,2,53472 , 0 
50881.444,10,11 ,14 ,512 ,0 ,0 ,1 ,0 ,0 ,0 ,0 ,1 ,0 ,0 ,0 ,0,27006 , 0 
50881.482,12,11 ,5 ,786 ,0 ,0 ,6 ,1 ,0 ,1 ,0 ,8 ,0 ,1 ,0 ,1,27424 , 0 
50881.596,9,11 ,5 ,825 ,0 ,0 ,1 ,0 ,0 ,0 ,0 ,1 ,0 ,2 ,0 ,2,46397 , 0 
50881.602,5,11 ,19 ,512 ,0 ,0 ,1 ,0 ,1 ,0 ,1 ,3 ,0 ,6 ,3 ,9,44862 , 0 
50881.606,19,11 ,1 ,256 ,0 ,0 ,1 ,0 ,1 ,0 ,1 ,3 ,0 ,2 ,2 ,4,28401 , 0 
50881.696,17,11 ,6 ,788 ,0 ,0 ,0 ,0 ,0 ,0 ,0 ,0 ,0 ,0 ,0 ,0,35151 , 0 
50881.771,13,11 ,1 ,256 ,0 ,0 ,1 ,0 ,0 ,0 ,0 ,1 ,0 ,1 ,0 ,1,25402 , 0 
50881.787,3,11 ,1 ,256 ,0 ,0 ,2 ,0 ,0 ,0 ,0 ,2 ,0 ,0 ,0 ,0,17920 , 0 
51000.96,8,35 ,0 ,0 ,0 ,0 ,14 ,7 ,4 ,9 ,3 ,37 ,0 ,16 ,7 ,23,21327 , 0 
51001.083,11,39 ,20 ,65535 ,0 ,0 ,17 ,3 ,7 ,7 ,2 ,36 ,0 ,42 ,23 ,65,34083 , 0 
51001.124,2,39 ,0 ,0 ,0 ,0 ,13 ,7 ,4 ,12 ,4 ,40 ,0 ,27 ,11 ,38,36496 , 0 
51001.143,6,41 ,10 ,2703 ,0 ,0 ,11 ,4 ,4 ,7 ,1 ,27 ,0 ,21 ,12 ,33,45373 , 0 
51001.214,18,39 ,5 ,1064 ,0 ,0 ,14 ,6 ,1 ,5 ,2 ,28 ,0 ,25 ,3 ,28,29199 , 0 
51001.252,4,35 ,8 ,512 ,0 ,0 ,13 ,6 ,0 ,7 ,0 ,26 ,0 ,17 ,0 ,17,25464 , 0 
51001.29,7,44 ,0 ,65535 ,0 ,0 ,17 ,1 ,6 ,2 ,0 ,26 ,0 ,24 ,25 ,49,38261 , 1 
51001.342,14,40 ,1 ,256 ,0 ,0 ,12 ,6 ,3 ,6 ,3 ,30 ,0 ,20 ,9 ,29,24693 , 0 
51001.35,15,43 ,7 ,1571 ,0 ,0 ,20 ,5 ,1 ,7 ,0 ,33 ,0 ,28 ,3 ,31,30341 , 0 
51001.36,20,39 ,12 ,1320 ,0 ,0 ,15 ,6 ,0 ,8 ,0 ,29 ,0 ,25 ,1 ,26,27612 , 0 
51001.361,16,39 ,7 ,1571 ,0 ,0 ,14 ,3 ,1 ,7 ,0 ,25 ,0 ,26 ,5 ,31,50225 , 0 
51001.444,10,40 ,0 ,0 ,0 ,0 ,13 ,7 ,1 ,8 ,1 ,30 ,0 ,14 ,4 ,18,26804 , 0 
51001.482,12,39 ,5 ,1064 ,0 ,0 ,15 ,6 ,0 ,7 ,0 ,28 ,0 ,33 ,1 ,34,30226 , 0 
51001.596,9,39 ,7 ,1571 ,0 ,0 ,16 ,2 ,7 ,5 ,3 ,33 ,0 ,35 ,12 ,47,44969 , 0 
51001.603,5,39 ,19 ,557 ,0 ,0 ,15 ,6 ,3 ,11 ,7 ,42 ,0 ,42 ,29 ,71,46280 , 0 
51001.607,19,40 ,1 ,256 ,0 ,0 ,12 ,5 ,6 ,9 ,7 ,39 ,0 ,33 ,15 ,48,29994 , 0 
51001.697,17,41 ,6 ,2083 ,0 ,0 ,13 ,3 ,3 ,5 ,0 ,24 ,0 ,18 ,4 ,22,35073 , 0 
51001.772,13,40 ,1 ,256 ,0 ,0 ,13 ,4 ,2 ,6 ,2 ,27 ,0 ,17 ,6 ,23,26502 , 0 
51001.787,3,40 ,1 ,256 ,0 ,0 ,10 ,5 ,1 ,6 ,1 ,23 ,0 ,16 ,2 ,18,18789 , 0 
51120.961,8,84 ,1 ,256 ,0 ,0 ,17 ,11 ,9 ,13 ,7 ,57 ,0 ,42 ,21 ,63,20851 , 0 
51121.078,11,83 ,5 ,1024 ,0 ,0 ,19 ,2 ,0 ,4 ,0 ,25 ,0 ,67 ,0 ,67,32500 , 0 
51121.124,2,87 ,19 ,768 ,0 ,0 ,19 ,7 ,13 ,9 ,4 ,52 ,0 ,59 ,23 ,82,38025 , 0 
51121.138,6,83 ,2 ,512 ,0 ,0 ,20 ,2 ,1 ,3 ,1 ,27 ,0 ,43 ,5 ,48,52833 , 0 
51121.214,18,83 ,0 ,0 ,0 ,0 ,19 ,4 ,2 ,14 ,1 ,40 ,0 ,51 ,5 ,56,26500 , 0 
51121.236,4,84 ,8 ,512 ,0 ,0 ,22 ,10 ,1 ,16 ,1 ,50 ,0 ,38 ,4 ,42,24066 , 0 
51121.29,7,90 ,0 ,65535 ,0 ,0 ,23 ,0 ,0 ,0 ,0 ,23 ,0 ,43 ,0 ,43,37965 , 1 
51121.338,14,83 ,1 ,256 ,0 ,0 ,15 ,10 ,3 ,9 ,3 ,40 ,0 ,42 ,8 ,50,24018 , 0 
51121.35,15,87 ,7 ,1571 ,0 ,0 ,18 ,0 ,0 ,0 ,0 ,18 ,0 ,47 ,0 ,47,29240 , 0 
51121.36,20,83 ,5 ,1024 ,0 ,0 ,19 ,4 ,1 ,5 ,0 ,29 ,0 ,40 ,2 ,42,25468 , 0 
51121.361,16,87 ,2 ,512 ,0 ,0 ,19 ,0 ,0 ,2 ,0 ,21 ,0 ,45 ,0 ,45,53733 , 0 
51121.444,10,81 ,14 ,534 ,0 ,0 ,15 ,4 ,0 ,6 ,0 ,25 ,0 ,27 ,0 ,27,27354 , 0 
51121.482,12,83 ,5 ,1024 ,0 ,0 ,19 ,4 ,1 ,5 ,0 ,29 ,0 ,52 ,1 ,53,27783 , 0 
51121.596,9,87 ,7 ,1571 ,0 ,0 ,22 ,0 ,0 ,0 ,0 ,22 ,0 ,58 ,0 ,58,46644 , 0 
51121.603,5,84 ,19 ,768 ,0 ,0 ,19 ,5 ,5 ,11 ,2 ,42 ,0 ,74 ,22 ,96,45470 , 0 
51121.607,19,84 ,8 ,512 ,0 ,0 ,19 ,7 ,4 ,13 ,4 ,47 ,0 ,77 ,30 ,107,28892 , 0 
51121.697,17,87 ,6 ,1024 ,0 ,0 ,19 ,1 ,0 ,1 ,0 ,21 ,0 ,43 ,0 ,43,35403 , 0 
51121.772,13,84 ,1 ,256 ,0 ,0 ,15 ,7 ,1 ,11 ,0 ,34 ,0 ,51 ,2 ,53,25878 , 0 
51121.787,3,84 ,8 ,512 ,0 ,0 ,17 ,11 ,0 ,9 ,0 ,37 ,0 ,32 ,0 ,32,18169 , 0 
51240.96,8,92 ,1 ,256 ,0 ,0 ,8 ,6 ,1 ,4 ,2 ,21 ,0 ,23 ,4 ,27,21566 , 0 
51241.078,11,92 ,12 ,1071 ,0 ,0 ,11 ,5 ,0 ,4 ,1 ,21 ,0 ,28 ,1 ,29,34387 , 0 
51241.124,2,92 ,1 ,256 ,0 ,0 ,7 ,4 ,12 ,3 ,1 ,27 ,0 ,23 ,17 ,40,36705 , 0 
51241.138,6,92 ,10 ,940 ,0 ,0 ,10 ,3 ,4 ,3 ,0 ,20 ,0 ,19 ,4 ,23,45668 , 0 
51241.214,18,92 ,19 ,520 ,0 ,0 ,8 ,6 ,7 ,3 ,0 ,24 ,0 ,21 ,9 ,30,29545 , 0 
51241.236,4,92 ,19 ,520 ,0 ,0 ,11 ,7 ,0 ,6 ,0 ,24 ,0 ,12 ,0 ,12,25807 , 0 
51241.29,7,92 ,16 ,1103 ,0 ,0 ,10 ,3 ,2 ,1 ,1 ,17 ,0 ,21 ,3 ,24,38462 , 0 
51241.338,14,92 ,1 ,256 ,0 ,0 ,8 ,4 ,8 ,1 ,0 ,21 ,0 ,20 ,9 ,29,24875 , 0 
51241.35,15,92 ,9 ,1416 ,0 ,0 ,12 ,5 ,0 ,2 ,0 ,19 ,0 ,18 ,0 ,18,30615 , 0 
51241.36,20,92 ,5 ,889 ,0 ,0 ,9 ,5 ,1 ,2 ,1 ,18 ,0 ,14 ,4 ,18,27949 , 0 
51241.361,16,92 ,2 ,593 ,0 ,0 ,8 ,1 ,8 ,0 ,1 ,18 ,0 ,22 ,11 ,33,50551 , 0 
51241.444,10,92 ,14 ,647 ,0 ,0 ,7 ,2 ,6 ,1 ,0 ,16 ,0 ,10 ,7 ,17,27012 , 0 
51241.482,12,92 ,18 ,798 ,0 ,0 ,9 ,6 ,3 ,3 ,1 ,22 ,0 ,18 ,4 ,22,30616 , 0 
51241.596,9,92 ,16 ,1103 ,0 ,0 ,10 ,4 ,3 ,3 ,1 ,21 ,0 ,22 ,4 ,26,45344 , 0 
51241.603,5,92 ,19 ,520 ,0 ,0 ,7 ,4 ,9 ,6 ,5 ,31 ,0 ,30 ,22 ,52,46868 , 0 
51241.607,19,92 ,1 ,256 ,0 ,0 ,7 ,4 ,25 ,3 ,6 ,45 ,0 ,27 ,39 ,66,30312 , 0 
51241.697,17,92 ,6 ,1232 ,0 ,0 ,9 ,4 ,0 ,0 ,0 ,13 ,0 ,13 ,0 ,13,35261 , 0 
51241.771,13,92 ,1 ,256 ,0 ,0 ,8 ,4 ,0 ,1 ,0 ,13 ,0 ,22 ,0 ,22,26705 , 0 
51241.787,3,92 ,1 ,256 ,0 ,0 ,6 ,6 ,0 ,2 ,0 ,14 ,0 ,16 ,0 ,16,18940 , 0 
51360.96,8,92 ,1 ,256 ,0 ,0 ,2 ,1 ,0 ,0 ,0 ,3 ,0 ,6 ,0 ,6,20920 , 0 
51361.078,11,92 ,12 ,1100 ,0 ,0 ,2 ,1 ,0 ,0 ,0 ,3 ,0 ,6 ,0 ,6,32586 , 0 
51361.123,2,92 ,1 ,256 ,0 ,0 ,2 ,1 ,6 ,0 ,0 ,9 ,0 ,9 ,6 ,15,38119 , 0 
51361.138,6,92 ,10 ,874 ,0 ,0 ,1 ,2 ,1 ,0 ,0 ,4 ,0 ,7 ,1 ,8,52903 , 0 
51361.214,18,92 ,19 ,512 ,0 ,0 ,2 ,1 ,1 ,0 ,0 ,4 ,0 ,6 ,2 ,8,26602 , 0 
51361.236,4,92 ,19 ,512 ,0 ,0 ,2 ,1 ,0 ,0 ,0 ,3 ,0 ,4 ,0 ,4,24145 , 0 
51361.289,7,92 ,16 ,1084 ,0 ,0 ,3 ,1 ,0 ,1 ,0 ,5 ,0 ,6 ,0 ,6,38049 , 0 
51361.337,14,92 ,1 ,256 ,0 ,0 ,3 ,1 ,5 ,0 ,0 ,9 ,0 ,5 ,5 ,10,24101 , 0 
51361.35,15,92 ,9 ,1404 ,0 ,0 ,3 ,1 ,0 ,0 ,0 ,4 ,0 ,4 ,0 ,4,29324 , 0 
51361.36,20,92 ,5 ,887 ,0 ,0 ,1 ,1 ,0 ,0 ,0 ,2 ,0 ,3 ,0 ,3,25531 , 0 
51361.36,16,92 ,2 ,548 ,0 ,0 ,2 ,2 ,4 ,0 ,0 ,8 ,0 ,7 ,5 ,12,53870 , 0 
51361.444,10,92 ,14 ,552 ,0 ,0 ,2 ,2 ,3 ,0 ,0 ,7 ,0 ,3 ,3 ,6,27451 , 0 
51361.482,12,92 ,18 ,835 ,0 ,0 ,2 ,0 ,1 ,1 ,0 ,4 ,0 ,4 ,1 ,5,27877 , 0 
51361.596,9,92 ,16 ,1002 ,0 ,0 ,1 ,2 ,1 ,0 ,0 ,4 ,0 ,9 ,1 ,10,46730 , 0 
51361.603,5,92 ,19 ,512 ,0 ,0 ,2 ,1 ,1 ,0 ,0 ,4 ,0 ,9 ,1 ,10,45568 , 0 
51361.607,19,92 ,1 ,256 ,0 ,0 ,3 ,2 ,5 ,0 ,0 ,10 ,0 ,9 ,5 ,14,29001 , 0 
51361.696,17,92 ,6 ,1168 ,0 ,0 ,2 ,1 ,0 ,0 ,0 ,3 ,0 ,4 ,0 ,4,35477 , 0 
51361.771,13,92 ,1 ,256 ,0 ,0 ,2 ,1 ,0 ,0 ,0 ,3 ,0 ,9 ,0 ,9,25954 , 0 
51361.787,3,92 ,1 ,256 ,0 ,0 ,2 ,1 ,0 ,0 ,0 ,3 ,0 ,6 ,0 ,6,18233 , 0 
51480.96,8,92 ,1 ,256 ,0 ,0 ,3 ,1 ,0 ,0 ,0 ,4 ,0 ,4 ,0 ,4,21644 , 0 
51481.078,11,92 ,12 ,1100 ,0 ,0 ,2 ,0 ,0 ,0 ,0 ,2 ,0 ,6 ,0 ,6,34457 , 0 
51481.123,2,92 ,1 ,256 ,0 ,0 ,1 ,1 ,5 ,0 ,0 ,7 ,0 ,5 ,5 ,10,36797 , 0 
51481.138,6,92 ,10 ,830 ,0 ,0 ,3 ,1 ,1 ,0 ,1 ,6 ,0 ,4 ,2 ,6,45804 , 0 
51481.214,18,92 ,19 ,512 ,0 ,0 ,2 ,1 ,1 ,0 ,0 ,4 ,0 ,3 ,1 ,4,29629 , 0 
51481.236,4,92 ,19 ,512 ,0 ,0 ,2 ,1 ,0 ,0 ,0 ,3 ,0 ,4 ,0 ,4,25880 , 0 
51481.289,7,92 ,16 ,898 ,0 ,0 ,0 ,2 ,0 ,0 ,0 ,2 ,0 ,9 ,0 ,9,38532 , 0 
51481.337,14,92 ,1 ,256 ,0 ,0 ,0 ,1 ,2 ,0 ,1 ,4 ,0 ,5 ,3 ,8,24940 , 0 
51481.35,15,92 ,9 ,1238 ,0 ,0 ,2 ,1 ,0 ,0 ,0 ,3 ,0 ,2 ,0 ,2,30701 , 0 
51481.36,20,92 ,5 ,848 ,0 ,0 ,2 ,1 ,0 ,0 ,0 ,3 ,0 ,5 ,0 ,5,28022 , 0 
51481.36,16,92 ,2 ,548 ,0 ,0 ,2 ,0 ,5 ,0 ,0 ,7 ,0 ,5 ,5 ,10,50660 , 0 
51481.444,10,92 ,14 ,552 ,0 ,0 ,2 ,0 ,2 ,0 ,1 ,5 ,0 ,1 ,3 ,4,27117 , 0 
51481.482,12,92 ,18 ,805 ,0 ,0 ,2 ,1 ,0 ,0 ,0 ,3 ,0 ,5 ,0 ,5,30683 , 0 
51481.596,9,92 ,16 ,950 ,0 ,0 ,2 ,1 ,1 ,0 ,0 ,4 ,0 ,4 ,1 ,5,45426 , 0 
51481.602,5,92 ,19 ,512 ,0 ,0 ,3 ,1 ,1 ,0 ,0 ,5 ,0 ,7 ,1 ,8,46980 , 0 
51481.606,19,92 ,1 ,256 ,0 ,0 ,1 ,0 ,5 ,0 ,0 ,6 ,0 ,5 ,5 ,10,30432 , 0 
51481.696,17,92 ,16 ,950 ,0 ,0 ,5 ,2 ,0 ,1 ,0 ,8 ,0 ,3 ,0 ,3,35369 , 0 
51481.771,13,92 ,1 ,256 ,0 ,0 ,0 ,1 ,0 ,0 ,0 ,1 ,0 ,2 ,0 ,2,26765 , 0 
51481.787,3,92 ,1 ,256 ,0 ,0 ,2 ,1 ,0 ,0 ,0 ,3 ,0 ,1 ,0 ,1,19001 , 0 
51600.96,8,92 ,1 ,256 ,0 ,0 ,1 ,1 ,0 ,0 ,0 ,2 ,0 ,2 ,0 ,2,20989 , 0 
51601.078,11,92 ,9 ,300 ,0 ,0 ,4 ,3 ,1 ,3 ,1 ,12 ,0 ,8 ,8 ,16,32841 , 0 
51601.131,2,92 ,1 ,256 ,0 ,0 ,3 ,1 ,4 ,0 ,1 ,9 ,0 ,9 ,5 ,14,38292 , 0 
51601.138,6,92 ,16 ,65535 ,0 ,0 ,2 ,3 ,0 ,3 ,0 ,8 ,0 ,10 ,0 ,10,53030 , 0 
51601.214,18,92 ,19 ,512 ,0 ,0 ,2 ,0 ,2 ,0 ,2 ,6 ,0 ,2 ,4 ,6,26728 , 0 
51601.236,4,92 ,19 ,512 ,0 ,0 ,0 ,0 ,0 ,0 ,0 ,0 ,0 ,1 ,0 ,1,24201 , 0 
51601.289,7,92 ,9 ,300 ,0 ,0 ,4 ,2 ,0 ,3 ,0 ,9 ,0 ,8 ,6 ,14,38221 , 0 
51601.338,14,92 ,1 ,256 ,0 ,0 ,3 ,1 ,4 ,1 ,1 ,10 ,0 ,5 ,6 ,11,24218 , 0 
51601.35,15,92 ,9 ,300 ,0 ,0 ,2 ,2 ,0 ,0 ,0 ,4 ,0 ,7 ,0 ,7,29420 , 0 
51601.36,20,92 ,11 ,673 ,0 ,0 ,3 ,2 ,1 ,3 ,1 ,10 ,0 ,7 ,4 ,11,25729 , 0 
51601.361,16,92 ,9 ,300 ,0 ,0 ,4 ,2 ,4 ,3 ,2 ,15 ,0 ,9 ,10 ,19,54161 , 0 
51601.444,10,92 ,14 ,523 ,0 ,0 ,2 ,2 ,2 ,1 ,1 ,8 ,0 ,3 ,4 ,7,27570 , 0 
51601.482,12,92 ,11 ,673 ,0 ,0 ,4 ,2 ,1 ,2 ,2 ,11 ,0 ,7 ,5 ,12,28139 , 0 
51601.603,5,92 ,19 ,512 ,0 ,0 ,3 ,0 ,1 ,0 ,1 ,5 ,0 ,11 ,2 ,13,45731 , 0 
51601.606,19,92 ,1 ,256 ,0 ,0 ,1 ,1 ,3 ,0 ,3 ,8 ,0 ,4 ,6 ,10,29118 , 0 
51601.696,17,92 ,7 ,556 ,0 ,0 ,3 ,2 ,0 ,1 ,0 ,6 ,0 ,5 ,0 ,5,35613 , 0 
51601.741,9,92 ,11 ,65535 ,0 ,0 ,5 ,3 ,5 ,7 ,1 ,21 ,0 ,11 ,14 ,25,47091 , 1 
51601.771,13,92 ,1 ,256 ,0 ,0 ,3 ,1 ,0 ,0 ,0 ,4 ,0 ,5 ,0 ,5,26067 , 0 
51601.787,3,92 ,1 ,256 ,0 ,0 ,3 ,1 ,0 ,0 ,0 ,4 ,0 ,3 ,0 ,3,18302 , 0 
51720.96,8,92 ,1 ,256 ,0 ,0 ,3 ,0 ,0 ,0 ,0 ,3 ,0 ,3 ,0 ,3,21749 , 0 
51721.079,11,92 ,9 ,65535 ,0 ,0 ,16 ,16 ,34 ,23 ,7 ,96 ,0 ,47 ,63 ,110,35441 , 0 
51721.124,2,92 ,1 ,256 ,0 ,0 ,5 ,0 ,0 ,1 ,0 ,6 ,0 ,10 ,0 ,10,36923 , 0 
51721.138,6,92 ,10 ,901 ,0 ,0 ,6 ,4 ,0 ,0 ,0 ,10 ,0 ,25 ,0 ,25,46089 , 0 
51721.214,18,92 ,19 ,512 ,0 ,0 ,2 ,1 ,0 ,2 ,0 ,5 ,0 ,10 ,0 ,10,29720 , 0 
51721.236,4,92 ,19 ,512 ,0 ,0 ,2 ,1 ,0 ,0 ,0 ,3 ,0 ,4 ,0 ,4,25971 , 0 
51721.29,7,92 ,9 ,300 ,0 ,0 ,14 ,14 ,13 ,7 ,6 ,54 ,0 ,37 ,36 ,73,39199 , 0 
51721.337,14,92 ,1 ,256 ,0 ,0 ,1 ,0 ,4 ,0 ,0 ,5 ,0 ,8 ,4 ,12,25064 , 0 
51721.351,15,92 ,9 ,300 ,0 ,0 ,19 ,16 ,44 ,21 ,13 ,113 ,0 ,34 ,88 ,122,31753 , 0 
51721.36,20,92 ,11 ,655 ,0 ,0 ,8 ,6 ,0 ,3 ,0 ,17 ,0 ,20 ,1 ,21,28305 , 0 
51721.361,16,92 ,9 ,65535 ,0 ,0 ,7 ,13 ,5 ,4 ,1 ,30 ,0 ,25 ,13 ,38,51160 , 0 
51721.444,10,92 ,14 ,523 ,0 ,0 ,6 ,0 ,4 ,0 ,0 ,10 ,0 ,3 ,4 ,7,27281 , 0 
51721.482,12,92 ,5 ,808 ,0 ,0 ,8 ,4 ,0 ,3 ,0 ,15 ,0 ,21 ,2 ,23,30974 , 0 
51721.597,9,92 ,15 ,639 ,0 ,0 ,20 ,16 ,54 ,30 ,6 ,126 ,0 ,42 ,144 ,186,46484 , 1 
51721.603,5,92 ,19 ,512 ,0 ,0 ,5 ,1 ,6 ,0 ,0 ,12 ,0 ,37 ,10 ,47,47283 , 0 
51721.607,19,92 ,1 ,256 ,0 ,0 ,3 ,0 ,9 ,1 ,0 ,13 ,0 ,7 ,11 ,18,30601 , 0 
51721.697,17,92 ,16 ,750 ,0 ,0 ,11 ,6 ,0 ,1 ,0 ,18 ,0 ,17 ,0 ,17,35613 , 0 
51721.771,13,92 ,1 ,256 ,0 ,0 ,1 ,0 ,0 ,0 ,0 ,1 ,0 ,8 ,0 ,8,26886 , 0 
51721.787,3,92 ,1 ,256 ,0 ,0 ,1 ,0 ,0 ,0 ,0 ,1 ,0 ,1 ,0 ,1,19081 , 0 
51840.96,8,92 ,1 ,256 ,0 ,0 ,1 ,0 ,0 ,0 ,0 ,1 ,0 ,2 ,0 ,2,21089 , 0 
51841.079,11,92 ,9 ,300 ,0 ,0 ,16 ,15 ,7 ,14 ,0 ,52 ,0 ,32 ,25 ,57,33494 , 0 
51841.124,2,92 ,1 ,256 ,0 ,0 ,3 ,0 ,3 ,1 ,1 ,8 ,0 ,13 ,4 ,17,38491 , 0 
51841.138,6,92 ,10 ,926 ,0 ,0 ,2 ,1 ,0 ,0 ,0 ,3 ,0 ,17 ,0 ,17,53169 , 0 
51841.214,18,92 ,19 ,512 ,0 ,0 ,2 ,0 ,1 ,0 ,1 ,4 ,0 ,10 ,2 ,12,26942 , 0 
51841.236,4,92 ,19 ,512 ,0 ,0 ,2 ,0 ,0 ,0 ,0 ,2 ,0 ,1 ,0 ,1,24393 , 0 
51841.29,7,92 ,9 ,300 ,0 ,0 ,12 ,14 ,55 ,10 ,1 ,92 ,0 ,38 ,77 ,115,39147 , 0 
51841.337,14,92 ,1 ,256 ,0 ,0 ,2 ,0 ,1 ,0 ,0 ,3 ,0 ,4 ,1 ,5,24327 , 0 
51841.351,15,92 ,9 ,300 ,0 ,0 ,13 ,12 ,5 ,10 ,3 ,43 ,0 ,34 ,30 ,64,29961 , 0 
51841.36,20,92 ,11 ,664 ,0 ,0 ,4 ,9 ,0 ,0 ,0 ,13 ,0 ,16 ,0 ,16,25912 , 0 
51841.418,16,92 ,7 ,619 ,0 ,0 ,13 ,9 ,60 ,9 ,7 ,98 ,0 ,30 ,86 ,116,55127 , 0 
51841.444,10,92 ,14 ,548 ,0 ,0 ,1 ,0 ,1 ,0 ,0 ,2 ,0 ,2 ,1 ,3,27678 , 0 
51841.482,12,92 ,11 ,664 ,0 ,0 ,8 ,4 ,1 ,4 ,1 ,18 ,0 ,12 ,3 ,15,28488 , 0 
51841.603,5,92 ,13 ,531 ,0 ,0 ,7 ,1 ,2 ,4 ,1 ,15 ,0 ,33 ,7 ,40,46149 , 0 
51841.606,19,92 ,1 ,256 ,0 ,0 ,1 ,0 ,3 ,1 ,1 ,6 ,0 ,5 ,4 ,9,29276 , 0 
51841.611,9,92 ,16 ,873 ,0 ,0 ,20 ,12 ,77 ,29 ,6 ,144 ,0 ,34 ,139 ,173,48454 , 1 
51841.697,17,92 ,7 ,619 ,0 ,0 ,6 ,9 ,0 ,1 ,0 ,16 ,0 ,18 ,0 ,18,35863 , 0 
51841.771,13,92 ,1 ,256 ,0 ,0 ,0 ,0 ,1 ,1 ,1 ,3 ,0 ,5 ,3 ,8,26149 , 0 
51841.787,3,92 ,1 ,256 ,0 ,0 ,1 ,0 ,0 ,0 ,0 ,1 ,0 ,1 ,0 ,1,18363 , 0 
51960.96,8,92 ,1 ,256 ,0 ,0 ,1 ,0 ,0 ,0 ,0 ,1 ,0 ,1 ,0 ,1,21823 , 0 
51961.078,11,92 ,9 ,1151 ,0 ,0 ,8 ,5 ,0 ,5 ,1 ,19 ,0 ,22 ,3 ,25,35726 , 0 
51961.124,2,92 ,1 ,256 ,0 ,0 ,0 ,0 ,12 ,0 ,2 ,14 ,0 ,11 ,15 ,26,37081 , 0 
51961.138,6,92 ,10 ,939 ,0 ,0 ,6 ,1 ,0 ,0 ,0 ,7 ,0 ,12 ,0 ,12,46229 , 0 
51961.214,18,92 ,19 ,518 ,0 ,0 ,1 ,1 ,0 ,1 ,0 ,3 ,0 ,13 ,0 ,13,29823 , 0 
51961.236,4,92 ,19 ,512 ,0 ,0 ,1 ,0 ,0 ,0 ,0 ,1 ,0 ,1 ,0 ,1,26030 , 0 
51961.29,7,92 ,16 ,1056 ,0 ,0 ,13 ,4 ,7 ,7 ,2 ,33 ,0 ,20 ,15 ,35,39543 , 0 
51961.337,14,92 ,1 ,256 ,0 ,0 ,1 ,0 ,1 ,0 ,0 ,2 ,0 ,0 ,1 ,1,25168 , 0 
51961.35,15,92 ,9 ,1372 ,0 ,0 ,9 ,5 ,0 ,5 ,0 ,19 ,0 ,21 ,5 ,26,32002 , 0 
51961.36,20,92 ,5 ,799 ,0 ,0 ,5 ,4 ,0 ,1 ,0 ,10 ,0 ,14 ,0 ,14,28489 , 0 
51961.361,16,92 ,2 ,539 ,0 ,0 ,6 ,2 ,16 ,1 ,4 ,29 ,0 ,23 ,26 ,49,51608 , 0 
51961.444,10,92 ,14 ,548 ,0 ,0 ,1 ,0 ,1 ,0 ,0 ,2 ,0 ,5 ,1 ,6,27377 , 0 
51961.482,12,92 ,5 ,799 ,0 ,0 ,6 ,5 ,0 ,1 ,0 ,12 ,0 ,14 ,2 ,16,31207 , 0 
51961.596,9,92 ,16 ,873 ,0 ,0 ,8 ,1 ,11 ,3 ,3 ,26 ,0 ,23 ,21 ,44,46842 , 0 
51961.603,5,92 ,13 ,518 ,0 ,0 ,8 ,1 ,10 ,1 ,1 ,21 ,0 ,19 ,11 ,30,47599 , 0 
51961.606,19,92 ,1 ,256 ,0 ,0 ,2 ,0 ,1 ,1 ,1 ,5 ,0 ,6 ,2 ,8,30711 , 0 
51961.697,17,92 ,16 ,1056 ,0 ,0 ,7 ,3 ,2 ,2 ,3 ,17 ,0 ,17 ,5 ,22,35799 , 0 
51961.771,13,92 ,1 ,256 ,0 ,0 ,2 ,0 ,11 ,1 ,1 ,15 ,0 ,5 ,13 ,18,27031 , 0 
51961.787,3,92 ,1 ,256 ,0 ,0 ,1 ,0 ,0 ,0 ,0 ,1 ,0 ,1 ,0 ,1,19147 , 0 
52080.96,8,92 ,1 ,256 ,0 ,0 ,2 ,1 ,0 ,0 ,0 ,3 ,0 ,2 ,0 ,2,21164 , 0 
52081.123,2,92 ,1 ,256 ,0 ,0 ,1 ,1 ,8 ,0 ,0 ,10 ,0 ,5 ,9 ,14,38582 , 0 
52081.138,6,92 ,10 ,970 ,0 ,0 ,1 ,0 ,0 ,0 ,0 ,1 ,0 ,5 ,0 ,5,53254 , 0 
52081.182,11,92 ,9 ,1424 ,0 ,0 ,3 ,1 ,0 ,0 ,0 ,4 ,0 ,8 ,0 ,8,33592 , 0 
52081.214,18,92 ,19 ,518 ,0 ,0 ,2 ,0 ,0 ,0 ,0 ,2 ,0 ,3 ,0 ,3,27017 , 0 
52081.236,4,92 ,19 ,512 ,0 ,0 ,2 ,0 ,0 ,0 ,0 ,2 ,0 ,2 ,0 ,2,24456 , 0 
52081.289,7,92 ,16 ,916 ,0 ,0 ,2 ,2 ,0 ,0 ,0 ,4 ,0 ,8 ,0 ,8,39232 , 0 
52081.337,14,92 ,1 ,256 ,0 ,0 ,1 ,1 ,0 ,0 ,0 ,2 ,0 ,4 ,0 ,4,24412 , 0 
52081.35,15,92 ,9 ,1424 ,0 ,0 ,2 ,1 ,0 ,0 ,0 ,3 ,0 ,6 ,0 ,6,30054 , 0 
52081.36,20,92 ,5 ,804 ,0 ,0 ,3 ,1 ,0 ,0 ,0 ,4 ,0 ,4 ,0 ,4,26008 , 0 
52081.361,16,92 ,2 ,539 ,0 ,0 ,3 ,0 ,8 ,1 ,0 ,12 ,0 ,4 ,13 ,17,55297 , 0 
52081.444,10,92 ,14 ,548 ,0 ,0 ,2 ,0 ,0 ,0 ,0 ,2 ,0 ,0 ,0 ,0,27741 , 0 
52081.482,12,92 ,5 ,804 ,0 ,0 ,1 ,0 ,0 ,0 ,0 ,1 ,0 ,6 ,0 ,6,28556 , 0 
52081.596,9,92 ,16 ,916 ,0 ,0 ,2 ,2 ,2 ,3 ,0 ,9 ,0 ,9 ,2 ,11,48582 , 0 
52081.602,5,92 ,13 ,512 ,0 ,0 ,2 ,2 ,1 ,0 ,0 ,5 ,0 ,7 ,1 ,8,46268 , 0 
52081.606,19,92 ,1 ,256 ,0 ,0 ,1 ,1 ,0 ,0 ,0 ,2 ,0 ,8 ,0 ,8,29355 , 0 
52081.696,17,92 ,16 ,916 ,0 ,0 ,2 ,2 ,0 ,2 ,0 ,6 ,0 ,5 ,0 ,5,35968 , 0 
52081.771,13,92 ,1 ,256 ,0 ,0 ,2 ,1 ,3 ,0 ,0 ,6 ,0 ,4 ,3 ,7,26237 , 0 
52081.787,3,92 ,1 ,256 ,0 ,0 ,1 ,1 ,0 ,0 ,0 ,2 ,0 ,3 ,0 ,3,18434 , 0 
52200.96,8,92 ,1 ,256 ,0 ,0 ,1 ,0 ,0 ,0 ,0 ,1 ,0 ,3 ,0 ,3,21886 , 0 
52201.078,11,92 ,9 ,1244 ,0 ,0 ,1 ,1 ,0 ,0 ,0 ,2 ,0 ,4 ,0 ,4,35800 , 0 
52201.123,2,92 ,1 ,256 ,0 ,0 ,2 ,0 ,5 ,0 ,0 ,7 ,0 ,5 ,5 ,10,37169 , 0 
52201.138,6,92 ,10 ,970 ,0 ,0 ,2 ,0 ,0 ,0 ,0 ,2 ,0 ,1 ,0 ,1,46303 , 0 
52201.214,18,92 ,19 ,513 ,0 ,0 ,1 ,1 ,0 ,0 ,0 ,2 ,0 ,3 ,0 ,3,29891 , 0 
52201.236,4,92 ,19 ,512 ,0 ,0 ,2 ,0 ,0 ,0 ,0 ,2 ,0 ,1 ,0 ,1,26127 , 0 
52201.289,7,92 ,16 ,916 ,0 ,0 ,3 ,0 ,0 ,0 ,0 ,3 ,0 ,3 ,0 ,3,39632 , 0 
52201.337,14,92 ,1 ,256 ,0 ,0 ,2 ,0 ,1 ,0 ,0 ,3 ,0 ,4 ,1 ,5,25233 , 0 
52201.35,15,92 ,9 ,1223 ,0 ,0 ,2 ,2 ,0 ,0 ,0 ,4 ,0 ,5 ,0 ,5,32100 , 0 
52201.36,20,92 ,5 ,804 ,0 ,0 ,1 ,1 ,0 ,0 ,0 ,2 ,0 ,2 ,0 ,2,28557 , 0 
52201.36,16,92 ,2 ,518 ,0 ,0 ,1 ,1 ,4 ,0 ,0 ,6 ,0 ,4 ,4 ,8,51735 , 0 
52201.444,10,92 ,14 ,531 ,0 ,0 ,1 ,1 ,0 ,0 ,0 ,2 ,0 ,2 ,0 ,2,27444 , 0 
52201.482,12,92 ,5 ,804 ,0 ,0 ,3 ,1 ,0 ,0 ,0 ,4 ,0 ,2 ,0 ,2,31289 , 0 
52201.596,9,92 ,16 ,916 ,0 ,0 ,2 ,0 ,3 ,0 ,0 ,5 ,0 ,2 ,3 ,5,46953 , 0 
52201.602,5,92 ,13 ,512 ,0 ,0 ,1 ,0 ,2 ,0 ,0 ,3 ,0 ,3 ,2 ,5,47695 , 0 
52201.606,19,92 ,1 ,256 ,0 ,0 ,1 ,0 ,1 ,0 ,0 ,2 ,0 ,2 ,1 ,3,30793 , 0 
52201.696,17,92 ,16 ,824 ,0 ,0 ,0 ,1 ,0 ,0 ,0 ,1 ,0 ,4 ,0 ,4,35872 , 0 
52201.771,13,92 ,1 ,256 ,0 ,0 ,1 ,0 ,2 ,0 ,0 ,3 ,0 ,2 ,2 ,4,27098 , 0 
52201.787,3,92 ,1 ,256 ,0 ,0 ,2 ,0 ,0 ,0 ,0 ,2 ,0 ,1 ,0 ,1,19205 , 0 
52320.96,8,92 ,1 ,256 ,0 ,0 ,0 ,0 ,0 ,0 ,0 ,0 ,0 ,1 ,0 ,1,21239 , 0 
52321.078,11,92 ,9 ,1244 ,0 ,0 ,1 ,0 ,0 ,0 ,0 ,1 ,0 ,3 ,0 ,3,33680 , 0 
52321.124,2,92 ,1 ,256 ,0 ,0 ,25 ,0 ,74 ,0 ,0 ,99 ,101 ,25 ,74 ,200,38957 , 0 
52321.214,18,92 ,19 ,513 ,0 ,0 ,1 ,0 ,0 ,0 ,0 ,1 ,0 ,3 ,0 ,3,27110 , 0 
52321.236,4,92 ,19 ,512 ,0 ,0 ,1 ,0 ,0 ,0 ,0 ,1 ,0 ,1 ,0 ,1,24512 , 0 
52321.27,6,92 ,16 ,772 ,0 ,120 ,6 ,16 ,0 ,1 ,0 ,143 ,0 ,85 ,0 ,85,54223 , 1 
52321.29,7,92 ,16 ,772 ,0 ,0 ,1 ,14 ,0 ,0 ,0 ,15 ,0 ,43 ,0 ,43,39477 , 0 
52321.337,14,92 ,1 ,256 ,0 ,0 ,2 ,0 ,3 ,1 ,1 ,7 ,0 ,40 ,5 ,45,24572 , 0 
52321.35,15,92 ,9 ,1223 ,0 ,0 ,2 ,0 ,0 ,0 ,0 ,2 ,0 ,0 ,0 ,0,30162 , 0 
52321.36,20,92 ,5 ,804 ,0 ,0 ,3 ,0 ,0 ,0 ,0 ,3 ,0 ,1 ,0 ,1,26100 , 0 
52321.375,16,92 ,2 ,512 ,0 ,0 ,25 ,15 ,60 ,0 ,0 ,100 ,105 ,37 ,60 ,202,56237 , 0 
52321.444,10,92 ,14 ,521 ,0 ,0 ,25 ,1 ,3 ,1 ,1 ,31 ,112 ,5 ,4 ,121,28110 , 0 
52321.482,12,92 ,5 ,804 ,0 ,0 ,1 ,0 ,0 ,0 ,0 ,1 ,0 ,2 ,0 ,2,28630 , 0 
52321.596,9,92 ,16 ,772 ,0 ,0 ,1 ,16 ,0 ,0 ,0 ,17 ,0 ,21 ,0 ,21,48935 , 0 
52321.603,5,92 ,13 ,512 ,0 ,0 ,1 ,0 ,0 ,0 ,0 ,1 ,0 ,23 ,0 ,23,46424 , 0 
52321.607,19,92 ,1 ,256 ,0 ,0 ,1 ,0 ,0 ,0 ,0 ,1 ,0 ,19 ,0 ,19,29456 , 0 
52321.697,17,92 ,16 ,772 ,0 ,0 ,25 ,16 ,0 ,0 ,0 ,41 ,107 ,26 ,0 ,133,36431 , 0 
52321.771,13,92 ,1 ,256 ,0 ,0 ,1 ,0 ,0 ,0 ,0 ,1 ,0 ,18 ,0 ,18,26386 , 0 
52321.787,3,92 ,1 ,256 ,0 ,0 ,2 ,0 ,0 ,0 ,0 ,2 ,0 ,0 ,0 ,0,18501 , 0 
52440.96,8,92 ,1 ,256 ,0 ,0 ,1 ,0 ,0 ,0 ,0 ,1 ,0 ,0 ,0 ,0,21957 , 0 
52441.078,11,92 ,9 ,1153 ,0 ,0 ,3 ,0 ,0 ,0 ,0 ,3 ,0 ,4 ,0 ,4,35904 , 0 
52441.139,6,92 ,16 ,783 ,0 ,120 ,1 ,17 ,0 ,0 ,0 ,138 ,0 ,82 ,0 ,82,47205 , 1 
52441.141,2,92 ,1 ,256 ,0 ,0 ,24 ,0 ,81 ,0 ,0 ,105 ,99 ,22 ,81 ,202,37526 , 0 
52441.214,18,92 ,19 ,513 ,0 ,0 ,1 ,0 ,0 ,0 ,0 ,1 ,0 ,1 ,0 ,1,29965 , 0 
52441.236,4,92 ,19 ,512 ,0 ,0 ,1 ,0 ,0 ,0 ,0 ,1 ,0 ,0 ,0 ,0,26188 , 0 
52441.29,7,92 ,16 ,783 ,0 ,0 ,1 ,16 ,0 ,0 ,0 ,17 ,0 ,39 ,0 ,39,39845 , 0 
52441.337,14,92 ,1 ,256 ,0 ,0 ,0 ,0 ,0 ,0 ,0 ,0 ,0 ,41 ,0 ,41,25310 , 0 
52441.35,15,92 ,9 ,1153 ,0 ,0 ,2 ,0 ,0 ,0 ,0 ,2 ,0 ,2 ,0 ,2,32195 , 0 
52441.36,20,92 ,5 ,804 ,0 ,0 ,1 ,0 ,0 ,0 ,0 ,1 ,0 ,2 ,0 ,2,28610 , 0 
52441.362,16,92 ,2 ,512 ,0 ,0 ,25 ,14 ,66 ,0 ,0 ,105 ,112 ,37 ,66 ,215,52674 , 0 
52441.444,10,92 ,14 ,521 ,0 ,0 ,27 ,0 ,0 ,0 ,0 ,27 ,116 ,1 ,0 ,117,27707 , 0 
52441.482,12,92 ,5 ,804 ,0 ,0 ,2 ,0 ,0 ,0 ,0 ,2 ,0 ,3 ,0 ,3,31389 , 0 
52441.596,9,92 ,16 ,783 ,0 ,0 ,1 ,16 ,0 ,0 ,0 ,17 ,0 ,23 ,0 ,23,47161 , 0 
52441.603,5,92 ,13 ,512 ,0 ,0 ,2 ,0 ,0 ,0 ,0 ,2 ,0 ,26 ,0 ,26,47787 , 0 
52441.606,19,92 ,1 ,256 ,0 ,0 ,0 ,0 ,0 ,0 ,0 ,0 ,0 ,22 ,0 ,22,30884 , 0 
52441.697,17,92 ,16 ,783 ,0 ,0 ,27 ,17 ,0 ,0 ,0 ,44 ,111 ,23 ,0 ,134,36262 , 0 
52441.771,13,92 ,1 ,256 ,0 ,0 ,1 ,0 ,0 ,0 ,0 ,1 ,0 ,22 ,0 ,22,27207 , 0 
52441.787,3,92 ,1 ,256 ,0 ,0 ,1 ,0 ,0 ,0 ,0 ,1 ,0 ,1 ,0 ,1,19262 , 0 
52560.96,8,92 ,1 ,256 ,0 ,0 ,1 ,0 ,1 ,0 ,0 ,2 ,0 ,3 ,1 ,4,21325 , 0 
52561.078,11,92 ,9 ,1153 ,0 ,0 ,2 ,0 ,0 ,0 ,0 ,2 ,0 ,1 ,0 ,1,33847 , 0 
52561.124,2,92 ,1 ,256 ,0 ,0 ,26 ,0 ,79 ,0 ,0 ,105 ,90 ,23 ,79 ,192,39407 , 0 
52561.214,18,92 ,19 ,513 ,0 ,0 ,1 ,0 ,0 ,0 ,0 ,1 ,0 ,2 ,0 ,2,27207 , 0 
52561.236,4,92 ,8 ,512 ,0 ,0 ,3 ,1 ,0 ,1 ,0 ,5 ,0 ,1 ,0 ,1,24694 , 0 
52561.273,6,92 ,16 ,810 ,0 ,120 ,0 ,20 ,0 ,0 ,0 ,140 ,0 ,79 ,0 ,79,55182 , 1 
52561.29,7,92 ,16 ,810 ,0 ,0 ,1 ,16 ,0 ,0 ,0 ,17 ,0 ,38 ,0 ,38,39805 , 0 
52561.338,14,92 ,1 ,256 ,0 ,0 ,1 ,0 ,0 ,0 ,0 ,1 ,0 ,29 ,0 ,29,24700 , 0 
52561.35,15,92 ,9 ,1087 ,0 ,0 ,1 ,0 ,0 ,0 ,0 ,1 ,0 ,2 ,0 ,2,30365 , 0 
52561.36,20,92 ,5 ,793 ,0 ,0 ,1 ,1 ,0 ,0 ,0 ,2 ,0 ,1 ,0 ,1,26272 , 0 
52561.444,10,92 ,14 ,521 ,0 ,0 ,25 ,0 ,0 ,0 ,0 ,25 ,109 ,0 ,0 ,109,28368 , 0 
52561.482,12,92 ,5 ,804 ,0 ,0 ,1 ,0 ,0 ,0 ,0 ,1 ,0 ,0 ,0 ,0,28704 , 0 
52561.496,16,92 ,2 ,514 ,0 ,0 ,26 ,12 ,68 ,0 ,0 ,106 ,98 ,28 ,68 ,194,57308 , 0 
52561.596,9,92 ,16 ,810 ,0 ,0 ,1 ,17 ,0 ,0 ,0 ,18 ,0 ,23 ,0 ,23,49301 , 0 
52561.603,5,92 ,13 ,512 ,0 ,0 ,1 ,0 ,1 ,0 ,0 ,2 ,0 ,16 ,1 ,17,46635 , 0 
52561.606,19,92 ,1 ,256 ,0 ,0 ,1 ,0 ,0 ,0 ,1 ,2 ,0 ,18 ,1 ,19,29650 , 0 
52561.697,17,92 ,16 ,810 ,0 ,0 ,25 ,15 ,0 ,0 ,0 ,40 ,100 ,23 ,0 ,123,36893 , 0 
52561.771,13,92 ,1 ,256 ,0 ,0 ,0 ,0 ,1 ,0 ,0 ,1 ,0 ,18 ,1 ,19,26507 , 0 
52561.787,3,92 ,1 ,256 ,0 ,0 ,1 ,0 ,0 ,0 ,0 ,1 ,0 ,1 ,0 ,1,18567 , 0 
52680.96,8,92 ,1 ,256 ,0 ,0 ,1 ,0 ,0 ,0 ,0 ,1 ,0 ,3 ,0 ,3,22032 , 0 
52681.078,11,92 ,9 ,1153 ,0 ,0 ,1 ,0 ,0 ,0 ,0 ,1 ,0 ,1 ,0 ,1,35999 , 0 
52681.124,2,92 ,1 ,256 ,0 ,0 ,6 ,0 ,21 ,0 ,0 ,27 ,1 ,6 ,21 ,28,37683 , 0 
52681.138,6,92 ,16 ,799 ,0 ,0 ,2 ,4 ,0 ,0 ,0 ,6 ,0 ,21 ,0 ,21,47354 , 0 
52681.214,18,92 ,19 ,513 ,0 ,0 ,1 ,0 ,0 ,0 ,0 ,1 ,0 ,2 ,0 ,2,30046 , 0 
52681.236,4,92 ,8 ,512 ,0 ,0 ,4 ,0 ,0 ,0 ,0 ,4 ,0 ,0 ,0 ,0,26320 , 0 
52681.289,7,92 ,16 ,799 ,0 ,0 ,1 ,4 ,0 ,0 ,0 ,5 ,0 ,9 ,0 ,9,39959 , 0 
52681.338,14,92 ,1 ,256 ,0 ,0 ,1 ,0 ,0 ,0 ,0 ,1 ,0 ,12 ,0 ,12,25396 , 0 
52681.35,15,92 ,9 ,1087 ,0 ,0 ,1 ,0 ,0 ,0 ,0 ,1 ,0 ,1 ,0 ,1,32262 , 0 
52681.36,20,92 ,5 ,793 ,0 ,0 ,0 ,0 ,0 ,0 ,0 ,0 ,0 ,1 ,0 ,1,28662 , 0 
52681.361,16,92 ,2 ,537 ,0 ,0 ,5 ,4 ,16 ,0 ,0 ,25 ,0 ,9 ,16 ,25,52943 , 0 
52681.444,10,92 ,14 ,521 ,0 ,0 ,6 ,0 ,0 ,0 ,0 ,6 ,0 ,0 ,0 ,0,27814 , 0 
52681.482,12,92 ,5 ,804 ,0 ,0 ,1 ,0 ,0 ,0 ,0 ,1 ,0 ,0 ,0 ,0,31457 , 0 
52681.596,9,92 ,16 ,859 ,0 ,0 ,2 ,4 ,0 ,0 ,0 ,6 ,0 ,4 ,0 ,4,47296 , 0 
52681.602,5,92 ,13 ,512 ,0 ,0 ,1 ,0 ,0 ,0 ,0 ,1 ,0 ,8 ,0 ,8,47935 , 0 
52681.606,19,92 ,1 ,256 ,0 ,0 ,1 ,0 ,0 ,1 ,0 ,2 ,0 ,8 ,0 ,8,30959 , 0 
52681.696,17,92 ,16 ,799 ,0 ,0 ,5 ,4 ,0 ,0 ,0 ,9 ,0 ,4 ,0 ,4,36376 , 0 
52681.771,13,92 ,1 ,256 ,0 ,0 ,2 ,0 ,0 ,0 ,0 ,2 ,0 ,6 ,0 ,6,27309 , 0 
52681.787,3,92 ,1 ,256 ,0 ,0 ,1 ,0 ,0 ,0 ,0 ,1 ,0 ,0 ,0 ,0,19324 , 0 
52800.96,8,92 ,1 ,256 ,0 ,0 ,1 ,0 ,0 ,0 ,0 ,1 ,0 ,1 ,0 ,1,21391 , 0 
52801.078,11,92 ,9 ,1193 ,0 ,0 ,2 ,0 ,0 ,0 ,0 ,2 ,0 ,2 ,0 ,2,33917 , 0 
52801.124,2,92 ,1 ,256 ,0 ,0 ,1 ,0 ,9 ,0 ,0 ,10 ,0 ,1 ,9 ,10,39483 , 0 
52801.138,6,92 ,16 ,804 ,0 ,0 ,1 ,2 ,0 ,0 ,0 ,3 ,0 ,4 ,0 ,4,55254 , 0 
52801.214,18,92 ,19 ,513 ,0 ,0 ,2 ,0 ,0 ,0 ,0 ,2 ,0 ,3 ,0 ,3,27282 , 0 
52801.236,4,92 ,8 ,512 ,0 ,0 ,2 ,0 ,0 ,0 ,0 ,2 ,0 ,1 ,0 ,1,24759 , 0 
52801.289,7,92 ,16 ,804 ,0 ,0 ,1 ,2 ,0 ,0 ,0 ,3 ,0 ,5 ,0 ,5,39869 , 0 
52801.337,14,92 ,1 ,256 ,0 ,0 ,1 ,0 ,0 ,0 ,0 ,1 ,0 ,3 ,0 ,3,24759 , 0 
52801.35,15,92 ,9 ,1135 ,0 ,0 ,1 ,0 ,0 ,0 ,0 ,1 ,0 ,3 ,0 ,3,30421 , 0 
52801.36,20,92 ,5 ,793 ,0 ,0 ,1 ,0 ,0 ,0 ,0 ,1 ,0 ,2 ,0 ,2,26341 , 0 
52801.36,16,92 ,2 ,523 ,0 ,0 ,3 ,1 ,8 ,0 ,0 ,12 ,0 ,2 ,8 ,10,57464 , 0 
52801.444,10,92 ,14 ,521 ,0 ,0 ,2 ,0 ,0 ,0 ,0 ,2 ,0 ,1 ,0 ,1,28430 , 0 
52801.482,12,92 ,5 ,804 ,0 ,0 ,2 ,0 ,0 ,0 ,0 ,2 ,0 ,4 ,0 ,4,28785 , 0 
52801.596,9,92 ,16 ,804 ,0 ,0 ,2 ,2 ,0 ,0 ,0 ,4 ,0 ,4 ,0 ,4,49408 , 0 
52801.602,5,92 ,13 ,512 ,0 ,0 ,1 ,0 ,0 ,0 ,0 ,1 ,0 ,5 ,0 ,5,46713 , 0 
52801.606,19,92 ,1 ,256 ,0 ,0 ,1 ,0 ,0 ,0 ,0 ,1 ,0 ,5 ,0 ,5,29715 , 0 
52801.696,17,92 ,16 ,804 ,0 ,0 ,1 ,2 ,0 ,0 ,0 ,3 ,0 ,3 ,0 ,3,36958 , 0 
52801.771,13,92 ,1 ,256 ,0 ,0 ,0 ,0 ,0 ,0 ,0 ,0 ,0 ,1 ,0 ,1,26563 , 0 
52801.787,3,92 ,1 ,256 ,0 ,0 ,0 ,0 ,0 ,0 ,0 ,0 ,0 ,2 ,0 ,2,18624 , 0 
52920.96,8,92 ,1 ,256 ,0 ,0 ,2 ,0 ,0 ,0 ,0 ,2 ,0 ,2 ,0 ,2,22102 , 0 
52921.078,11,92 ,9 ,1193 ,0 ,0 ,1 ,0 ,0 ,0 ,0 ,1 ,0 ,4 ,0 ,4,36102 , 0 
52921.123,2,92 ,1 ,256 ,0 ,0 ,2 ,0 ,2 ,0 ,0 ,4 ,0 ,1 ,2 ,3,37782 , 0 
52921.138,6,92 ,16 ,804 ,0 ,0 ,0 ,0 ,0 ,0 ,0 ,0 ,0 ,3 ,0 ,3,47421 , 0 
52921.214,18,92 ,19 ,513 ,0 ,0 ,1 ,0 ,0 ,0 ,0 ,1 ,0 ,1 ,0 ,1,30109 , 0 
52921.236,4,92 ,8 ,512 ,0 ,0 ,2 ,0 ,0 ,0 ,0 ,2 ,0 ,2 ,0 ,2,26396 , 0 
52921.289,7,92 ,16 ,804 ,0 ,0 ,1 ,0 ,0 ,0 ,0 ,1 ,0 ,3 ,0 ,3,40030 , 0 
52921.337,14,92 ,1 ,256 ,0 ,0 ,1 ,0 ,0 ,0 ,0 ,1 ,0 ,2 ,0 ,2,25471 , 0 
52921.35,15,92 ,9 ,1135 ,0 ,0 ,2 ,1 ,0 ,0 ,0 ,3 ,0 ,1 ,0 ,1,32348 , 0 
52921.36,20,92 ,5 ,793 ,0 ,0 ,3 ,0 ,0 ,0 ,0 ,3 ,0 ,0 ,0 ,0,28741 , 0 
52921.36,16,92 ,2 ,523 ,0 ,0 ,1 ,0 ,2 ,0 ,0 ,3 ,0 ,1 ,2 ,3,53040 , 0 
52921.444,10,92 ,14 ,521 ,0 ,0 ,1 ,0 ,0 ,0 ,0 ,1 ,0 ,0 ,0 ,0,27869 , 0 
52921.482,12,92 ,5 ,804 ,0 ,0 ,1 ,0 ,0 ,0 ,0 ,1 ,0 ,1 ,0 ,1,31533 , 0 
52921.596,9,92 ,16 ,804 ,0 ,0 ,0 ,0 ,1 ,0 ,0 ,1 ,0 ,2 ,1 ,3,47380 , 0 
52921.602,5,92 ,13 ,512 ,0 ,0 ,0 ,0 ,0 ,0 ,0 ,0 ,0 ,3 ,0 ,3,48011 , 0 
52921.606,19,92 ,1 ,256 ,0 ,0 ,1 ,0 ,0 ,0 ,0 ,1 ,0 ,2 ,0 ,2,31060 , 0 
52921.696,17,92 ,16 ,792 ,0 ,0 ,2 ,1 ,0 ,0 ,0 ,3 ,0 ,1 ,0 ,1,36460 , 0 
52921.771,13,92 ,1 ,256 ,0 ,0 ,1 ,0 ,0 ,0 ,0 ,1 ,0 ,1 ,0 ,1,27382 , 0 
52921.787,3,92 ,1 ,256 ,0 ,0 ,2 ,0 ,0 ,0 ,0 ,2 ,0 ,1 ,0 ,1,19382 , 0 
53040.96,8,92 ,1 ,256 ,0 ,0 ,1 ,0 ,0 ,0 ,0 ,1 ,0 ,1 ,0 ,1,21458 , 0 
53041.078,11,92 ,9 ,1129 ,0 ,0 ,7 ,2 ,0 ,2 ,0 ,11 ,0 ,15 ,0 ,15,34088 , 0 
53041.124,2,92 ,1 ,256 ,0 ,0 ,9 ,0 ,19 ,1 ,4 ,33 ,0 ,15 ,25 ,40,39666 , 0 
53041.138,6,92 ,2 ,512 ,0 ,0 ,11 ,6 ,5 ,1 ,0 ,23 ,0 ,24 ,5 ,29,55500 , 0 
53041.214,18,92 ,19 ,513 ,0 ,0 ,0 ,0 ,0 ,0 ,0 ,0 ,0 ,3 ,0 ,3,27343 , 0 
53041.236,4,92 ,8 ,512 ,0 ,0 ,2 ,0 ,0 ,0 ,0 ,2 ,0 ,0 ,0 ,0,24858 , 0 
53041.29,7,92 ,9 ,1129 ,0 ,0 ,11 ,4 ,2 ,1 ,1 ,19 ,0 ,21 ,5 ,26,40087 , 0 
53041.337,14,92 ,1 ,256 ,0 ,0 ,1 ,0 ,0 ,0 ,0 ,1 ,0 ,13 ,0 ,13,24850 , 0 
53041.35,15,92 ,9 ,1129 ,0 ,0 ,6 ,6 ,0 ,2 ,0 ,14 ,0 ,21 ,0 ,21,30624 , 0 
53041.36,20,92 ,5 ,775 ,0 ,0 ,1 ,3 ,0 ,0 ,0 ,4 ,0 ,10 ,0 ,10,26419 , 0 
53041.361,16,92 ,2 ,512 ,0 ,0 ,6 ,6 ,2 ,2 ,4 ,20 ,0 ,37 ,6 ,43,57724 , 1 
53041.444,10,92 ,14 ,521 ,0 ,0 ,5 ,0 ,0 ,0 ,0 ,5 ,0 ,10 ,0 ,10,28525 , 0 
53041.482,12,92 ,5 ,775 ,0 ,0 ,1 ,3 ,1 ,0 ,1 ,6 ,0 ,9 ,2 ,11,28890 , 0 
53041.596,9,92 ,5 ,783 ,0 ,0 ,9 ,3 ,9 ,1 ,0 ,22 ,0 ,26 ,12 ,38,49697 , 0 
53041.603,5,92 ,13 ,512 ,0 ,0 ,5 ,0 ,19 ,0 ,1 ,25 ,0 ,21 ,20 ,41,46915 , 0 
53041.606,19,92 ,1 ,256 ,0 ,0 ,1 ,0 ,0 ,0 ,0 ,1 ,0 ,14 ,0 ,14,29838 , 0 
53041.697,17,92 ,6 ,894 ,0 ,0 ,10 ,6 ,0 ,2 ,0 ,18 ,0 ,22 ,0 ,22,37160 , 0 
53041.772,13,92 ,1 ,256 ,0 ,0 ,1 ,0 ,19 ,0 ,1 ,21 ,0 ,12 ,20 ,32,26678 , 0 
53041.787,3,92 ,1 ,256 ,0 ,0 ,1 ,0 ,0 ,0 ,0 ,1 ,0 ,0 ,0 ,0,18689 , 0 
53160.96,8,92 ,1 ,256 ,0 ,0 ,2 ,0 ,1 ,0 ,0 ,3 ,0 ,1 ,1 ,2,22189 , 0 
53161.078,11,92 ,9 ,1218 ,0 ,0 ,4 ,6 ,0 ,0 ,0 ,10 ,0 ,12 ,0 ,12,36255 , 0 
53161.124,2,92 ,1 ,256 ,0 ,0 ,7 ,0 ,18 ,1 ,0 ,26 ,0 ,7 ,19 ,26,37973 , 0 
53161.138,6,92 ,2 ,513 ,0 ,0 ,6 ,5 ,8 ,0 ,0 ,19 ,0 ,10 ,8 ,18,47634 , 0 
53161.214,18,92 ,19 ,521 ,0 ,0 ,2 ,0 ,0 ,0 ,0 ,2 ,0 ,4 ,0 ,4,30221 , 0 
53161.236,4,92 ,8 ,512 ,0 ,0 ,1 ,1 ,0 ,0 ,0 ,2 ,0 ,2 ,0 ,2,26501 , 0 
53161.29,7,92 ,17 ,1092 ,0 ,0 ,11 ,6 ,0 ,2 ,0 ,19 ,0 ,12 ,0 ,12,40245 , 0 
53161.337,14,92 ,1 ,256 ,0 ,0 ,1 ,0 ,0 ,0 ,0 ,1 ,0 ,6 ,0 ,6,25536 , 0 
53161.35,15,92 ,9 ,1218 ,0 ,0 ,3 ,5 ,0 ,0 ,0 ,8 ,0 ,17 ,0 ,17,32465 , 0 
53161.36,20,92 ,5 ,788 ,0 ,0 ,1 ,1 ,0 ,0 ,0 ,2 ,0 ,3 ,0 ,3,28806 , 0 
53161.36,16,92 ,2 ,513 ,0 ,0 ,2 ,5 ,0 ,1 ,0 ,8 ,0 ,26 ,0 ,26,53213 , 1 
53161.444,10,92 ,14 ,521 ,0 ,0 ,1 ,0 ,0 ,0 ,0 ,1 ,0 ,4 ,0 ,4,27931 , 0 
53161.482,12,92 ,5 ,788 ,0 ,0 ,2 ,1 ,0 ,1 ,0 ,4 ,0 ,5 ,0 ,5,31675 , 0 
53161.596,9,92 ,5 ,788 ,0 ,0 ,7 ,1 ,15 ,0 ,1 ,24 ,0 ,13 ,17 ,30,47729 , 0 
53161.603,5,92 ,13 ,517 ,0 ,0 ,3 ,0 ,16 ,0 ,1 ,20 ,0 ,14 ,18 ,32,48241 , 0 
53161.606,19,92 ,1 ,256 ,0 ,0 ,1 ,0 ,0 ,0 ,0 ,1 ,0 ,8 ,0 ,8,31141 , 0 
53161.697,17,92 ,6 ,832 ,0 ,0 ,5 ,6 ,2 ,0 ,0 ,13 ,0 ,15 ,2 ,17,36618 , 0 
53161.772,13,92 ,1 ,256 ,0 ,0 ,2 ,0 ,16 ,0 ,1 ,19 ,0 ,7 ,17 ,24,27525 , 0 
53161.787,3,92 ,1 ,256 ,0 ,0 ,1 ,0 ,0 ,0 ,0 ,1 ,0 ,0 ,0 ,0,19471 , 0 
53280.96,8,92 ,1 ,256 ,0 ,0 ,0 ,0 ,0 ,0 ,0 ,0 ,0 ,0 ,0 ,0,21517 , 0 
53281.078,11,92 ,9 ,1133 ,0 ,0 ,2 ,3 ,0 ,0 ,0 ,5 ,0 ,5 ,0 ,5,34195 , 0 
53281.124,2,92 ,1 ,256 ,0 ,0 ,5 ,0 ,18 ,0 ,0 ,23 ,0 ,6 ,18 ,24,39796 , 0 
53281.138,6,92 ,2 ,512 ,0 ,0 ,6 ,4 ,10 ,0 ,0 ,20 ,0 ,12 ,10 ,22,55684 , 0 
53281.214,18,92 ,19 ,521 ,0 ,0 ,2 ,0 ,0 ,0 ,0 ,2 ,0 ,2 ,0 ,2,27429 , 0 
53281.236,4,92 ,8 ,512 ,0 ,0 ,1 ,0 ,0 ,0 ,0 ,1 ,0 ,1 ,0 ,1,24924 , 0 
53281.29,7,92 ,17 ,1044 ,0 ,0 ,6 ,6 ,0 ,0 ,0 ,12 ,0 ,11 ,0 ,11,40227 , 0 
53281.337,14,92 ,1 ,256 ,0 ,0 ,2 ,0 ,0 ,0 ,0 ,2 ,0 ,7 ,0 ,7,24931 , 0 
53281.35,15,92 ,9 ,1133 ,0 ,0 ,1 ,4 ,0 ,0 ,0 ,5 ,0 ,11 ,0 ,11,30713 , 0 
53281.36,20,92 ,5 ,788 ,0 ,0 ,1 ,0 ,0 ,0 ,0 ,1 ,0 ,2 ,0 ,2,26509 , 0 
53281.36,16,92 ,2 ,512 ,0 ,0 ,2 ,4 ,0 ,0 ,0 ,6 ,0 ,24 ,0 ,24,57859 , 1 
53281.444,10,92 ,14 ,512 ,0 ,0 ,2 ,0 ,0 ,0 ,0 ,2 ,0 ,6 ,0 ,6,28597 , 0 
53281.482,12,92 ,5 ,788 ,0 ,0 ,1 ,0 ,0 ,0 ,0 ,1 ,0 ,2 ,0 ,2,28973 , 0 
53281.596,9,92 ,5 ,813 ,0 ,0 ,5 ,1 ,7 ,1 ,0 ,14 ,0 ,9 ,7 ,16,49893 , 0 
53281.603,5,92 ,13 ,517 ,0 ,0 ,2 ,0 ,8 ,1 ,0 ,11 ,0 ,10 ,9 ,19,47057 , 0 
53281.606,19,92 ,1 ,256 ,0 ,0 ,1 ,0 ,0 ,0 ,0 ,1 ,0 ,8 ,0 ,8,29923 , 0 
53281.697,17,92 ,6 ,783 ,0 ,0 ,8 ,4 ,6 ,0 ,0 ,18 ,0 ,10 ,6 ,16,37335 , 0 
53281.771,13,92 ,1 ,256 ,0 ,0 ,0 ,0 ,8 ,1 ,0 ,9 ,0 ,5 ,9 ,14,26763 , 0 
53281.787,3,92 ,1 ,256 ,0 ,0 ,2 ,0 ,0 ,0 ,0 ,2 ,0 ,0 ,0 ,0,18753 , 0 
53400.96,8,92 ,1 ,256 ,0 ,0 ,1 ,0 ,0 ,0 ,0 ,1 ,0 ,2 ,0 ,2,22252 , 0 
53401.078,11,92 ,9 ,1120 ,0 ,0 ,0 ,1 ,0 ,0 ,0 ,1 ,0 ,2 ,0 ,2,36327 , 0 
53401.123,2,92 ,1 ,256 ,0 ,0 ,1 ,0 ,6 ,0 ,0 ,7 ,0 ,1 ,6 ,7,38050 , 0 
53401.138,6,92 ,2 ,512 ,0 ,0 ,2 ,1 ,4 ,0 ,0 ,7 ,0 ,7 ,4 ,11,47748 , 0 
53401.214,18,92 ,19 ,521 ,0 ,0 ,1 ,0 ,0 ,0 ,0 ,1 ,0 ,0 ,0 ,0,30280 , 0 
53401.236,4,92 ,8 ,512 ,0 ,0 ,1 ,0 ,0 ,0 ,0 ,1 ,0 ,0 ,0 ,0,26575 , 0 
53401.289,7,92 ,17 ,1033 ,0 ,0 ,1 ,3 ,0 ,0 ,0 ,4 ,0 ,6 ,0 ,6,40330 , 0 
53401.337,14,92 ,1 ,256 ,0 ,0 ,1 ,0 ,0 ,0 ,0 ,1 ,0 ,3 ,0 ,3,25603 , 0 
53401.35,15,92 ,9 ,1120 ,0 ,0 ,1 ,1 ,0 ,0 ,0 ,2 ,0 ,2 ,0 ,2,32529 , 0 
53401.36,20,92 ,5 ,788 ,0 ,0 ,1 ,0 ,0 ,0 ,0 ,1 ,0 ,0 ,0 ,0,28890 , 0 
53401.36,16,92 ,2 ,512 ,0 ,0 ,1 ,1 ,0 ,0 ,0 ,2 ,0 ,7 ,0 ,7,53284 , 0 
53401.444,10,92 ,14 ,512 ,0 ,0 ,2 ,0 ,0 ,0 ,0 ,2 ,0 ,2 ,0 ,2,27993 , 0 
53401.482,12,92 ,5 ,788 ,0 ,0 ,1 ,0 ,0 ,0 ,0 ,1 ,0 ,0 ,0 ,0,31746 , 0 
53401.596,9,92 ,5 ,813 ,0 ,0 ,2 ,0 ,2 ,0 ,0 ,4 ,0 ,1 ,2 ,3,47817 , 0 
53401.602,5,92 ,13 ,517 ,0 ,0 ,0 ,0 ,2 ,0 ,0 ,2 ,0 ,4 ,2 ,6,48326 , 0 
53401.606,19,92 ,1 ,256 ,0 ,0 ,1 ,0 ,0 ,0 ,0 ,1 ,0 ,2 ,0 ,2,31232 , 0 
53401.696,17,92 ,6 ,775 ,0 ,0 ,3 ,1 ,3 ,0 ,0 ,7 ,0 ,2 ,3 ,5,36710 , 0 
53401.771,13,92 ,1 ,256 ,0 ,0 ,1 ,0 ,2 ,0 ,0 ,3 ,0 ,1 ,2 ,3,27600 , 0 
53401.787,3,92 ,1 ,256 ,0 ,0 ,1 ,0 ,0 ,0 ,0 ,1 ,0 ,2 ,0 ,2,19537 , 0 
53520.96,8,92 ,1 ,256 ,0 ,0 ,1 ,0 ,0 ,0 ,0 ,1 ,0 ,3 ,0 ,3,21604 , 0 
53521.078,11,92 ,9 ,1059 ,0 ,0 ,2 ,2 ,0 ,0 ,0 ,4 ,0 ,6 ,0 ,6,34289 , 0 
53521.123,2,92 ,1 ,256 ,0 ,0 ,2 ,0 ,5 ,0 ,0 ,7 ,0 ,3 ,5 ,8,39890 , 0 
53521.138,6,92 ,2 ,512 ,0 ,0 ,2 ,1 ,3 ,0 ,0 ,6 ,0 ,3 ,3 ,6,55795 , 0 
53521.214,18,92 ,19 ,521 ,0 ,0 ,2 ,0 ,0 ,0 ,0 ,2 ,0 ,5 ,0 ,5,27498 , 0 
53521.236,4,92 ,8 ,512 ,0 ,0 ,2 ,0 ,0 ,0 ,0 ,2 ,0 ,1 ,0 ,1,25002 , 0 
53521.289,7,92 ,17 ,1050 ,0 ,0 ,2 ,1 ,0 ,0 ,0 ,3 ,0 ,5 ,0 ,5,40317 , 0 
53521.337,14,92 ,1 ,256 ,0 ,0 ,2 ,0 ,0 ,0 ,0 ,2 ,0 ,2 ,0 ,2,25005 , 0 
53521.35,15,92 ,9 ,1109 ,0 ,0 ,2 ,1 ,0 ,0 ,0 ,3 ,0 ,4 ,0 ,4,30818 , 0 
53521.36,20,92 ,5 ,781 ,0 ,0 ,2 ,1 ,0 ,0 ,0 ,3 ,0 ,3 ,0 ,3,26583 , 0 
53521.36,16,92 ,2 ,512 ,0 ,0 ,1 ,1 ,0 ,0 ,0 ,2 ,0 ,6 ,0 ,6,57941 , 0 
53521.444,10,92 ,14 ,512 ,0 ,0 ,1 ,0 ,0 ,0 ,0 ,1 ,0 ,2 ,0 ,2,28656 , 0 
53521.482,12,92 ,5 ,781 ,0 ,0 ,2 ,1 ,0 ,0 ,0 ,3 ,0 ,4 ,0 ,4,29060 , 0 
53521.596,9,92 ,5 ,781 ,0 ,0 ,2 ,1 ,3 ,0 ,0 ,6 ,0 ,5 ,3 ,8,50015 , 0 
53521.603,5,92 ,13 ,517 ,0 ,0 ,2 ,0 ,6 ,0 ,0 ,8 ,0 ,5 ,6 ,11,47215 , 0 
53521.606,19,92 ,1 ,256 ,0 ,0 ,1 ,0 ,0 ,0 ,0 ,1 ,0 ,4 ,0 ,4,29996 , 0 
53521.696,17,92 ,6 ,794 ,0 ,0 ,2 ,2 ,1 ,0 ,0 ,5 ,0 ,4 ,1 ,5,37425 , 0 
53521.771,13,92 ,1 ,256 ,0 ,0 ,1 ,0 ,6 ,0 ,0 ,7 ,0 ,4 ,6 ,10,26862 , 0 
53521.787,3,92 ,1 ,256 ,0 ,0 ,2 ,0 ,0 ,0 ,0 ,2 ,0 ,0 ,0 ,0,18819 , 0 
53640.96,8,92 ,1 ,256 ,0 ,0 ,1 ,0 ,0 ,0 ,0 ,1 ,0 ,0 ,0 ,0,22315 , 0 
53641.078,11,92 ,9 ,1059 ,0 ,0 ,1 ,0 ,0 ,0 ,0 ,1 ,0 ,2 ,0 ,2,36401 , 0 
53641.123,2,92 ,1 ,256 ,0 ,0 ,1 ,0 ,1 ,0 ,0 ,2 ,0 ,2 ,1 ,3,38125 , 0 
53641.138,6,92 ,2 ,512 ,0 ,0 ,1 ,0 ,1 ,0 ,0 ,2 ,0 ,1 ,1 ,2,47817 , 0 
53641.214,18,92 ,19 ,521 ,0 ,0 ,1 ,0 ,0 ,0 ,0 ,1 ,0 ,0 ,0 ,0,30345 , 0 
53641.236,4,92 ,8 ,512 ,0 ,0 ,0 ,0 ,0 ,0 ,0 ,0 ,0 ,1 ,0 ,1,26636 , 0 
53641.289,7,92 ,17 ,1050 ,0 ,0 ,2 ,1 ,0 ,0 ,0 ,3 ,0 ,1 ,0 ,1,40403 , 0 
53641.337,14,92 ,1 ,256 ,0 ,0 ,1 ,0 ,0 ,0 ,0 ,1 ,0 ,1 ,0 ,1,25683 , 0 
53641.35,15,92 ,9 ,1109 ,0 ,0 ,1 ,0 ,0 ,0 ,0 ,1 ,0 ,0 ,0 ,0,32583 , 0 
53641.36,20,92 ,5 ,781 ,0 ,0 ,1 ,0 ,0 ,0 ,0 ,1 ,0 ,1 ,0 ,1,28968 , 0 
53641.36,16,92 ,2 ,512 ,0 ,0 ,1 ,0 ,0 ,0 ,0 ,1 ,0 ,2 ,0 ,2,53357 , 0 
53641.444,10,92 ,14 ,512 ,0 ,0 ,1 ,0 ,0 ,0 ,0 ,1 ,0 ,1 ,0 ,1,28064 , 0 
53641.482,12,92 ,5 ,781 ,0 ,0 ,1 ,0 ,0 ,0 ,0 ,1 ,0 ,0 ,0 ,0,31825 , 0 
53641.596,9,92 ,5 ,781 ,0 ,0 ,1 ,0 ,0 ,0 ,0 ,1 ,0 ,2 ,0 ,2,47888 , 0 
53641.602,5,92 ,13 ,517 ,0 ,0 ,1 ,0 ,0 ,0 ,0 ,1 ,0 ,1 ,0 ,1,48422 , 0 
53641.606,19,92 ,1 ,256 ,0 ,0 ,1 ,0 ,0 ,0 ,0 ,1 ,0 ,3 ,0 ,3,31309 , 0 
53641.696,17,92 ,6 ,794 ,0 ,0 ,1 ,0 ,1 ,0 ,0 ,2 ,0 ,0 ,1 ,1,36786 , 0 
53641.771,13,92 ,1 ,256 ,0 ,0 ,1 ,0 ,0 ,0 ,0 ,1 ,0 ,1 ,0 ,1,27676 , 0 
53641.787,3,92 ,1 ,256 ,0 ,0 ,1 ,0 ,0 ,0 ,0 ,1 ,0 ,0 ,0 ,0,19594 , 0 
53760.96,8,92 ,1 ,256 ,0 ,0 ,1 ,0 ,0 ,0 ,0 ,1 ,0 ,3 ,0 ,3,21672 , 0 
53761.078,11,92 ,9 ,1056 ,0 ,0 ,1 ,0 ,0 ,0 ,0 ,1 ,0 ,2 ,0 ,2,34349 , 0 
53761.123,2,92 ,1 ,256 ,0 ,0 ,2 ,0 ,3 ,0 ,0 ,5 ,0 ,2 ,3 ,5,40003 , 0 
53761.138,6,92 ,2 ,512 ,0 ,0 ,2 ,1 ,1 ,0 ,0 ,4 ,0 ,3 ,1 ,4,55879 , 0 
53761.214,18,92 ,19 ,521 ,0 ,0 ,1 ,0 ,0 ,0 ,0 ,1 ,0 ,0 ,0 ,0,27561 , 0 
53761.236,4,92 ,8 ,512 ,0 ,0 ,2 ,0 ,0 ,0 ,0 ,2 ,0 ,1 ,0 ,1,25080 , 0 
53761.289,7,92 ,17 ,1050 ,0 ,0 ,2 ,0 ,0 ,0 ,0 ,2 ,0 ,2 ,0 ,2,40381 , 0 
53761.337,14,92 ,1 ,256 ,0 ,0 ,1 ,0 ,0 ,0 ,0 ,1 ,0 ,3 ,0 ,3,25083 , 0 
53761.35,15,92 ,9 ,1056 ,0 ,0 ,0 ,1 ,0 ,0 ,0 ,1 ,0 ,3 ,0 ,3,30871 , 0 
53761.36,20,92 ,5 ,781 ,0 ,0 ,1 ,0 ,0 ,0 ,0 ,1 ,0 ,0 ,0 ,0,26639 , 0 
53761.36,16,92 ,2 ,512 ,0 ,0 ,1 ,1 ,0 ,0 ,0 ,2 ,0 ,6 ,0 ,6,58020 , 1 
53761.444,10,92 ,14 ,512 ,0 ,0 ,1 ,0 ,0 ,0 ,0 ,1 ,0 ,1 ,0 ,1,28711 , 0 
53761.482,12,92 ,5 ,781 ,0 ,0 ,1 ,0 ,0 ,0 ,0 ,1 ,0 ,1 ,0 ,1,29114 , 0 
53761.596,9,92 ,5 ,781 ,0 ,0 ,1 ,0 ,1 ,0 ,0 ,2 ,0 ,1 ,1 ,2,50082 , 0 
53761.602,5,92 ,13 ,517 ,0 ,0 ,1 ,0 ,1 ,0 ,0 ,2 ,0 ,4 ,1 ,5,47284 , 0 
53761.606,19,92 ,1 ,256 ,0 ,0 ,2 ,0 ,0 ,0 ,0 ,2 ,0 ,3 ,0 ,3,30084 , 0 
53761.696,17,92 ,6 ,778 ,0 ,0 ,2 ,1 ,0 ,0 ,0 ,3 ,0 ,3 ,0 ,3,37497 , 0 
53761.771,13,92 ,1 ,256 ,0 ,0 ,1 ,0 ,1 ,0 ,0 ,2 ,0 ,1 ,1 ,2,26929 , 0 
53761.787,3,92 ,1 ,256 ,0 ,0 ,1 ,0 ,0 ,0 ,0 ,1 ,0 ,2 ,0 ,2,18883 , 0 
53880.96,8,92 ,1 ,256 ,0 ,0 ,2 ,0 ,0 ,0 ,0 ,2 ,0 ,0 ,0 ,0,22387 , 0 
53881.078,11,92 ,9 ,1056 ,0 ,0 ,1 ,0 ,0 ,0 ,0 ,1 ,0 ,0 ,0 ,0,36477 , 0 
53881.123,2,92 ,1 ,256 ,0 ,0 ,1 ,0 ,1 ,0 ,0 ,2 ,0 ,1 ,1 ,2,38201 , 0 
53881.138,6,92 ,2 ,512 ,0 ,0 ,1 ,0 ,1 ,0 ,0 ,2 ,0 ,2 ,1 ,3,47898 , 0 
53881.214,18,92 ,19 ,521 ,0 ,0 ,1 ,0 ,0 ,0 ,0 ,1 ,0 ,2 ,0 ,2,30412 , 0 
53881.236,4,92 ,8 ,512 ,0 ,0 ,1 ,0 ,0 ,0 ,0 ,1 ,0 ,2 ,0 ,2,26702 , 0 
53881.289,7,92 ,17 ,1056 ,0 ,0 ,2 ,1 ,0 ,0 ,0 ,3 ,0 ,4 ,0 ,4,40516 , 0 
53881.337,14,92 ,1 ,256 ,0 ,0 ,1 ,0 ,0 ,0 ,0 ,1 ,0 ,1 ,0 ,1,25760 , 0 
53881.35,15,92 ,9 ,1050 ,0 ,0 ,2 ,1 ,0 ,0 ,0 ,3 ,0 ,2 ,0 ,2,32681 , 0 
53881.36,20,92 ,5 ,781 ,0 ,0 ,1 ,0 ,0 ,0 ,0 ,1 ,0 ,0 ,0 ,0,29039 , 0 
53881.36,16,92 ,2 ,512 ,0 ,0 ,2 ,0 ,0 ,0 ,0 ,2 ,0 ,2 ,0 ,2,53433 , 1 
53881.444,10,92 ,14 ,512 ,0 ,0 ,1 ,0 ,0 ,0 ,0 ,1 ,0 ,1 ,0 ,1,28124 , 0 
53881.482,12,92 ,5 ,768 ,0 ,0 ,1 ,1 ,0 ,0 ,0 ,2 ,0 ,3 ,0 ,3,31914 , 0 
53881.596,9,92 ,5 ,781 ,0 ,0 ,2 ,0 ,1 ,0 ,0 ,3 ,0 ,1 ,1 ,2,48017 , 0 
53881.602,5,92 ,13 ,512 ,0 ,0 ,2 ,0 ,2 ,0 ,0 ,4 ,0 ,4 ,2 ,6,48549 , 0 
53881.606,19,92 ,1 ,256 ,0 ,0 ,0 ,0 ,0 ,0 ,0 ,0 ,0 ,2 ,0 ,2,31382 , 0 
53881.696,17,92 ,6 ,778 ,0 ,0 ,1 ,0 ,1 ,0 ,0 ,2 ,0 ,0 ,1 ,1,36864 , 0 
53881.771,13,92 ,1 ,256 ,0 ,0 ,2 ,0 ,2 ,0 ,0 ,4 ,0 ,1 ,2 ,3,27762 , 0 
53881.787,3,92 ,1 ,256 ,0 ,0 ,1 ,0 ,0 ,0 ,0 ,1 ,0 ,1 ,0 ,1,19646 , 0 
54000.96,8,92 ,1 ,256 ,0 ,0 ,1 ,0 ,0 ,0 ,0 ,1 ,0 ,2 ,0 ,2,21743 , 0 
54001.078,11,92 ,9 ,1056 ,0 ,0 ,2 ,0 ,0 ,0 ,0 ,2 ,0 ,4 ,0 ,4,34430 , 0 
54001.123,2,92 ,1 ,256 ,0 ,0 ,1 ,0 ,0 ,0 ,0 ,1 ,0 ,3 ,0 ,3,40089 , 0 
54001.138,6,92 ,2 ,512 ,0 ,0 ,1 ,0 ,0 ,0 ,0 ,1 ,0 ,1 ,0 ,1,55963 , 0 
54001.214,18,92 ,19 ,521 ,0 ,0 ,2 ,0 ,0 ,0 ,0 ,2 ,0 ,1 ,0 ,1,27634 , 0 
54001.236,4,92 ,8 ,512 ,0 ,0 ,1 ,0 ,0 ,0 ,0 ,1 ,0 ,2 ,0 ,2,25161 , 0 
54001.289,7,92 ,17 ,1056 ,0 ,0 ,1 ,0 ,0 ,0 ,0 ,1 ,0 ,2 ,0 ,2,40451 , 0 
54001.337,14,92 ,1 ,256 ,0 ,0 ,1 ,0 ,0 ,0 ,0 ,1 ,0 ,3 ,0 ,3,25153 , 0 
54001.35,15,92 ,9 ,1050 ,0 ,0 ,2 ,0 ,0 ,0 ,0 ,2 ,0 ,1 ,0 ,1,30931 , 0 
54001.36,20,92 ,5 ,768 ,0 ,0 ,1 ,1 ,0 ,0 ,0 ,2 ,0 ,3 ,0 ,3,26717 , 0 
54001.36,16,92 ,2 ,512 ,0 ,0 ,1 ,0 ,0 ,0 ,0 ,1 ,0 ,2 ,0 ,2,58085 , 1 
54001.444,10,92 ,14 ,512 ,0 ,0 ,1 ,0 ,0 ,0 ,0 ,1 ,0 ,0 ,0 ,0,28774 , 0 
54001.482,12,92 ,5 ,768 ,0 ,0 ,1 ,0 ,0 ,0 ,0 ,1 ,0 ,3 ,0 ,3,29186 , 0 
54001.596,9,92 ,5 ,768 ,0 ,0 ,0 ,1 ,0 ,0 ,0 ,1 ,0 ,4 ,0 ,4,50139 , 0 
54001.602,5,92 ,13 ,512 ,0 ,0 ,1 ,0 ,2 ,0 ,0 ,3 ,0 ,2 ,2 ,4,47366 , 0 
54001.606,19,92 ,1 ,256 ,0 ,0 ,1 ,0 ,0 ,0 ,0 ,1 ,0 ,4 ,0 ,4,30150 , 0 
54001.696,17,92 ,6 ,778 ,0 ,0 ,1 ,0 ,0 ,0 ,0 ,1 ,0 ,2 ,0 ,2,37565 , 0 
54001.771,13,92 ,1 ,256 ,0 ,0 ,1 ,0 ,2 ,0 ,0 ,3 ,0 ,3 ,2 ,5,27018 , 0 
54001.787,3,92 ,1 ,256 ,0 ,0 ,3 ,0 ,0 ,0 ,0 ,3 ,0 ,0 ,0 ,0,18975 , 0 
54120.96,8,92 ,1 ,256 ,0 ,0 ,2 ,0 ,1 ,0 ,0 ,3 ,0 ,0 ,1 ,1,22450 , 0 
54121.078,11,92 ,9 ,1056 ,0 ,0 ,1 ,0 ,0 ,0 ,0 ,1 ,0 ,2 ,0 ,2,36568 , 0 
54121.123,2,92 ,1 ,256 ,0 ,0 ,3 ,0 ,5 ,0 ,0 ,8 ,0 ,0 ,5 ,5,38330 , 0 
54121.138,6,92 ,2 ,512 ,0 ,0 ,2 ,1 ,3 ,0 ,0 ,6 ,0 ,3 ,3 ,6,47989 , 0 
54121.214,18,92 ,19 ,521 ,0 ,0 ,1 ,0 ,0 ,0 ,0 ,1 ,0 ,2 ,0 ,2,30469 , 0 
54121.236,4,92 ,8 ,512 ,0 ,0 ,2 ,1 ,0 ,0 ,0 ,3 ,0 ,1 ,0 ,1,26761 , 0 
54121.289,7,92 ,17 ,1045 ,0 ,0 ,1 ,2 ,0 ,0 ,0 ,3 ,0 ,3 ,0 ,3,40576 , 0 
54121.337,14,92 ,1 ,256 ,0 ,0 ,1 ,0 ,0 ,0 ,0 ,1 ,0 ,4 ,0 ,4,25838 , 0 
54121.35,15,92 ,9 ,1050 ,0 ,0 ,0 ,0 ,0 ,0 ,0 ,0 ,0 ,0 ,0 ,0,32733 , 0 
54121.36,20,92 ,5 ,768 ,0 ,0 ,1 ,0 ,0 ,0 ,0 ,1 ,0 ,0 ,0 ,0,29094 , 0 
54121.36,16,92 ,2 ,512 ,0 ,0 ,1 ,1 ,0 ,0 ,0 ,2 ,0 ,3 ,0 ,3,53521 , 0 
54121.444,10,92 ,14 ,512 ,0 ,0 ,2 ,0 ,0 ,0 ,0 ,2 ,0 ,0 ,0 ,0,28185 , 0 
54121.482,12,92 ,5 ,768 ,0 ,0 ,1 ,0 ,0 ,0 ,0 ,1 ,0 ,2 ,0 ,2,31979 , 0 
54121.596,9,92 ,5 ,768 ,0 ,0 ,1 ,0 ,0 ,0 ,0 ,1 ,0 ,2 ,0 ,2,48096 , 0 
54121.602,5,92 ,13 ,512 ,0 ,0 ,2 ,1 ,0 ,0 ,0 ,3 ,0 ,5 ,0 ,5,48674 , 0 
54121.606,19,92 ,1 ,256 ,0 ,0 ,1 ,0 ,0 ,0 ,0 ,1 ,0 ,4 ,0 ,4,31468 , 0 
54121.696,17,92 ,6 ,774 ,0 ,0 ,2 ,1 ,2 ,0 ,0 ,5 ,0 ,1 ,2 ,3,36941 , 0 
54121.771,13,92 ,1 ,256 ,0 ,0 ,1 ,0 ,1 ,0 ,0 ,2 ,0 ,2 ,1 ,3,27830 , 0 
54121.787,3,92 ,1 ,256 ,0 ,0 ,1 ,0 ,0 ,0 ,0 ,1 ,0 ,0 ,0 ,0,19709 , 0 
54240.96,8,92 ,1 ,256 ,0 ,0 ,1 ,0 ,0 ,0 ,0 ,1 ,0 ,0 ,0 ,0,21812 , 0 
54241.078,11,92 ,9 ,1030 ,0 ,0 ,1 ,1 ,0 ,0 ,0 ,2 ,0 ,1 ,0 ,1,34509 , 0 
54241.123,2,92 ,1 ,256 ,0 ,0 ,0 ,0 ,2 ,0 ,0 ,2 ,0 ,3 ,2 ,5,40160 , 0 
54241.138,6,92 ,2 ,512 ,0 ,0 ,1 ,0 ,2 ,0 ,0 ,3 ,0 ,1 ,2 ,3,56069 , 0 
54241.214,18,92 ,19 ,521 ,0 ,0 ,1 ,0 ,0 ,0 ,0 ,1 ,0 ,1 ,0 ,1,27698 , 0 
54241.236,4,92 ,8 ,512 ,0 ,0 ,0 ,0 ,0 ,0 ,0 ,0 ,0 ,1 ,0 ,1,25242 , 0 
54241.289,7,92 ,17 ,1035 ,0 ,0 ,1 ,1 ,0 ,0 ,0 ,2 ,0 ,3 ,0 ,3,40542 , 0 
54241.337,14,92 ,1 ,256 ,0 ,0 ,1 ,0 ,0 ,0 ,0 ,1 ,0 ,0 ,0 ,0,25228 , 0 
54241.35,15,92 ,9 ,1030 ,0 ,0 ,2 ,1 ,0 ,0 ,0 ,3 ,0 ,4 ,0 ,4,31042 , 0 
54241.36,20,92 ,5 ,768 ,0 ,0 ,0 ,0 ,0 ,0 ,0 ,0 ,0 ,0 ,0 ,0,26774 , 0 
54241.36,16,92 ,2 ,512 ,0 ,0 ,1 ,0 ,0 ,0 ,0 ,1 ,0 ,2 ,0 ,2,58176 , 0 
54241.444,10,92 ,14 ,512 ,0 ,0 ,1 ,0 ,0 ,0 ,0 ,1 ,0 ,2 ,0 ,2,28845 , 0 
54241.482,12,92 ,5 ,768 ,0 ,0 ,1 ,0 ,0 ,0 ,0 ,1 ,0 ,1 ,0 ,1,29252 , 0 
54241.596,9,92 ,5 ,768 ,0 ,0 ,2 ,0 ,2 ,0 ,0 ,4 ,0 ,1 ,2 ,3,50245 , 0 
54241.602,5,92 ,13 ,512 ,0 ,0 ,1 ,0 ,2 ,0 ,0 ,3 ,0 ,1 ,2 ,3,47463 , 0 
54241.606,19,92 ,1 ,256 ,0 ,0 ,2 ,0 ,0 ,0 ,0 ,2 ,0 ,0 ,0 ,0,30252 , 0 
54241.696,17,92 ,6 ,770 ,0 ,0 ,1 ,1 ,1 ,0 ,0 ,3 ,0 ,2 ,1 ,3,37651 , 0 
54241.771,13,92 ,1 ,256 ,0 ,0 ,1 ,0 ,2 ,0 ,0 ,3 ,0 ,1 ,2 ,3,27090 , 0 
54241.787,3,92 ,1 ,256 ,0 ,0 ,1 ,0 ,0 ,0 ,0 ,1 ,0 ,1 ,0 ,1,19027 , 0 
54360.96,8,92 ,1 ,256 ,0 ,0 ,1 ,0 ,0 ,0 ,0 ,1 ,0 ,1 ,0 ,1,22509 , 0 
54361.098,11,92 ,9 ,1030 ,0 ,0 ,2 ,0 ,0 ,0 ,0 ,2 ,0 ,2 ,0 ,2,36649 , 0 
54361.123,2,92 ,1 ,256 ,0 ,0 ,1 ,0 ,1 ,0 ,1 ,3 ,0 ,2 ,3 ,5,38441 , 0 
54361.138,6,92 ,2 ,512 ,0 ,0 ,2 ,0 ,0 ,1 ,1 ,4 ,0 ,0 ,2 ,2,48084 , 0 
54361.214,18,92 ,19 ,521 ,0 ,0 ,1 ,0 ,0 ,0 ,0 ,1 ,0 ,1 ,0 ,1,30529 , 0 
54361.236,4,92 ,8 ,512 ,0 ,0 ,2 ,0 ,0 ,0 ,0 ,2 ,0 ,1 ,0 ,1,26842 , 0 
54361.289,7,92 ,16 ,778 ,0 ,0 ,5 ,1 ,0 ,1 ,0 ,7 ,0 ,1 ,0 ,1,40688 , 0 
54361.337,14,92 ,1 ,256 ,0 ,0 ,1 ,0 ,0 ,0 ,0 ,1 ,0 ,1 ,0 ,1,25905 , 0 
54361.35,15,92 ,9 ,1029 ,0 ,0 ,1 ,1 ,0 ,0 ,0 ,2 ,0 ,4 ,0 ,4,32804 , 0 
54361.36,20,92 ,5 ,768 ,0 ,0 ,1 ,0 ,0 ,0 ,0 ,1 ,0 ,2 ,0 ,2,29173 , 0 
54361.36,16,92 ,2 ,512 ,0 ,0 ,2 ,0 ,1 ,0 ,0 ,3 ,0 ,5 ,1 ,6,53605 , 0 
54361.444,10,92 ,14 ,512 ,0 ,0 ,1 ,0 ,0 ,0 ,0 ,1 ,0 ,1 ,0 ,1,28242 , 0 
54361.481,12,92 ,5 ,768 ,0 ,0 ,1 ,0 ,0 ,0 ,0 ,1 ,0 ,0 ,0 ,0,32050 , 0 
54361.596,9,92 ,5 ,768 ,0 ,0 ,2 ,0 ,1 ,0 ,0 ,3 ,0 ,6 ,1 ,7,48200 , 0 
54361.602,5,92 ,13 ,512 ,0 ,0 ,1 ,0 ,1 ,0 ,0 ,2 ,0 ,1 ,1 ,2,48769 , 0 
54361.606,19,92 ,1 ,256 ,0 ,0 ,1 ,0 ,0 ,0 ,0 ,1 ,0 ,3 ,0 ,3,31542 , 0 
54361.696,17,92 ,6 ,770 ,0 ,0 ,0 ,0 ,0 ,1 ,1 ,2 ,0 ,4 ,1 ,5,37018 , 0 
54361.771,13,92 ,1 ,256 ,0 ,0 ,1 ,0 ,1 ,0 ,0 ,2 ,0 ,1 ,1 ,2,27932 , 0 
54361.787,3,92 ,1 ,256 ,0 ,0 ,1 ,0 ,0 ,0 ,0 ,1 ,0 ,0 ,0 ,0,19767 , 0 
54480.961,8,109 ,1 ,256 ,0 ,0 ,10 ,5 ,1 ,9 ,0 ,25 ,0 ,21 ,4 ,25,22256 , 0 
54481.078,11,112 ,5 ,873 ,0 ,0 ,12 ,6 ,4 ,7 ,3 ,32 ,0 ,25 ,11 ,36,35077 , 0 
54481.124,2,109 ,1 ,256 ,0 ,0 ,9 ,5 ,9 ,5 ,7 ,35 ,0 ,27 ,21 ,48,40488 , 0 
54481.138,6,108 ,2 ,768 ,0 ,0 ,9 ,2 ,0 ,4 ,1 ,16 ,0 ,23 ,1 ,24,56360 , 0 
54481.214,18,112 ,4 ,1104 ,0 ,0 ,11 ,4 ,0 ,7 ,0 ,22 ,0 ,18 ,0 ,18,28256 , 0 
54481.236,4,107 ,19 ,662 ,0 ,0 ,8 ,4 ,1 ,8 ,1 ,22 ,0 ,13 ,2 ,15,25558 , 0 
54481.29,7,113 ,16 ,65535 ,0 ,0 ,11 ,0 ,3 ,1 ,1 ,16 ,0 ,15 ,19 ,34,40818 , 1 
54481.338,14,108 ,1 ,256 ,0 ,0 ,7 ,3 ,2 ,7 ,2 ,21 ,0 ,22 ,5 ,27,25575 , 0 
54481.35,15,112 ,7 ,1109 ,0 ,0 ,9 ,2 ,2 ,3 ,1 ,17 ,0 ,22 ,5 ,27,31297 , 0 
54481.36,20,112 ,11 ,1897 ,0 ,0 ,10 ,3 ,0 ,5 ,0 ,18 ,0 ,14 ,0 ,14,27107 , 0 
54481.361,16,112 ,2 ,537 ,0 ,0 ,11 ,2 ,2 ,3 ,0 ,18 ,0 ,22 ,3 ,25,58470 , 0 
54481.444,10,108 ,14 ,2377 ,0 ,0 ,7 ,2 ,0 ,3 ,0 ,12 ,0 ,6 ,0 ,6,29054 , 0 
54481.482,12,112 ,11 ,1897 ,0 ,0 ,12 ,5 ,0 ,7 ,0 ,24 ,0 ,14 ,2 ,16,29813 , 0 
54481.596,9,112 ,7 ,1109 ,0 ,0 ,8 ,2 ,7 ,4 ,7 ,28 ,0 ,15 ,15 ,30,50764 , 0 
54481.603,5,112 ,13 ,512 ,0 ,0 ,11 ,3 ,7 ,6 ,9 ,36 ,0 ,32 ,21 ,53,48030 , 0 
54481.607,19,112 ,1 ,256 ,0 ,0 ,10 ,5 ,4 ,7 ,3 ,29 ,0 ,28 ,17 ,45,30789 , 0 
54481.697,17,112 ,6 ,1559 ,0 ,0 ,11 ,2 ,0 ,4 ,0 ,17 ,0 ,15 ,0 ,15,37969 , 0 
54481.772,13,109 ,1 ,256 ,0 ,0 ,9 ,4 ,0 ,9 ,3 ,25 ,0 ,23 ,4 ,27,27416 , 0 
54481.787,3,109 ,1 ,256 ,0 ,0 ,9 ,4 ,5 ,3 ,3 ,24 ,0 ,14 ,8 ,22,19231 , 0 
54600.963,8,149 ,1 ,256 ,0 ,0 ,16 ,13 ,9 ,11 ,6 ,55 ,0 ,45 ,19 ,64,22931 , 0 
54601.078,11,149 ,5 ,998 ,0 ,0 ,22 ,4 ,2 ,4 ,0 ,32 ,0 ,51 ,3 ,54,37068 , 0 
54601.126,2,149 ,19 ,512 ,0 ,0 ,17 ,6 ,4 ,10 ,1 ,38 ,0 ,71 ,14 ,85,38838 , 0 
54601.138,6,149 ,2 ,512 ,0 ,0 ,21 ,2 ,0 ,2 ,0 ,25 ,0 ,48 ,0 ,48,48381 , 0 
54601.214,18,149 ,19 ,512 ,0 ,0 ,18 ,9 ,3 ,7 ,2 ,39 ,0 ,44 ,6 ,50,31029 , 0 
54601.236,4,149 ,8 ,512 ,0 ,0 ,16 ,12 ,0 ,10 ,0 ,38 ,0 ,34 ,1 ,35,27376 , 0 
54601.29,7,153 ,16 ,65535 ,0 ,0 ,20 ,0 ,0 ,0 ,0 ,20 ,0 ,40 ,0 ,40,40896 , 1 
54601.338,14,149 ,1 ,256 ,0 ,0 ,16 ,7 ,2 ,10 ,1 ,36 ,0 ,51 ,9 ,60,26216 , 0 
54601.35,15,152 ,7 ,1109 ,0 ,0 ,19 ,0 ,0 ,0 ,0 ,19 ,0 ,40 ,0 ,40,33002 , 0 
54601.36,20,149 ,0 ,0 ,0 ,0 ,16 ,3 ,0 ,3 ,0 ,22 ,0 ,33 ,0 ,33,29458 , 0 
54601.361,16,152 ,2 ,512 ,0 ,0 ,19 ,0 ,0 ,3 ,0 ,22 ,0 ,46 ,0 ,46,53889 , 0 
54601.444,10,149 ,14 ,512 ,0 ,0 ,17 ,3 ,0 ,5 ,0 ,25 ,0 ,31 ,0 ,31,28560 , 0 
54601.482,12,149 ,18 ,768 ,0 ,0 ,19 ,5 ,0 ,5 ,0 ,29 ,0 ,37 ,0 ,37,32390 , 0 
54601.596,9,149 ,5 ,998 ,0 ,0 ,21 ,1 ,0 ,2 ,0 ,24 ,0 ,56 ,0 ,56,48469 , 0 
54601.603,5,149 ,2 ,512 ,0 ,0 ,20 ,5 ,8 ,9 ,3 ,45 ,0 ,71 ,22 ,93,49366 , 0 
54601.697,17,152 ,6 ,1559 ,0 ,0 ,19 ,0 ,0 ,0 ,0 ,19 ,0 ,40 ,0 ,40,37217 , 0 
54601.758,19,149 ,1 ,256 ,0 ,0 ,18 ,9 ,15 ,12 ,7 ,61 ,0 ,76 ,35 ,111,31973 , 0 
54601.772,13,149 ,1 ,256 ,0 ,0 ,16 ,5 ,8 ,8 ,3 ,40 ,0 ,55 ,17 ,72,28267 , 0 
54601.861,3,149 ,1 ,256 ,0 ,0 ,15 ,11 ,1 ,11 ,2 ,40 ,0 ,32 ,4 ,36,20044 , 0 
54720.961,8,183 ,0 ,0 ,0 ,0 ,18 ,7 ,4 ,10 ,3 ,42 ,0 ,47 ,10 ,57,22576 , 0 
54721.078,11,188 ,5 ,768 ,0 ,0 ,19 ,0 ,0 ,2 ,0 ,21 ,0 ,65 ,2 ,67,35402 , 0 
54721.124,2,190 ,1 ,256 ,0 ,0 ,22 ,3 ,0 ,10 ,2 ,37 ,0 ,69 ,5 ,74,40927 , 0 
54721.138,6,190 ,2 ,512 ,0 ,0 ,19 ,0 ,0 ,2 ,0 ,21 ,0 ,51 ,0 ,51,56659 , 0 
54721.214,18,188 ,19 ,512 ,0 ,0 ,18 ,5 ,0 ,10 ,0 ,33 ,0 ,44 ,2 ,46,28711 , 0 
54721.236,4,188 ,19 ,512 ,0 ,0 ,19 ,7 ,0 ,12 ,0 ,38 ,0 ,31 ,0 ,31,26040 , 0 
54721.29,7,191 ,16 ,65535 ,0 ,0 ,19 ,0 ,0 ,0 ,0 ,19 ,0 ,48 ,0 ,48,41021 , 1 
54721.338,14,182 ,1 ,256 ,0 ,0 ,16 ,6 ,4 ,11 ,3 ,40 ,0 ,56 ,9 ,65,25877 , 0 
54721.35,15,190 ,7 ,1109 ,0 ,0 ,19 ,0 ,0 ,0 ,0 ,19 ,0 ,44 ,0 ,44,31504 , 0 
54721.361,16,190 ,2 ,512 ,0 ,0 ,19 ,0 ,0 ,1 ,0 ,20 ,0 ,52 ,0 ,52,58719 , 0 
54721.364,20,188 ,5 ,768 ,0 ,0 ,18 ,4 ,0 ,5 ,0 ,27 ,0 ,40 ,1 ,41,27457 , 0 
54721.444,10,182 ,14 ,512 ,0 ,0 ,14 ,4 ,0 ,6 ,0 ,24 ,0 ,22 ,0 ,22,29392 , 0 
54721.482,12,188 ,5 ,768 ,0 ,0 ,18 ,1 ,0 ,6 ,0 ,25 ,0 ,47 ,0 ,47,30154 , 0 
54721.596,9,190 ,5 ,941 ,0 ,0 ,20 ,0 ,0 ,1 ,0 ,21 ,0 ,57 ,0 ,57,51065 , 0 
54721.603,5,190 ,19 ,512 ,0 ,0 ,22 ,5 ,3 ,10 ,1 ,41 ,0 ,74 ,16 ,90,48593 , 0 
54721.607,19,188 ,1 ,256 ,0 ,0 ,17 ,6 ,8 ,12 ,6 ,49 ,0 ,73 ,28 ,101,31170 , 0 
54721.697,17,190 ,6 ,1559 ,0 ,0 ,19 ,0 ,0 ,0 ,0 ,19 ,0 ,42 ,0 ,42,38169 , 0 
54721.772,13,188 ,1 ,256 ,0 ,0 ,17 ,7 ,5 ,9 ,2 ,40 ,0 ,57 ,11 ,68,27806 , 0 
54721.787,3,189 ,1 ,256 ,0 ,0 ,17 ,10 ,0 ,13 ,0 ,40 ,0 ,36 ,1 ,37,19523 , 0 
54840.96,8,193 ,1 ,256 ,0 ,0 ,8 ,5 ,0 ,3 ,0 ,16 ,0 ,23 ,1 ,24,23121 , 0 
54841.082,11,193 ,5 ,822 ,0 ,0 ,8 ,5 ,3 ,0 ,0 ,16 ,0 ,29 ,3 ,32,37312 , 0 
54841.124,2,193 ,1 ,256 ,0 ,0 ,6 ,4 ,10 ,3 ,3 ,26 ,0 ,30 ,14 ,44,39096 , 0 
54841.139,6,193 ,10 ,811 ,0 ,0 ,12 ,4 ,9 ,2 ,1 ,28 ,0 ,17 ,10 ,27,48746 , 0 
54841.214,18,193 ,19 ,512 ,0 ,0 ,7 ,1 ,1 ,1 ,0 ,10 ,0 ,23 ,2 ,25,31181 , 0 
54841.236,4,193 ,18 ,768 ,0 ,0 ,10 ,4 ,0 ,3 ,0 ,17 ,0 ,14 ,0 ,14,27611 , 0 
54841.29,7,193 ,16 ,1280 ,0 ,0 ,10 ,3 ,0 ,0 ,0 ,13 ,0 ,17 ,0 ,17,41087 , 0 
54841.338,14,193 ,1 ,256 ,0 ,0 ,8 ,5 ,10 ,2 ,0 ,25 ,0 ,16 ,10 ,26,26378 , 0 
54841.351,15,193 ,11 ,1275 ,0 ,0 ,10 ,3 ,0 ,1 ,0 ,14 ,0 ,19 ,0 ,19,33244 , 0 
54841.36,20,193 ,5 ,822 ,0 ,0 ,11 ,3 ,0 ,1 ,0 ,15 ,0 ,15 ,0 ,15,29680 , 0 
54841.361,16,193 ,2 ,512 ,0 ,0 ,8 ,2 ,4 ,1 ,1 ,16 ,0 ,27 ,5 ,32,54230 , 0 
54841.444,10,193 ,14 ,512 ,0 ,0 ,10 ,5 ,8 ,1 ,0 ,24 ,0 ,15 ,9 ,24,28833 , 0 
54841.482,12,193 ,5 ,975 ,0 ,0 ,9 ,2 ,1 ,2 ,1 ,15 ,0 ,19 ,2 ,21,32616 , 0 
54841.596,9,193 ,5 ,822 ,0 ,0 ,7 ,5 ,0 ,0 ,0 ,12 ,0 ,27 ,1 ,28,48679 , 0 
54841.603,5,193 ,13 ,512 ,0 ,0 ,9 ,2 ,18 ,1 ,1 ,31 ,0 ,31 ,20 ,51,49663 , 0 
54841.607,19,193 ,1 ,256 ,0 ,0 ,9 ,4 ,6 ,2 ,2 ,23 ,0 ,34 ,10 ,44,32168 , 0 
54841.697,17,193 ,6 ,1067 ,0 ,0 ,9 ,7 ,0 ,1 ,0 ,17 ,0 ,23 ,0 ,23,37488 , 0 
54841.772,13,193 ,1 ,256 ,0 ,0 ,8 ,3 ,19 ,2 ,1 ,33 ,0 ,18 ,20 ,38,28477 , 0 
54841.787,3,193 ,1 ,256 ,0 ,0 ,7 ,4 ,0 ,1 ,0 ,12 ,0 ,12 ,0 ,12,20191 , 0 
54960.96,8,193 ,1 ,256 ,0 ,0 ,2 ,1 ,1 ,0 ,0 ,4 ,0 ,9 ,1 ,10,22657 , 0 
54961.078,11,193 ,5 ,798 ,0 ,0 ,1 ,1 ,1 ,0 ,0 ,3 ,0 ,5 ,1 ,6,35470 , 0 
54961.124,2,193 ,1 ,256 ,0 ,0 ,3 ,1 ,3 ,0 ,0 ,7 ,0 ,11 ,3 ,14,41013 , 0 
54961.138,6,193 ,10 ,792 ,0 ,0 ,2 ,2 ,1 ,0 ,0 ,5 ,0 ,6 ,1 ,7,56736 , 0 
54961.214,18,193 ,19 ,512 ,0 ,0 ,2 ,2 ,1 ,0 ,1 ,6 ,0 ,6 ,2 ,8,28832 , 0 
54961.236,4,193 ,8 ,521 ,0 ,0 ,5 ,2 ,0 ,1 ,0 ,8 ,0 ,5 ,0 ,5,26158 , 0 
54961.289,7,193 ,16 ,1186 ,0 ,0 ,3 ,1 ,0 ,0 ,0 ,4 ,0 ,3 ,0 ,3,41106 , 0 
54961.338,14,193 ,1 ,256 ,0 ,0 ,3 ,1 ,5 ,0 ,0 ,9 ,0 ,7 ,5 ,12,25975 , 0 
54961.351,15,193 ,11 ,1162 ,0 ,0 ,1 ,1 ,0 ,0 ,0 ,2 ,0 ,5 ,0 ,5,31568 , 0 
54961.36,20,193 ,5 ,798 ,0 ,0 ,2 ,1 ,0 ,0 ,0 ,3 ,0 ,3 ,0 ,3,27526 , 0 
54961.36,16,193 ,2 ,512 ,0 ,0 ,2 ,2 ,1 ,0 ,0 ,5 ,0 ,8 ,1 ,9,58811 , 0 
54961.444,10,193 ,14 ,512 ,0 ,0 ,2 ,2 ,3 ,0 ,0 ,7 ,0 ,3 ,3 ,6,29498 , 0 
54961.482,12,193 ,5 ,798 ,0 ,0 ,1 ,1 ,0 ,0 ,0 ,2 ,0 ,6 ,0 ,6,30238 , 0 
54961.596,9,193 ,5 ,798 ,0 ,0 ,3 ,1 ,0 ,0 ,0 ,4 ,0 ,7 ,0 ,7,51150 , 0 
54961.603,5,193 ,13 ,512 ,0 ,0 ,2 ,2 ,5 ,0 ,0 ,9 ,0 ,10 ,5 ,15,48721 , 0 
54961.607,19,193 ,1 ,256 ,0 ,0 ,3 ,1 ,3 ,0 ,1 ,8 ,0 ,14 ,4 ,18,31269 , 0 
54961.696,17,193 ,6 ,1048 ,0 ,0 ,2 ,1 ,0 ,0 ,0 ,3 ,0 ,4 ,0 ,4,38242 , 0 
54961.771,13,193 ,1 ,256 ,0 ,0 ,3 ,1 ,7 ,0 ,0 ,11 ,0 ,9 ,7 ,16,27888 , 0 
54961.787,3,193 ,1 ,256 ,0 ,0 ,2 ,1 ,0 ,0 ,0 ,3 ,0 ,4 ,0 ,4,19595 , 0 
55080.96,8,193 ,1 ,256 ,0 ,0 ,1 ,1 ,1 ,0 ,0 ,3 ,0 ,5 ,1 ,6,23182 , 0 
55081.078,11,193 ,5 ,798 ,0 ,0 ,3 ,0 ,1 ,0 ,0 ,4 ,0 ,6 ,1 ,7,37400 , 0 
55081.123,2,193 ,1 ,256 ,0 ,0 ,1 ,1 ,2 ,0 ,0 ,4 ,0 ,4 ,2 ,6,39191 , 0 
55081.138,6,193 ,10 ,777 ,0 ,0 ,2 ,2 ,1 ,0 ,0 ,5 ,0 ,4 ,1 ,5,48825 , 0 
55081.214,18,193 ,19 ,512 ,0 ,0 ,3 ,0 ,0 ,1 ,0 ,4 ,0 ,4 ,0 ,4,31249 , 0 
55081.236,4,193 ,8 ,521 ,0 ,0 ,3 ,1 ,0 ,0 ,0 ,4 ,0 ,3 ,0 ,3,27710 , 0 
55081.289,7,193 ,16 ,1041 ,0 ,0 ,1 ,2 ,0 ,0 ,0 ,3 ,0 ,6 ,0 ,6,41162 , 0 
55081.337,14,193 ,1 ,256 ,0 ,0 ,0 ,1 ,3 ,0 ,0 ,4 ,0 ,4 ,3 ,7,26455 , 0 
55081.35,15,193 ,11 ,1114 ,0 ,0 ,2 ,1 ,0 ,0 ,0 ,3 ,0 ,3 ,0 ,3,33319 , 0 
55081.36,20,193 ,5 ,798 ,0 ,0 ,3 ,0 ,0 ,0 ,0 ,3 ,0 ,2 ,0 ,2,29746 , 0 
55081.36,16,193 ,2 ,512 ,0 ,0 ,2 ,0 ,2 ,0 ,0 ,4 ,0 ,4 ,2 ,6,54315 , 0 
55081.444,10,193 ,14 ,512 ,0 ,0 ,2 ,0 ,3 ,0 ,0 ,5 ,0 ,1 ,3 ,4,28916 , 0 
55081.482,12,193 ,5 ,798 ,0 ,0 ,2 ,0 ,0 ,0 ,0 ,2 ,0 ,4 ,0 ,4,32686 , 0 
55081.596,9,193 ,5 ,798 ,0 ,0 ,2 ,0 ,0 ,0 ,0 ,2 ,0 ,4 ,0 ,4,48770 , 0 
55081.603,5,193 ,13 ,512 ,0 ,0 ,0 ,0 ,1 ,0 ,0 ,1 ,0 ,5 ,1 ,6,49757 , 0 
55081.606,19,193 ,1 ,256 ,0 ,0 ,1 ,1 ,0 ,1 ,0 ,3 ,0 ,5 ,1 ,6,32255 , 0 
55081.696,17,193 ,6 ,1048 ,0 ,0 ,2 ,1 ,0 ,0 ,0 ,3 ,0 ,3 ,0 ,3,37554 , 0 
55081.771,13,193 ,1 ,256 ,0 ,0 ,1 ,1 ,1 ,0 ,0 ,3 ,0 ,1 ,1 ,2,28576 , 0 
55081.787,3,193 ,1 ,256 ,0 ,0 ,2 ,1 ,0 ,0 ,0 ,3 ,0 ,1 ,0 ,1,20254 , 0 
55200.96,8,193 ,1 ,256 ,0 ,0 ,1 ,0 ,0 ,0 ,0 ,1 ,0 ,3 ,0 ,3,22750 , 0 
55201.101,11,193 ,9 ,300 ,0 ,0 ,3 ,2 ,6 ,1 ,1 ,13 ,0 ,7 ,9 ,16,35724 , 0 
55201.124,2,193 ,1 ,256 ,0 ,0 ,1 ,0 ,3 ,0 ,2 ,6 ,0 ,8 ,6 ,14,41180 , 0 
55201.138,6,193 ,16 ,624 ,0 ,0 ,5 ,4 ,0 ,3 ,1 ,13 ,0 ,8 ,1 ,9,56941 , 0 
55201.214,18,193 ,19 ,512 ,0 ,0 ,2 ,1 ,0 ,0 ,0 ,3 ,0 ,7 ,0 ,7,28986 , 0 
55201.236,4,193 ,8 ,521 ,0 ,0 ,1 ,0 ,0 ,0 ,0 ,1 ,0 ,2 ,0 ,2,26335 , 0 
55201.289,7,193 ,9 ,300 ,0 ,0 ,3 ,3 ,0 ,1 ,0 ,7 ,0 ,9 ,0 ,9,41270 , 0 
55201.337,14,193 ,1 ,256 ,0 ,0 ,2 ,0 ,1 ,0 ,1 ,4 ,0 ,1 ,3 ,4,26057 , 0 
55201.35,15,193 ,11 ,556 ,0 ,0 ,4 ,2 ,6 ,2 ,1 ,15 ,0 ,5 ,12 ,17,31913 , 0 
55201.36,20,193 ,11 ,556 ,0 ,0 ,2 ,2 ,0 ,1 ,0 ,5 ,0 ,4 ,0 ,4,27689 , 0 
55201.361,16,193 ,9 ,300 ,0 ,0 ,5 ,4 ,6 ,3 ,3 ,21 ,0 ,8 ,11 ,19,59166 , 0 
55201.444,10,193 ,14 ,512 ,0 ,0 ,1 ,1 ,1 ,0 ,2 ,5 ,0 ,5 ,3 ,8,29629 , 0 
55201.482,12,193 ,5 ,782 ,0 ,0 ,2 ,2 ,0 ,2 ,0 ,6 ,0 ,2 ,0 ,2,30418 , 0 
55201.596,9,193 ,15 ,928 ,0 ,0 ,5 ,3 ,9 ,3 ,2 ,22 ,0 ,7 ,18 ,25,51432 , 1 
55201.603,5,193 ,9 ,300 ,0 ,0 ,5 ,1 ,5 ,1 ,5 ,17 ,0 ,3 ,10 ,13,49006 , 0 
55201.606,19,193 ,1 ,256 ,0 ,0 ,2 ,0 ,1 ,0 ,0 ,3 ,0 ,6 ,1 ,7,31502 , 0 
55201.696,17,193 ,6 ,829 ,0 ,0 ,5 ,2 ,0 ,2 ,0 ,9 ,0 ,4 ,0 ,4,38435 , 0 
55201.771,13,193 ,1 ,256 ,0 ,0 ,2 ,0 ,5 ,0 ,3 ,10 ,0 ,4 ,8 ,12,27996 , 0 
55201.787,3,193 ,1 ,256 ,0 ,0 ,2 ,0 ,0 ,0 ,0 ,2 ,0 ,2 ,0 ,2,19661 , 0 
55320.96,8,193 ,1 ,256 ,0 ,0 ,2 ,1 ,0 ,0 ,0 ,3 ,0 ,3 ,0 ,3,23267 , 0 
55321.078,11,193 ,9 ,300 ,0 ,0 ,4 ,4 ,16 ,1 ,1 ,26 ,0 ,19 ,19 ,38,37727 , 0 
55321.124,2,193 ,1 ,256 ,0 ,0 ,6 ,1 ,25 ,1 ,2 ,35 ,0 ,9 ,27 ,36,39352 , 0 
55321.138,6,193 ,2 ,491 ,0 ,0 ,7 ,3 ,0 ,2 ,0 ,12 ,0 ,13 ,1 ,14,49048 , 0 
55321.214,18,193 ,19 ,512 ,0 ,0 ,0 ,0 ,0 ,0 ,0 ,0 ,0 ,7 ,0 ,7,31328 , 0 
55321.236,4,193 ,8 ,521 ,0 ,0 ,2 ,0 ,0 ,0 ,0 ,2 ,0 ,0 ,0 ,0,27796 , 0 
55321.289,7,193 ,9 ,300 ,0 ,0 ,3 ,4 ,3 ,0 ,0 ,10 ,0 ,15 ,3 ,18,41357 , 0 
55321.337,14,193 ,1 ,256 ,0 ,0 ,1 ,1 ,0 ,1 ,0 ,3 ,0 ,7 ,1 ,8,26578 , 0 
55321.351,15,193 ,11 ,621 ,0 ,0 ,5 ,4 ,10 ,1 ,1 ,21 ,0 ,10 ,12 ,22,33628 , 0 
55321.36,20,193 ,5 ,662 ,0 ,0 ,7 ,3 ,0 ,1 ,0 ,11 ,0 ,10 ,0 ,10,29936 , 0 
55321.361,16,193 ,9 ,300 ,0 ,0 ,4 ,5 ,0 ,3 ,1 ,13 ,0 ,18 ,2 ,20,54610 , 0 
55321.444,10,193 ,14 ,512 ,0 ,0 ,2 ,0 ,0 ,1 ,0 ,3 ,0 ,5 ,0 ,5,29013 , 0 
55321.482,12,193 ,5 ,662 ,0 ,0 ,6 ,3 ,0 ,0 ,0 ,9 ,0 ,9 ,0 ,9,32907 , 0 
55321.596,9,193 ,5 ,662 ,0 ,0 ,7 ,4 ,26 ,3 ,1 ,41 ,0 ,14 ,39 ,53,49281 , 1 
55321.603,5,193 ,2 ,491 ,0 ,0 ,4 ,4 ,20 ,2 ,1 ,31 ,0 ,20 ,27 ,47,50242 , 0 
55321.606,19,193 ,1 ,256 ,0 ,0 ,1 ,1 ,0 ,0 ,0 ,2 ,0 ,7 ,0 ,7,32405 , 0 
55321.697,17,193 ,7 ,735 ,0 ,0 ,6 ,3 ,0 ,1 ,0 ,10 ,0 ,11 ,0 ,11,37687 , 0 
55321.771,13,193 ,1 ,256 ,0 ,0 ,1 ,1 ,0 ,2 ,0 ,4 ,0 ,8 ,0 ,8,28678 , 0 
55321.787,3,193 ,1 ,256 ,0 ,0 ,1 ,1 ,0 ,0 ,0 ,2 ,0 ,3 ,0 ,3,20323 , 0 
55440.96,8,193 ,1 ,256 ,0 ,0 ,0 ,0 ,0 ,0 ,0 ,0 ,0 ,1 ,0 ,1,22805 , 0 
55441.078,11,193 ,9 ,300 ,0 ,0 ,2 ,5 ,1 ,0 ,0 ,8 ,0 ,8 ,1 ,9,35859 , 0 
55441.138,6,193 ,16 ,693 ,0 ,0 ,5 ,1 ,0 ,1 ,0 ,7 ,0 ,4 ,0 ,4,57040 , 0 
55441.214,18,193 ,19 ,512 ,0 ,0 ,1 ,0 ,0 ,0 ,0 ,1 ,0 ,6 ,0 ,6,29195 , 0 
55441.227,2,193 ,1 ,256 ,0 ,0 ,3 ,0 ,7 ,0 ,3 ,13 ,0 ,7 ,10 ,17,41330 , 0 
55441.236,4,193 ,8 ,521 ,0 ,0 ,1 ,0 ,0 ,0 ,0 ,1 ,0 ,1 ,0 ,1,26407 , 0 
55441.29,7,193 ,16 ,693 ,0 ,0 ,5 ,2 ,3 ,4 ,0 ,14 ,0 ,8 ,10 ,18,41417 , 0 
55441.337,14,193 ,1 ,256 ,0 ,0 ,1 ,0 ,0 ,0 ,0 ,1 ,0 ,2 ,0 ,2,26119 , 0 
55441.35,15,193 ,11 ,597 ,0 ,0 ,2 ,1 ,0 ,0 ,0 ,3 ,0 ,9 ,0 ,9,31999 , 0 
55441.36,20,193 ,5 ,796 ,0 ,0 ,1 ,2 ,0 ,0 ,0 ,3 ,0 ,5 ,0 ,5,27774 , 0 
55441.361,16,193 ,6 ,1072 ,0 ,0 ,3 ,5 ,1 ,1 ,0 ,10 ,0 ,15 ,2 ,17,59295 , 0 
55441.446,10,193 ,14 ,512 ,0 ,0 ,0 ,0 ,0 ,0 ,0 ,0 ,0 ,6 ,0 ,6,29680 , 0 
55441.482,12,193 ,5 ,796 ,0 ,0 ,2 ,2 ,0 ,0 ,0 ,4 ,0 ,4 ,0 ,4,30501 , 0 
55441.596,9,193 ,5 ,796 ,0 ,0 ,5 ,4 ,7 ,6 ,1 ,23 ,0 ,9 ,22 ,31,51682 , 1 
55441.603,5,193 ,2 ,500 ,0 ,0 ,3 ,1 ,7 ,0 ,2 ,13 ,0 ,8 ,12 ,20,49222 , 0 
55441.606,19,193 ,1 ,256 ,0 ,0 ,1 ,0 ,0 ,0 ,0 ,1 ,0 ,4 ,0 ,4,31590 , 0 
55441.697,17,193 ,16 ,693 ,0 ,0 ,1 ,3 ,0 ,1 ,0 ,5 ,0 ,12 ,0 ,12,38532 , 0 
55441.771,13,193 ,1 ,256 ,0 ,0 ,0 ,0 ,0 ,0 ,0 ,0 ,0 ,3 ,0 ,3,28060 , 0 
55441.787,3,193 ,1 ,256 ,0 ,0 ,0 ,0 ,0 ,0 ,0 ,0 ,0 ,0 ,0 ,0,19711 , 0 
55560.96,8,193 ,1 ,256 ,0 ,0 ,2 ,0 ,0 ,0 ,0 ,2 ,0 ,0 ,0 ,0,23333 , 0 
55561.078,11,193 ,5 ,800 ,0 ,0 ,5 ,5 ,4 ,1 ,1 ,16 ,0 ,21 ,7 ,28,38009 , 0 
55561.124,2,193 ,1 ,256 ,0 ,0 ,0 ,0 ,9 ,4 ,2 ,15 ,0 ,10 ,11 ,21,39521 , 0 
55561.138,6,193 ,2 ,500 ,0 ,0 ,7 ,1 ,0 ,1 ,0 ,9 ,0 ,7 ,4 ,11,49247 , 0 
55561.214,18,193 ,19 ,512 ,0 ,0 ,2 ,0 ,0 ,0 ,0 ,2 ,0 ,4 ,0 ,4,31451 , 0 
55561.236,4,193 ,8 ,521 ,0 ,0 ,0 ,0 ,0 ,0 ,0 ,0 ,0 ,1 ,0 ,1,27866 , 0 
55561.29,7,193 ,16 ,1109 ,0 ,0 ,9 ,5 ,0 ,2 ,0 ,16 ,0 ,15 ,1 ,16,41555 , 0 
55561.337,14,193 ,1 ,256 ,0 ,0 ,2 ,0 ,1 ,0 ,0 ,3 ,0 ,3 ,1 ,4,26686 , 0 
55561.35,15,193 ,11 ,1227 ,0 ,0 ,7 ,2 ,1 ,2 ,0 ,12 ,0 ,13 ,4 ,17,33848 , 0 
55561.36,20,193 ,5 ,800 ,0 ,0 ,8 ,5 ,0 ,2 ,0 ,15 ,0 ,7 ,0 ,7,30194 , 0 
55561.361,16,193 ,2 ,503 ,0 ,0 ,8 ,1 ,10 ,1 ,1 ,21 ,0 ,12 ,12 ,24,54956 , 0 
55561.444,10,193 ,14 ,512 ,0 ,0 ,1 ,1 ,0 ,0 ,0 ,2 ,0 ,7 ,0 ,7,29090 , 0 
55561.482,12,193 ,5 ,800 ,0 ,0 ,1 ,4 ,0 ,0 ,0 ,5 ,0 ,13 ,0 ,13,33094 , 0 
55561.596,9,193 ,5 ,800 ,0 ,0 ,8 ,5 ,1 ,5 ,1 ,20 ,0 ,22 ,2 ,24,49577 , 0 
55561.603,5,193 ,13 ,512 ,0 ,0 ,6 ,2 ,21 ,3 ,4 ,36 ,0 ,11 ,29 ,40,50719 , 0 
55561.606,19,193 ,1 ,256 ,0 ,0 ,1 ,0 ,0 ,0 ,0 ,1 ,0 ,8 ,0 ,8,32517 , 0 
55561.697,17,193 ,16 ,1109 ,0 ,0 ,4 ,6 ,0 ,0 ,0 ,10 ,0 ,14 ,0 ,14,37879 , 0 
55561.772,13,193 ,1 ,256 ,0 ,0 ,3 ,0 ,23 ,0 ,2 ,28 ,0 ,6 ,28 ,34,28858 , 0 
55561.787,3,193 ,1 ,256 ,0 ,0 ,1 ,0 ,0 ,0 ,0 ,1 ,0 ,1 ,0 ,1,20390 , 0 
55680.96,8,193 ,1 ,256 ,0 ,0 ,1 ,1 ,1 ,0 ,0 ,3 ,0 ,5 ,1 ,6,22890 , 0 
55681.078,11,193 ,5 ,779 ,0 ,0 ,2 ,0 ,2 ,0 ,0 ,4 ,0 ,5 ,2 ,7,35929 , 0 
55681.123,2,193 ,1 ,256 ,0 ,0 ,2 ,1 ,3 ,0 ,0 ,6 ,0 ,6 ,3 ,9,41416 , 0 
55681.138,6,193 ,2 ,503 ,0 ,0 ,1 ,0 ,0 ,0 ,0 ,1 ,0 ,6 ,0 ,6,57112 , 0 
55681.214,18,193 ,19 ,527 ,0 ,0 ,0 ,1 ,0 ,0 ,0 ,1 ,0 ,4 ,0 ,4,29257 , 0 
55681.236,4,193 ,8 ,513 ,0 ,0 ,1 ,1 ,0 ,0 ,0 ,2 ,0 ,2 ,0 ,2,26479 , 0 
55681.289,7,193 ,16 ,1065 ,0 ,0 ,2 ,1 ,0 ,0 ,0 ,3 ,0 ,6 ,0 ,6,41509 , 0 
55681.337,14,193 ,1 ,256 ,0 ,0 ,1 ,1 ,0 ,0 ,0 ,2 ,0 ,5 ,0 ,5,26181 , 0 
55681.35,15,193 ,11 ,1219 ,0 ,0 ,3 ,2 ,0 ,0 ,0 ,5 ,0 ,4 ,0 ,4,32088 , 0 
55681.36,20,193 ,5 ,779 ,0 ,0 ,2 ,0 ,0 ,0 ,0 ,2 ,0 ,3 ,0 ,3,27834 , 0 
55681.36,16,193 ,2 ,503 ,0 ,0 ,2 ,1 ,2 ,0 ,0 ,5 ,0 ,4 ,2 ,6,59387 , 0 
55681.444,10,193 ,14 ,512 ,0 ,0 ,2 ,0 ,0 ,0 ,0 ,2 ,0 ,1 ,0 ,1,29747 , 0 
55681.482,12,193 ,5 ,779 ,0 ,0 ,1 ,0 ,0 ,0 ,0 ,1 ,0 ,4 ,0 ,4,30558 , 0 
55681.596,9,193 ,5 ,779 ,0 ,0 ,2 ,0 ,0 ,0 ,0 ,2 ,0 ,7 ,0 ,7,51762 , 0 
55681.603,5,193 ,13 ,512 ,0 ,0 ,2 ,0 ,2 ,0 ,0 ,4 ,0 ,6 ,2 ,8,49305 , 0 
55681.606,19,193 ,1 ,256 ,0 ,0 ,3 ,1 ,1 ,0 ,0 ,5 ,0 ,6 ,1 ,7,31683 , 0 
55681.697,17,193 ,16 ,1065 ,0 ,0 ,2 ,1 ,0 ,0 ,0 ,3 ,0 ,4 ,0 ,4,38601 , 0 
55681.771,13,193 ,1 ,256 ,0 ,0 ,1 ,1 ,2 ,0 ,0 ,4 ,0 ,4 ,2 ,6,28135 , 0 
55681.787,3,193 ,1 ,256 ,0 ,0 ,2 ,1 ,0 ,0 ,0 ,3 ,0 ,2 ,0 ,2,19778 , 0 
55800.96,8,193 ,1 ,256 ,0 ,0 ,2 ,0 ,0 ,0 ,0 ,2 ,0 ,0 ,0 ,0,23415 , 0 
55801.078,11,193 ,5 ,779 ,0 ,0 ,1 ,1 ,1 ,0 ,0 ,3 ,0 ,4 ,1 ,5,38126 , 0 
55801.123,2,193 ,1 ,256 ,0 ,0 ,1 ,0 ,2 ,0 ,0 ,3 ,0 ,2 ,2 ,4,39628 , 0 
55801.138,6,193 ,2 ,503 ,0 ,0 ,1 ,1 ,0 ,0 ,0 ,2 ,0 ,2 ,0 ,2,49327 , 0 
55801.214,18,193 ,19 ,527 ,0 ,0 ,1 ,0 ,0 ,0 ,0 ,1 ,0 ,2 ,0 ,2,31512 , 0 
55801.236,4,193 ,8 ,513 ,0 ,0 ,1 ,0 ,0 ,0 ,0 ,1 ,0 ,2 ,0 ,2,27933 , 0 
55801.289,7,193 ,16 ,981 ,0 ,0 ,2 ,1 ,0 ,0 ,0 ,3 ,0 ,4 ,0 ,4,41638 , 0 
55801.337,14,193 ,1 ,256 ,0 ,0 ,1 ,0 ,0 ,0 ,0 ,1 ,0 ,2 ,0 ,2,26751 , 0 
55801.35,15,193 ,11 ,1166 ,0 ,0 ,2 ,1 ,0 ,0 ,0 ,3 ,0 ,2 ,0 ,2,33929 , 0 
55801.36,20,193 ,5 ,779 ,0 ,0 ,1 ,1 ,0 ,0 ,0 ,2 ,0 ,1 ,0 ,1,30258 , 0 
55801.36,16,193 ,2 ,503 ,0 ,0 ,2 ,0 ,1 ,0 ,0 ,3 ,0 ,4 ,1 ,5,55089 , 0 
55801.444,10,193 ,14 ,512 ,0 ,0 ,1 ,0 ,0 ,0 ,0 ,1 ,0 ,0 ,0 ,0,29144 , 0 
55801.482,12,193 ,5 ,779 ,0 ,0 ,2 ,1 ,0 ,0 ,0 ,3 ,0 ,1 ,0 ,1,33161 , 0 
55801.596,9,193 ,5 ,779 ,0 ,0 ,2 ,1 ,0 ,0 ,0 ,3 ,0 ,2 ,0 ,2,49679 , 0 
55801.603,5,193 ,13 ,512 ,0 ,0 ,1 ,1 ,5 ,0 ,0 ,7 ,0 ,2 ,5 ,7,50843 , 0 
55801.606,19,193 ,1 ,256 ,0 ,0 ,1 ,0 ,0 ,0 ,0 ,1 ,0 ,2 ,0 ,2,32592 , 0 
55801.697,17,193 ,16 ,1065 ,0 ,0 ,2 ,0 ,0 ,0 ,0 ,2 ,0 ,1 ,0 ,1,37948 , 0 
55801.771,13,193 ,1 ,256 ,0 ,0 ,1 ,0 ,6 ,0 ,0 ,7 ,0 ,0 ,6 ,6,28929 , 0 
55801.787,3,193 ,1 ,256 ,0 ,0 ,0 ,0 ,0 ,0 ,0 ,0 ,0 ,0 ,0 ,0,20441 , 0 
55920.96,8,193 ,1 ,256 ,0 ,0 ,1 ,0 ,1 ,0 ,0 ,2 ,0 ,2 ,1 ,3,22957 , 0 
55921.078,11,193 ,5 ,794 ,0 ,0 ,2 ,1 ,0 ,0 ,0 ,3 ,0 ,5 ,0 ,5,36020 , 0 
55921.125,2,193 ,1 ,256 ,0 ,0 ,26 ,0 ,74 ,0 ,0 ,100 ,107 ,21 ,74 ,202,41804 , 0 
55921.214,18,193 ,19 ,527 ,0 ,0 ,0 ,0 ,0 ,0 ,0 ,0 ,0 ,2 ,0 ,2,29361 , 0 
55921.236,4,193 ,8 ,512 ,0 ,0 ,2 ,1 ,0 ,0 ,0 ,3 ,0 ,1 ,0 ,1,26558 , 0 
55921.27,6,193 ,2 ,512 ,0 ,120 ,2 ,15 ,0 ,0 ,0 ,137 ,0 ,79 ,0 ,79,58059 , 1 
55921.29,7,193 ,16 ,776 ,0 ,0 ,1 ,16 ,0 ,0 ,0 ,17 ,0 ,40 ,0 ,40,41790 , 0 
55921.338,14,193 ,1 ,256 ,0 ,0 ,1 ,0 ,0 ,0 ,0 ,1 ,0 ,38 ,0 ,38,26344 , 0 
55921.35,15,193 ,11 ,1196 ,0 ,0 ,1 ,0 ,0 ,0 ,0 ,1 ,0 ,5 ,0 ,5,32196 , 0 
55921.36,20,193 ,5 ,794 ,0 ,0 ,1 ,1 ,0 ,0 ,0 ,2 ,0 ,3 ,0 ,3,27921 , 0 
55921.445,10,193 ,14 ,512 ,0 ,0 ,25 ,0 ,0 ,0 ,0 ,25 ,105 ,1 ,0 ,106,30026 , 0 
55921.482,12,193 ,5 ,794 ,0 ,0 ,1 ,1 ,0 ,0 ,0 ,2 ,0 ,3 ,0 ,3,30678 , 0 
55921.495,16,193 ,2 ,512 ,0 ,0 ,25 ,16 ,44 ,0 ,0 ,85 ,104 ,40 ,44 ,188,60184 , 0 
55921.596,9,193 ,16 ,776 ,0 ,0 ,4 ,8 ,0 ,1 ,0 ,13 ,0 ,25 ,0 ,25,52038 , 0 
55921.603,5,193 ,13 ,512 ,0 ,0 ,2 ,0 ,4 ,0 ,1 ,7 ,0 ,23 ,5 ,28,49502 , 0 
55921.607,19,193 ,1 ,256 ,0 ,0 ,1 ,0 ,0 ,0 ,0 ,1 ,0 ,26 ,0 ,26,31803 , 0 
55921.697,17,193 ,16 ,776 ,0 ,0 ,25 ,21 ,0 ,0 ,0 ,46 ,102 ,24 ,0 ,126,39046 , 0 
55921.771,13,193 ,1 ,256 ,0 ,0 ,1 ,0 ,4 ,0 ,1 ,6 ,0 ,21 ,5 ,26,28294 , 0 
55921.787,3,193 ,1 ,256 ,0 ,0 ,2 ,0 ,0 ,0 ,0 ,2 ,0 ,1 ,0 ,1,19879 , 0 
56040.96,8,193 ,1 ,256 ,0 ,0 ,1 ,0 ,0 ,0 ,0 ,1 ,0 ,1 ,0 ,1,23508 , 0 
56041.078,11,193 ,5 ,794 ,0 ,0 ,1 ,0 ,1 ,0 ,0 ,2 ,0 ,2 ,1 ,3,38205 , 0 
56041.125,2,193 ,1 ,256 ,0 ,0 ,26 ,0 ,79 ,0 ,0 ,105 ,107 ,21 ,79 ,207,40032 , 0 
56041.14,6,193 ,2 ,512 ,0 ,120 ,1 ,17 ,0 ,0 ,0 ,138 ,0 ,81 ,0 ,81,50203 , 1 
56041.214,18,193 ,19 ,527 ,0 ,0 ,0 ,0 ,0 ,0 ,0 ,0 ,0 ,2 ,0 ,2,31625 , 0 
56041.236,4,193 ,8 ,512 ,0 ,0 ,0 ,0 ,0 ,0 ,0 ,0 ,0 ,0 ,0 ,0,28000 , 0 
56041.29,7,193 ,16 ,783 ,0 ,0 ,2 ,15 ,0 ,0 ,0 ,17 ,0 ,48 ,0 ,48,41928 , 0 
56041.338,14,193 ,1 ,256 ,0 ,0 ,2 ,0 ,0 ,0 ,0 ,2 ,0 ,42 ,0 ,42,26849 , 0 
56041.35,15,193 ,11 ,1194 ,0 ,0 ,2 ,1 ,0 ,0 ,0 ,3 ,0 ,4 ,0 ,4,34052 , 0 
56041.36,20,193 ,5 ,794 ,0 ,0 ,2 ,0 ,0 ,0 ,0 ,2 ,0 ,0 ,0 ,0,30368 , 0 
56041.361,16,193 ,2 ,512 ,0 ,0 ,25 ,14 ,48 ,0 ,0 ,87 ,108 ,36 ,48 ,192,55929 , 0 
56041.445,10,193 ,14 ,512 ,0 ,0 ,27 ,0 ,0 ,0 ,0 ,27 ,109 ,0 ,0 ,109,29413 , 0 
56041.482,12,193 ,5 ,794 ,0 ,0 ,1 ,0 ,0 ,0 ,0 ,1 ,0 ,1 ,0 ,1,33267 , 0 
56041.601,9,193 ,16 ,783 ,0 ,0 ,2 ,16 ,0 ,0 ,0 ,18 ,0 ,23 ,0 ,23,49978 , 0 
56041.603,5,193 ,13 ,512 ,0 ,0 ,1 ,0 ,1 ,1 ,0 ,3 ,0 ,23 ,1 ,24,50969 , 0 
56041.607,19,193 ,1 ,256 ,0 ,0 ,1 ,0 ,0 ,0 ,0 ,1 ,0 ,24 ,0 ,24,32695 , 0 
56041.697,17,193 ,16 ,783 ,0 ,0 ,26 ,18 ,0 ,0 ,0 ,44 ,108 ,24 ,0 ,132,38384 , 0 
56041.771,13,193 ,1 ,256 ,0 ,0 ,1 ,0 ,1 ,1 ,0 ,3 ,0 ,20 ,2 ,22,29093 , 0 
56041.787,3,193 ,1 ,256 ,0 ,0 ,1 ,0 ,0 ,0 ,0 ,1 ,0 ,1 ,0 ,1,20525 , 0 
56160.96,8,193 ,1 ,256 ,0 ,0 ,1 ,0 ,0 ,0 ,0 ,1 ,0 ,0 ,0 ,0,23015 , 0 
56161.078,11,193 ,5 ,794 ,0 ,0 ,2 ,0 ,0 ,0 ,0 ,2 ,0 ,4 ,0 ,4,36150 , 0 
56161.125,2,193 ,1 ,256 ,0 ,0 ,25 ,0 ,78 ,0 ,0 ,103 ,107 ,20 ,78 ,205,42202 , 0 
56161.214,18,193 ,19 ,527 ,0 ,0 ,0 ,0 ,0 ,0 ,0 ,0 ,0 ,2 ,0 ,2,29422 , 0 
56161.236,4,193 ,8 ,512 ,0 ,0 ,2 ,0 ,0 ,0 ,0 ,2 ,0 ,0 ,0 ,0,26644 , 0 
56161.276,6,193 ,2 ,512 ,0 ,120 ,0 ,14 ,0 ,0 ,0 ,134 ,0 ,81 ,0 ,81,58989 , 1 
56161.29,7,193 ,16 ,778 ,0 ,0 ,1 ,17 ,0 ,0 ,0 ,18 ,0 ,42 ,0 ,42,42074 , 0 
56161.338,14,193 ,1 ,256 ,0 ,0 ,1 ,0 ,0 ,0 ,0 ,1 ,0 ,35 ,0 ,35,26446 , 0 
56161.35,15,193 ,11 ,1194 ,0 ,0 ,1 ,0 ,0 ,0 ,0 ,1 ,0 ,1 ,0 ,1,32299 , 0 
56161.36,20,193 ,5 ,794 ,0 ,0 ,1 ,0 ,0 ,0 ,0 ,1 ,0 ,2 ,0 ,2,27996 , 0 
56161.362,16,193 ,2 ,512 ,0 ,0 ,25 ,16 ,47 ,0 ,0 ,88 ,105 ,38 ,47 ,190,61009 , 0 
56161.445,10,193 ,14 ,512 ,0 ,0 ,25 ,0 ,0 ,0 ,0 ,25 ,103 ,0 ,0 ,103,30287 , 0 
56161.482,12,193 ,5 ,794 ,0 ,0 ,2 ,0 ,0 ,0 ,0 ,2 ,0 ,0 ,0 ,0,30753 , 0 
56161.596,9,193 ,16 ,778 ,0 ,0 ,2 ,14 ,0 ,0 ,0 ,16 ,0 ,25 ,0 ,25,52353 , 0 
56161.603,5,193 ,13 ,557 ,0 ,0 ,1 ,0 ,0 ,0 ,0 ,1 ,0 ,20 ,0 ,20,49655 , 0 
56161.607,19,193 ,1 ,256 ,0 ,0 ,1 ,0 ,0 ,0 ,0 ,1 ,0 ,22 ,0 ,22,31935 , 0 
56161.697,17,193 ,16 ,778 ,0 ,0 ,26 ,15 ,0 ,0 ,0 ,41 ,106 ,23 ,0 ,129,39475 , 0 
56161.771,13,193 ,1 ,256 ,0 ,0 ,1 ,0 ,0 ,0 ,0 ,1 ,0 ,22 ,0 ,22,28421 , 0 
56161.787,3,193 ,1 ,256 ,0 ,0 ,1 ,0 ,0 ,0 ,0 ,1 ,0 ,1 ,0 ,1,19930 , 0 
56280.96,8,193 ,1 ,256 ,0 ,0 ,0 ,0 ,0 ,0 ,0 ,0 ,0 ,1 ,0 ,1,23569 , 0 
56281.078,11,193 ,5 ,794 ,0 ,0 ,1 ,0 ,0 ,0 ,0 ,1 ,0 ,2 ,0 ,2,38274 , 0 
56281.124,2,193 ,1 ,256 ,0 ,0 ,6 ,0 ,22 ,0 ,0 ,28 ,1 ,5 ,22 ,28,40168 , 0 
56281.138,6,193 ,2 ,512 ,0 ,0 ,1 ,5 ,0 ,0 ,0 ,6 ,0 ,19 ,0 ,19,50301 , 0 
56281.214,18,193 ,19 ,527 ,0 ,0 ,1 ,0 ,0 ,0 ,0 ,1 ,0 ,0 ,0 ,0,31689 , 0 
56281.236,4,193 ,8 ,512 ,0 ,0 ,1 ,0 ,0 ,0 ,0 ,1 ,0 ,1 ,0 ,1,28084 , 0 
56281.289,7,193 ,16 ,787 ,0 ,0 ,0 ,4 ,0 ,0 ,0 ,4 ,0 ,12 ,0 ,12,42004 , 0 
56281.337,14,193 ,1 ,256 ,0 ,0 ,1 ,0 ,0 ,0 ,0 ,1 ,0 ,9 ,0 ,9,26922 , 0 
56281.35,15,193 ,11 ,1194 ,0 ,0 ,2 ,0 ,0 ,0 ,0 ,2 ,0 ,0 ,0 ,0,34119 , 0 
56281.36,20,193 ,5 ,794 ,0 ,0 ,1 ,0 ,0 ,0 ,0 ,1 ,0 ,0 ,0 ,0,30434 , 0 
56281.361,16,193 ,2 ,512 ,0 ,0 ,7 ,5 ,12 ,0 ,0 ,24 ,0 ,8 ,12 ,20,56167 , 0 
56281.444,10,193 ,14 ,512 ,0 ,0 ,6 ,0 ,0 ,0 ,0 ,6 ,0 ,0 ,0 ,0,29505 , 0 
56281.482,12,193 ,5 ,794 ,0 ,0 ,1 ,0 ,0 ,0 ,0 ,1 ,0 ,2 ,0 ,2,33355 , 0 
56281.596,9,193 ,16 ,787 ,0 ,0 ,1 ,4 ,0 ,0 ,0 ,5 ,0 ,7 ,0 ,7,50078 , 0 
56281.603,5,193 ,13 ,557 ,0 ,0 ,1 ,0 ,0 ,0 ,0 ,1 ,0 ,6 ,0 ,6,51061 , 0 
56281.606,19,193 ,1 ,256 ,0 ,0 ,0 ,0 ,0 ,0 ,0 ,0 ,0 ,6 ,0 ,6,32772 , 0 
56281.697,17,193 ,16 ,787 ,0 ,0 ,5 ,4 ,0 ,0 ,0 ,9 ,0 ,6 ,0 ,6,38494 , 0 
56281.771,13,193 ,1 ,256 ,0 ,0 ,1 ,0 ,0 ,0 ,0 ,1 ,0 ,6 ,0 ,6,29175 , 0 
56281.787,3,193 ,1 ,256 ,0 ,0 ,0 ,0 ,0 ,0 ,0 ,0 ,0 ,0 ,0 ,0,20576 , 0 
56400.96,8,193 ,1 ,256 ,0 ,0 ,2 ,0 ,0 ,0 ,0 ,2 ,0 ,0 ,0 ,0,23086 , 0 
56401.078,11,193 ,5 ,794 ,0 ,0 ,2 ,0 ,1 ,0 ,0 ,3 ,0 ,2 ,1 ,3,36218 , 0 
56401.123,2,193 ,1 ,256 ,0 ,0 ,1 ,0 ,7 ,0 ,0 ,8 ,0 ,2 ,7 ,9,42282 , 0 
56401.138,6,193 ,2 ,512 ,0 ,0 ,1 ,0 ,0 ,0 ,0 ,1 ,0 ,4 ,0 ,4,59067 , 0 
56401.214,18,193 ,19 ,527 ,0 ,0 ,1 ,0 ,0 ,0 ,0 ,1 ,0 ,3 ,0 ,3,29502 , 0 
56401.236,4,193 ,8 ,512 ,0 ,0 ,2 ,0 ,0 ,0 ,0 ,2 ,0 ,1 ,0 ,1,26708 , 0 
56401.289,7,193 ,16 ,776 ,0 ,0 ,2 ,2 ,0 ,0 ,0 ,4 ,0 ,3 ,0 ,3,42156 , 0 
56401.337,14,193 ,1 ,256 ,0 ,0 ,1 ,0 ,0 ,0 ,0 ,1 ,0 ,3 ,0 ,3,26510 , 0 
56401.35,15,193 ,11 ,1154 ,0 ,0 ,1 ,1 ,0 ,0 ,0 ,2 ,0 ,5 ,0 ,5,32380 , 0 
56401.36,20,193 ,5 ,794 ,0 ,0 ,1 ,0 ,0 ,0 ,0 ,1 ,0 ,1 ,0 ,1,28052 , 0 
56401.36,16,193 ,2 ,512 ,0 ,0 ,2 ,1 ,6 ,0 ,0 ,9 ,0 ,4 ,6 ,10,61144 , 0 
56401.444,10,193 ,14 ,512 ,0 ,0 ,3 ,0 ,0 ,0 ,0 ,3 ,0 ,0 ,0 ,0,30349 , 0 
56401.482,12,193 ,5 ,794 ,0 ,0 ,1 ,0 ,0 ,0 ,0 ,1 ,0 ,2 ,0 ,2,30827 , 0 
56401.596,9,193 ,16 ,776 ,0 ,0 ,2 ,2 ,0 ,0 ,0 ,4 ,0 ,3 ,0 ,3,52465 , 0 
56401.603,5,193 ,13 ,557 ,0 ,0 ,2 ,0 ,1 ,0 ,0 ,3 ,0 ,4 ,1 ,5,49745 , 0 
56401.606,19,193 ,1 ,256 ,0 ,0 ,1 ,0 ,0 ,0 ,0 ,1 ,0 ,3 ,0 ,3,32016 , 0 
56401.696,17,193 ,16 ,776 ,0 ,0 ,1 ,2 ,0 ,0 ,0 ,3 ,0 ,3 ,0 ,3,39584 , 0 
56401.771,13,193 ,1 ,256 ,0 ,0 ,1 ,0 ,1 ,0 ,0 ,2 ,0 ,1 ,1 ,2,28486 , 0 
56401.787,3,193 ,1 ,256 ,0 ,0 ,1 ,0 ,0 ,0 ,0 ,1 ,0 ,1 ,0 ,1,20006 , 0 
56520.96,8,193 ,1 ,256 ,0 ,0 ,1 ,0 ,0 ,0 ,0 ,1 ,0 ,2 ,0 ,2,23625 , 0 
56521.078,11,193 ,5 ,794 ,0 ,0 ,1 ,0 ,0 ,0 ,0 ,1 ,0 ,2 ,0 ,2,38349 , 0 
56521.123,2,193 ,1 ,256 ,0 ,0 ,2 ,0 ,1 ,0 ,0 ,3 ,0 ,0 ,1 ,1,40244 , 0 
56521.138,6,193 ,2 ,512 ,0 ,0 ,2 ,1 ,0 ,0 ,0 ,3 ,0 ,3 ,0 ,3,50394 , 0 
56521.214,18,193 ,19 ,527 ,0 ,0 ,0 ,0 ,0 ,0 ,0 ,0 ,0 ,0 ,0 ,0,31748 , 0 
56521.236,4,193 ,8 ,512 ,0 ,0 ,0 ,0 ,0 ,0 ,0 ,0 ,0 ,0 ,0 ,0,28133 , 0 
56521.289,7,193 ,16 ,776 ,0 ,0 ,1 ,0 ,0 ,0 ,0 ,1 ,0 ,2 ,0 ,2,42094 , 0 
56521.337,14,193 ,1 ,256 ,0 ,0 ,0 ,0 ,0 ,0 ,0 ,0 ,0 ,2 ,0 ,2,26977 , 0 
56521.35,15,193 ,11 ,1154 ,0 ,0 ,1 ,0 ,0 ,0 ,0 ,1 ,0 ,1 ,0 ,1,34200 , 0 
56521.36,20,193 ,5 ,794 ,0 ,0 ,2 ,0 ,0 ,0 ,0 ,2 ,0 ,2 ,0 ,2,30530 , 0 
56521.36,16,193 ,2 ,512 ,0 ,0 ,1 ,0 ,0 ,0 ,0 ,1 ,0 ,1 ,0 ,1,56254 , 0 
56521.444,10,193 ,14 ,512 ,0 ,0 ,0 ,0 ,0 ,0 ,0 ,0 ,0 ,1 ,0 ,1,29555 , 0 
56521.482,12,193 ,5 ,794 ,0 ,0 ,1 ,0 ,0 ,0 ,0 ,1 ,0 ,1 ,0 ,1,33428 , 0 
56521.596,9,193 ,16 ,776 ,0 ,0 ,1 ,0 ,0 ,0 ,0 ,1 ,0 ,1 ,0 ,1,50151 , 0 
56521.603,5,193 ,13 ,540 ,0 ,0 ,0 ,0 ,0 ,0 ,0 ,0 ,0 ,3 ,0 ,3,51152 , 0 
56521.606,19,193 ,1 ,256 ,0 ,0 ,1 ,0 ,0 ,0 ,0 ,1 ,0 ,2 ,0 ,2,32848 , 0 
56521.696,17,193 ,16 ,776 ,0 ,0 ,1 ,0 ,0 ,0 ,0 ,1 ,0 ,1 ,0 ,1,38561 , 0 
56521.771,13,193 ,1 ,256 ,0 ,0 ,1 ,0 ,0 ,0 ,0 ,1 ,0 ,1 ,0 ,1,29243 , 0 
56521.787,3,193 ,1 ,256 ,0 ,0 ,2 ,0 ,0 ,0 ,0 ,2 ,0 ,0 ,0 ,0,20633 , 0 
56640.96,8,193 ,1 ,256 ,0 ,0 ,2 ,0 ,0 ,0 ,0 ,2 ,0 ,1 ,0 ,1,23162 , 0 
56641.078,11,193 ,5 ,822 ,0 ,0 ,5 ,2 ,1 ,0 ,0 ,8 ,0 ,12 ,1 ,13,36331 , 0 
56641.124,2,193 ,1 ,256 ,0 ,0 ,7 ,0 ,18 ,1 ,3 ,29 ,0 ,13 ,22 ,35,42441 , 0 
56641.138,6,193 ,2 ,512 ,0 ,0 ,7 ,5 ,9 ,0 ,0 ,21 ,0 ,15 ,9 ,24,59307 , 0 
56641.214,18,193 ,19 ,527 ,0 ,0 ,0 ,0 ,0 ,0 ,0 ,0 ,0 ,4 ,0 ,4,29558 , 0 
56641.236,4,193 ,8 ,512 ,0 ,0 ,2 ,0 ,0 ,0 ,0 ,2 ,0 ,2 ,0 ,2,26796 , 0 
56641.29,7,193 ,17 ,1128 ,0 ,0 ,8 ,4 ,0 ,1 ,0 ,13 ,0 ,24 ,0 ,24,42314 , 0 
56641.337,14,193 ,1 ,256 ,0 ,0 ,1 ,0 ,0 ,0 ,0 ,1 ,0 ,5 ,0 ,5,26600 , 0 
56641.35,15,193 ,11 ,1156 ,0 ,0 ,5 ,1 ,0 ,0 ,0 ,6 ,0 ,14 ,0 ,14,32472 , 0 
56641.36,20,193 ,5 ,822 ,0 ,0 ,1 ,2 ,0 ,0 ,0 ,3 ,0 ,6 ,0 ,6,28140 , 0 
56641.361,16,193 ,2 ,512 ,0 ,0 ,5 ,4 ,0 ,1 ,3 ,13 ,0 ,29 ,3 ,32,61314 , 1 
56641.444,10,193 ,14 ,512 ,0 ,0 ,1 ,0 ,0 ,0 ,0 ,1 ,0 ,6 ,0 ,6,30427 , 0 
56641.482,12,193 ,5 ,822 ,0 ,0 ,0 ,2 ,0 ,0 ,0 ,2 ,0 ,4 ,0 ,4,30895 , 0 
56641.596,9,193 ,5 ,822 ,0 ,0 ,8 ,2 ,0 ,1 ,0 ,11 ,0 ,21 ,0 ,21,52628 , 0 
56641.606,19,193 ,1 ,256 ,0 ,0 ,1 ,0 ,0 ,0 ,0 ,1 ,0 ,8 ,0 ,8,32095 , 0 
56641.697,17,193 ,6 ,832 ,0 ,0 ,9 ,5 ,4 ,1 ,0 ,19 ,0 ,16 ,4 ,20,39779 , 0 
56641.749,5,193 ,13 ,540 ,0 ,0 ,5 ,0 ,9 ,0 ,0 ,14 ,0 ,12 ,9 ,21,49890 , 0 
56641.771,13,193 ,1 ,256 ,0 ,0 ,1 ,0 ,8 ,0 ,0 ,9 ,0 ,9 ,8 ,17,28586 , 0 
56641.787,3,193 ,1 ,256 ,0 ,0 ,1 ,0 ,0 ,0 ,0 ,1 ,0 ,2 ,0 ,2,20063 , 0 
56760.96,8,193 ,1 ,256 ,0 ,0 ,1 ,0 ,0 ,0 ,0 ,1 ,0 ,1 ,0 ,1,23691 , 0 
56761.078,11,193 ,5 ,827 ,0 ,0 ,2 ,2 ,2 ,0 ,0 ,6 ,0 ,14 ,2 ,16,38467 , 0 
56761.124,2,193 ,1 ,256 ,0 ,0 ,6 ,0 ,20 ,0 ,0 ,26 ,0 ,9 ,22 ,31,40398 , 0 
56761.139,6,193 ,2 ,512 ,0 ,0 ,8 ,4 ,13 ,0 ,0 ,25 ,0 ,13 ,13 ,26,50644 , 0 
56761.214,18,193 ,19 ,527 ,0 ,0 ,0 ,0 ,1 ,0 ,0 ,1 ,0 ,6 ,1 ,7,31826 , 0 
56761.236,4,193 ,8 ,512 ,0 ,0 ,1 ,0 ,0 ,0 ,0 ,1 ,0 ,0 ,0 ,0,28243 , 0 
56761.29,7,193 ,17 ,1072 ,0 ,0 ,7 ,7 ,0 ,0 ,0 ,14 ,0 ,15 ,0 ,15,42252 , 0 
56761.337,14,193 ,1 ,256 ,0 ,0 ,1 ,0 ,0 ,0 ,0 ,1 ,0 ,7 ,0 ,7,27062 , 0 
56761.35,15,193 ,11 ,1134 ,0 ,0 ,1 ,2 ,0 ,0 ,0 ,3 ,0 ,13 ,0 ,13,34294 , 0 
56761.36,20,193 ,5 ,827 ,0 ,0 ,1 ,2 ,0 ,0 ,0 ,3 ,0 ,7 ,0 ,7,30633 , 0 
56761.36,16,193 ,2 ,512 ,0 ,0 ,2 ,3 ,0 ,2 ,0 ,7 ,0 ,24 ,0 ,24,56392 , 1 
56761.444,10,193 ,14 ,512 ,0 ,0 ,2 ,0 ,0 ,0 ,0 ,2 ,0 ,8 ,0 ,8,29622 , 0 
56761.482,12,193 ,18 ,875 ,0 ,0 ,6 ,1 ,0 ,1 ,0 ,8 ,0 ,3 ,0 ,3,33597 , 0 
56761.596,9,193 ,5 ,827 ,0 ,0 ,8 ,2 ,0 ,0 ,0 ,10 ,0 ,8 ,0 ,8,50304 , 0 
56761.603,5,193 ,13 ,540 ,0 ,0 ,2 ,0 ,5 ,1 ,1 ,9 ,0 ,14 ,6 ,20,51280 , 0 
56761.606,19,193 ,1 ,256 ,0 ,0 ,1 ,0 ,1 ,0 ,0 ,2 ,0 ,7 ,1 ,8,32954 , 0 
56761.697,17,193 ,6 ,802 ,0 ,0 ,8 ,6 ,7 ,0 ,0 ,21 ,0 ,11 ,7 ,18,38748 , 0 
56761.771,13,193 ,1 ,256 ,0 ,0 ,1 ,0 ,6 ,1 ,1 ,9 ,0 ,5 ,8 ,13,29342 , 0 
56761.787,3,193 ,1 ,256 ,0 ,0 ,2 ,0 ,0 ,0 ,0 ,2 ,0 ,1 ,0 ,1,20697 , 0 
56880.96,8,193 ,1 ,256 ,0 ,0 ,1 ,0 ,0 ,0 ,0 ,1 ,0 ,3 ,0 ,3,23239 , 0 
56881.078,11,193 ,5 ,832 ,0 ,0 ,2 ,1 ,1 ,0 ,0 ,4 ,0 ,8 ,1 ,9,36409 , 0 
56881.124,2,193 ,1 ,256 ,0 ,0 ,5 ,0 ,17 ,0 ,0 ,22 ,0 ,8 ,17 ,25,42571 , 0 
56881.138,6,193 ,2 ,512 ,0 ,0 ,5 ,4 ,11 ,0 ,0 ,20 ,0 ,13 ,11 ,24,59534 , 0 
56881.214,18,193 ,19 ,527 ,0 ,0 ,0 ,0 ,0 ,0 ,0 ,0 ,0 ,3 ,0 ,3,29636 , 0 
56881.236,4,193 ,8 ,512 ,0 ,0 ,2 ,0 ,0 ,0 ,0 ,2 ,0 ,0 ,0 ,0,26861 , 0 
56881.29,7,193 ,17 ,1047 ,0 ,0 ,6 ,7 ,0 ,0 ,0 ,13 ,0 ,15 ,0 ,15,42475 , 0 
56881.337,14,193 ,1 ,256 ,0 ,0 ,1 ,0 ,0 ,0 ,0 ,1 ,0 ,4 ,0 ,4,26678 , 0 
56881.35,15,193 ,11 ,1123 ,0 ,0 ,3 ,1 ,0 ,0 ,0 ,4 ,0 ,11 ,0 ,11,32594 , 0 
56881.36,20,193 ,5 ,832 ,0 ,0 ,0 ,1 ,0 ,0 ,0 ,1 ,0 ,3 ,0 ,3,28215 , 0 
56881.36,16,193 ,2 ,512 ,0 ,0 ,2 ,2 ,0 ,0 ,0 ,4 ,0 ,26 ,0 ,26,61443 , 1 
56881.444,10,193 ,14 ,512 ,0 ,0 ,1 ,0 ,0 ,0 ,0 ,1 ,0 ,4 ,0 ,4,30506 , 0 
56881.482,12,193 ,18 ,875 ,0 ,0 ,1 ,0 ,0 ,0 ,0 ,1 ,0 ,0 ,0 ,0,30954 , 0 
56881.596,9,193 ,5 ,821 ,0 ,0 ,7 ,2 ,0 ,0 ,0 ,9 ,0 ,11 ,0 ,11,52776 , 0 
56881.603,5,193 ,13 ,540 ,0 ,0 ,3 ,0 ,5 ,0 ,0 ,8 ,0 ,8 ,5 ,13,50071 , 0 
56881.606,19,193 ,1 ,256 ,0 ,0 ,2 ,0 ,0 ,0 ,0 ,2 ,0 ,5 ,0 ,5,32186 , 0 
56881.697,17,193 ,6 ,781 ,0 ,0 ,7 ,4 ,7 ,0 ,0 ,18 ,0 ,12 ,7 ,19,39961 , 0 
56881.771,13,193 ,1 ,256 ,0 ,0 ,1 ,0 ,5 ,0 ,0 ,6 ,0 ,6 ,5 ,11,28708 , 0 
56881.787,3,193 ,1 ,256 ,0 ,0 ,1 ,0 ,0 ,0 ,0 ,1 ,0 ,0 ,0 ,0,20142 , 0 
57000.96,8,193 ,1 ,256 ,0 ,0 ,2 ,0 ,0 ,0 ,0 ,2 ,0 ,1 ,0 ,1,23756 , 0 
57001.078,11,193 ,5 ,844 ,0 ,0 ,1 ,1 ,0 ,0 ,0 ,2 ,0 ,4 ,0 ,4,38536 , 0 
57001.124,2,193 ,1 ,256 ,0 ,0 ,3 ,0 ,7 ,0 ,0 ,10 ,0 ,2 ,7 ,9,40486 , 0 
57001.138,6,193 ,2 ,512 ,0 ,0 ,3 ,2 ,4 ,0 ,0 ,9 ,0 ,3 ,4 ,7,50760 , 0 
57001.214,18,193 ,19 ,527 ,0 ,0 ,0 ,0 ,0 ,0 ,0 ,0 ,0 ,3 ,0 ,3,31882 , 0 
57001.236,4,193 ,8 ,512 ,0 ,0 ,2 ,0 ,0 ,0 ,0 ,2 ,0 ,0 ,0 ,0,28334 , 0 
57001.289,7,193 ,17 ,1033 ,0 ,0 ,2 ,1 ,0 ,0 ,0 ,3 ,0 ,3 ,0 ,3,42329 , 0 
57001.337,14,193 ,1 ,256 ,0 ,0 ,1 ,0 ,0 ,0 ,0 ,1 ,0 ,3 ,0 ,3,27118 , 0 
57001.35,15,193 ,11 ,1123 ,0 ,0 ,1 ,0 ,0 ,0 ,0 ,1 ,0 ,3 ,0 ,3,34348 , 0 
57001.36,20,193 ,5 ,844 ,0 ,0 ,1 ,1 ,0 ,0 ,0 ,2 ,0 ,3 ,0 ,3,30708 , 0 
57001.36,16,193 ,2 ,512 ,0 ,0 ,1 ,1 ,0 ,0 ,0 ,2 ,0 ,7 ,0 ,7,56469 , 0 
57001.444,10,193 ,14 ,512 ,0 ,0 ,1 ,0 ,0 ,0 ,0 ,1 ,0 ,1 ,0 ,1,29680 , 0 
57001.482,12,193 ,18 ,875 ,0 ,0 ,2 ,0 ,0 ,0 ,0 ,2 ,0 ,1 ,0 ,1,33674 , 0 
57001.596,9,193 ,5 ,844 ,0 ,0 ,2 ,0 ,0 ,0 ,0 ,2 ,0 ,3 ,0 ,3,50379 , 0 
57001.603,5,193 ,13 ,540 ,0 ,0 ,1 ,0 ,2 ,0 ,0 ,3 ,0 ,6 ,2 ,8,51363 , 0 
57001.606,19,193 ,1 ,256 ,0 ,0 ,1 ,0 ,0 ,0 ,0 ,1 ,0 ,5 ,0 ,5,33036 , 0 
57001.696,17,193 ,6 ,774 ,0 ,0 ,2 ,3 ,1 ,0 ,0 ,6 ,0 ,4 ,1 ,5,38825 , 0 
57001.771,13,193 ,1 ,256 ,0 ,0 ,0 ,0 ,2 ,0 ,0 ,2 ,0 ,5 ,2 ,7,29415 , 0 
57001.787,3,193 ,1 ,256 ,0 ,0 ,0 ,0 ,0 ,0 ,0 ,0 ,0 ,1 ,0 ,1,20746 , 0 
57120.96,8,193 ,1 ,256 ,0 ,0 ,1 ,0 ,0 ,0 ,0 ,1 ,0 ,1 ,0 ,1,23304 , 0 
57121.078,11,193 ,5 ,844 ,0 ,0 ,2 ,0 ,1 ,0 ,0 ,3 ,0 ,8 ,1 ,9,36535 , 0 
57121.124,2,193 ,1 ,256 ,0 ,0 ,2 ,0 ,5 ,0 ,1 ,8 ,0 ,4 ,7 ,11,42730 , 0 
57121.138,6,193 ,2 ,512 ,0 ,0 ,2 ,1 ,0 ,1 ,1 ,5 ,0 ,4 ,2 ,6,59686 , 0 
57121.214,18,193 ,19 ,527 ,0 ,0 ,0 ,0 ,0 ,0 ,0 ,0 ,0 ,1 ,0 ,1,29719 , 0 
57121.236,4,193 ,8 ,512 ,0 ,0 ,2 ,0 ,0 ,0 ,0 ,2 ,0 ,0 ,0 ,0,26974 , 0 
57121.289,7,193 ,16 ,775 ,0 ,0 ,4 ,1 ,0 ,1 ,0 ,6 ,0 ,10 ,0 ,10,42576 , 0 
57121.337,14,193 ,1 ,256 ,0 ,0 ,1 ,0 ,0 ,0 ,0 ,1 ,0 ,5 ,0 ,5,26765 , 0 
57121.35,15,193 ,11 ,1128 ,0 ,0 ,2 ,1 ,0 ,0 ,0 ,3 ,0 ,9 ,0 ,9,32679 , 0 
57121.36,20,193 ,5 ,844 ,0 ,0 ,2 ,0 ,0 ,0 ,0 ,2 ,0 ,1 ,0 ,1,28304 , 0 
57121.36,16,193 ,2 ,512 ,0 ,0 ,2 ,1 ,3 ,0 ,0 ,6 ,0 ,9 ,3 ,12,61577 , 0 
57121.444,10,193 ,14 ,512 ,0 ,0 ,2 ,0 ,0 ,0 ,0 ,2 ,0 ,2 ,0 ,2,30577 , 0 
57121.482,12,193 ,18 ,875 ,0 ,0 ,1 ,0 ,0 ,0 ,0 ,1 ,0 ,3 ,0 ,3,31062 , 0 
57121.596,9,193 ,16 ,772 ,0 ,0 ,6 ,2 ,0 ,1 ,0 ,9 ,0 ,7 ,0 ,7,52906 , 0 
57121.603,5,193 ,13 ,519 ,0 ,0 ,2 ,0 ,1 ,1 ,1 ,5 ,0 ,8 ,2 ,10,50220 , 0 
57121.606,19,193 ,1 ,256 ,0 ,0 ,1 ,0 ,0 ,0 ,0 ,1 ,0 ,4 ,0 ,4,32295 , 0 
57121.696,17,193 ,6 ,772 ,0 ,0 ,2 ,0 ,0 ,1 ,1 ,4 ,0 ,4 ,1 ,5,40056 , 0 
57121.771,13,193 ,1 ,256 ,0 ,0 ,2 ,0 ,1 ,1 ,1 ,5 ,0 ,1 ,3 ,4,28800 , 0 
57121.787,3,193 ,1 ,256 ,0 ,0 ,1 ,0 ,0 ,0 ,0 ,1 ,0 ,1 ,0 ,1,20203 , 0 
57240.96,8,193 ,1 ,256 ,0 ,0 ,1 ,0 ,1 ,0 ,0 ,2 ,0 ,2 ,1 ,3,23824 , 0 
57241.078,11,193 ,5 ,844 ,0 ,0 ,1 ,0 ,0 ,0 ,0 ,1 ,0 ,3 ,0 ,3,38603 , 0 
57241.123,2,193 ,1 ,256 ,0 ,0 ,1 ,0 ,3 ,0 ,0 ,4 ,0 ,1 ,3 ,4,40559 , 0 
57241.138,6,193 ,2 ,512 ,0 ,0 ,1 ,1 ,0 ,0 ,0 ,2 ,0 ,2 ,0 ,2,50821 , 0 
57241.214,18,193 ,19 ,527 ,0 ,0 ,0 ,0 ,0 ,0 ,0 ,0 ,0 ,2 ,0 ,2,31951 , 0 
57241.236,4,193 ,8 ,512 ,0 ,0 ,1 ,1 ,0 ,0 ,0 ,2 ,0 ,1 ,0 ,1,28412 , 0 
57241.289,7,193 ,16 ,795 ,0 ,0 ,2 ,1 ,0 ,0 ,0 ,3 ,0 ,4 ,0 ,4,42418 , 0 
57241.337,14,193 ,1 ,256 ,0 ,0 ,1 ,0 ,0 ,0 ,0 ,1 ,0 ,0 ,0 ,0,27192 , 0 
57241.35,15,193 ,11 ,1128 ,0 ,0 ,1 ,0 ,0 ,0 ,0 ,1 ,0 ,2 ,0 ,2,34416 , 0 
57241.36,20,193 ,5 ,844 ,0 ,0 ,1 ,0 ,0 ,0 ,0 ,1 ,0 ,2 ,0 ,2,30762 , 0 
57241.36,16,193 ,2 ,512 ,0 ,0 ,1 ,1 ,1 ,0 ,0 ,3 ,0 ,5 ,1 ,6,56571 , 0 
57241.444,10,193 ,14 ,512 ,0 ,0 ,1 ,0 ,0 ,0 ,0 ,1 ,0 ,0 ,0 ,0,29734 , 0 
57241.482,12,193 ,18 ,875 ,0 ,0 ,2 ,0 ,0 ,0 ,0 ,2 ,0 ,0 ,0 ,0,33736 , 0 
57241.596,9,193 ,16 ,772 ,0 ,0 ,2 ,0 ,0 ,0 ,0 ,2 ,0 ,3 ,0 ,3,50461 , 0 
57241.603,5,193 ,13 ,519 ,0 ,0 ,1 ,0 ,0 ,0 ,0 ,1 ,0 ,3 ,0 ,3,51434 , 0 
57241.606,19,193 ,1 ,256 ,0 ,0 ,1 ,0 ,0 ,0 ,0 ,1 ,0 ,2 ,0 ,2,33112 , 0 
57241.696,17,193 ,6 ,772 ,0 ,0 ,2 ,0 ,0 ,0 ,0 ,2 ,0 ,1 ,0 ,1,38903 , 0 
57241.771,13,193 ,1 ,256 ,0 ,0 ,1 ,0 ,0 ,0 ,0 ,1 ,0 ,1 ,0 ,1,29483 , 0 
57241.787,3,193 ,1 ,256 ,0 ,0 ,1 ,0 ,0 ,0 ,0 ,1 ,0 ,0 ,0 ,0,20800 , 0 
57360.96,8,193 ,1 ,256 ,0 ,0 ,1 ,0 ,0 ,0 ,0 ,1 ,0 ,0 ,0 ,0,23366 , 0 
57361.078,11,193 ,5 ,844 ,0 ,0 ,0 ,0 ,0 ,0 ,0 ,0 ,0 ,1 ,0 ,1,36592 , 0 
57361.123,2,193 ,1 ,256 ,0 ,0 ,2 ,0 ,2 ,0 ,1 ,5 ,0 ,2 ,3 ,5,42797 , 0 
57361.138,6,193 ,2 ,512 ,0 ,0 ,2 ,0 ,2 ,0 ,0 ,4 ,0 ,2 ,2 ,4,59772 , 0 
57361.214,18,193 ,19 ,527 ,0 ,0 ,0 ,0 ,0 ,0 ,0 ,0 ,0 ,1 ,0 ,1,29778 , 0 
57361.236,4,193 ,8 ,512 ,0 ,0 ,0 ,0 ,0 ,0 ,0 ,0 ,0 ,1 ,0 ,1,27033 , 0 
57361.289,7,193 ,16 ,795 ,0 ,0 ,2 ,0 ,0 ,0 ,0 ,2 ,0 ,1 ,0 ,1,42647 , 0 
57361.337,14,193 ,1 ,256 ,0 ,0 ,1 ,0 ,0 ,0 ,0 ,1 ,0 ,2 ,0 ,2,26836 , 0 
57361.35,15,193 ,11 ,1128 ,0 ,0 ,1 ,0 ,0 ,0 ,0 ,1 ,0 ,2 ,0 ,2,32748 , 0 
57361.36,20,193 ,5 ,844 ,0 ,0 ,1 ,0 ,0 ,0 ,0 ,1 ,0 ,0 ,0 ,0,28359 , 0 
57361.36,16,193 ,2 ,512 ,0 ,0 ,2 ,0 ,0 ,0 ,1 ,3 ,0 ,4 ,1 ,5,61659 , 1 
57361.444,10,193 ,14 ,512 ,0 ,0 ,1 ,0 ,0 ,0 ,0 ,1 ,0 ,1 ,0 ,1,30630 , 0 
57361.482,12,193 ,18 ,875 ,0 ,0 ,1 ,0 ,0 ,0 ,0 ,1 ,0 ,2 ,0 ,2,31160 , 0 
57361.596,9,193 ,16 ,4000 ,0 ,0 ,1 ,0 ,0 ,1 ,0 ,2 ,0 ,2 ,0 ,2,52988 , 0 
57361.603,5,193 ,13 ,519 ,0 ,0 ,1 ,0 ,0 ,0 ,0 ,1 ,0 ,2 ,0 ,2,50309 , 0 
57361.61,19,193 ,1 ,256 ,0 ,0 ,1 ,0 ,0 ,0 ,0 ,1 ,0 ,1 ,0 ,1,32366 , 0 
57361.696,17,193 ,6 ,801 ,0 ,0 ,2 ,2 ,0 ,0 ,0 ,4 ,0 ,3 ,0 ,3,40143 , 0 
57361.771,13,193 ,1 ,256 ,0 ,0 ,1 ,0 ,0 ,0 ,0 ,1 ,0 ,2 ,0 ,2,28893 , 0 
57361.787,3,193 ,1 ,256 ,0 ,0 ,1 ,0 ,0 ,0 ,0 ,1 ,0 ,1 ,0 ,1,20269 , 0 
57480.96,8,193 ,1 ,256 ,0 ,0 ,2 ,0 ,0 ,0 ,0 ,2 ,0 ,2 ,0 ,2,23906 , 0 
57481.078,11,193 ,5 ,844 ,0 ,0 ,3 ,0 ,1 ,0 ,0 ,4 ,0 ,7 ,1 ,8,38713 , 0 
57481.123,2,193 ,1 ,256 ,0 ,0 ,1 ,0 ,1 ,1 ,1 ,4 ,0 ,2 ,4 ,6,40693 , 0 
57481.138,6,193 ,2 ,512 ,0 ,0 ,1 ,0 ,1 ,0 ,0 ,2 ,0 ,2 ,1 ,3,50909 , 0 
57481.214,18,193 ,19 ,527 ,0 ,0 ,0 ,0 ,0 ,0 ,0 ,0 ,0 ,2 ,0 ,2,32022 , 0 
57481.236,4,193 ,8 ,512 ,0 ,0 ,1 ,0 ,0 ,0 ,0 ,1 ,0 ,0 ,0 ,0,28493 , 0 
57481.289,7,193 ,17 ,1083 ,0 ,0 ,5 ,1 ,0 ,1 ,0 ,7 ,0 ,6 ,0 ,6,42523 , 0 
57481.337,14,193 ,1 ,256 ,0 ,0 ,1 ,0 ,0 ,0 ,0 ,1 ,0 ,2 ,0 ,2,27274 , 0 
57481.35,15,193 ,11 ,1165 ,0 ,0 ,2 ,1 ,0 ,0 ,0 ,3 ,0 ,9 ,0 ,9,34511 , 0 
57481.36,20,193 ,5 ,844 ,0 ,0 ,1 ,0 ,0 ,0 ,0 ,1 ,0 ,4 ,0 ,4,30863 , 0 
57481.36,16,193 ,2 ,512 ,0 ,0 ,1 ,0 ,0 ,2 ,1 ,4 ,0 ,8 ,1 ,9,56677 , 1 
57481.444,10,193 ,14 ,512 ,0 ,0 ,2 ,0 ,0 ,0 ,0 ,2 ,0 ,0 ,0 ,0,29806 , 0 
57481.482,12,193 ,18 ,875 ,0 ,0 ,2 ,0 ,0 ,0 ,0 ,2 ,0 ,2 ,0 ,2,33822 , 0 
57481.596,9,193 ,5 ,844 ,0 ,0 ,5 ,1 ,0 ,0 ,0 ,6 ,0 ,9 ,0 ,9,50596 , 0 
57481.603,5,193 ,13 ,519 ,0 ,0 ,1 ,0 ,2 ,0 ,0 ,3 ,0 ,7 ,2 ,9,51552 , 0 
57481.606,19,193 ,1 ,256 ,0 ,0 ,1 ,0 ,0 ,0 ,0 ,1 ,0 ,1 ,0 ,1,33235 , 0 
57481.696,17,193 ,6 ,801 ,0 ,0 ,0 ,0 ,1 ,0 ,0 ,1 ,0 ,5 ,1 ,6,38967 , 0 
57481.771,13,193 ,1 ,256 ,0 ,0 ,0 ,0 ,2 ,0 ,0 ,2 ,0 ,0 ,2 ,2,29563 , 0 
57481.787,3,193 ,1 ,256 ,0 ,0 ,3 ,0 ,0 ,0 ,0 ,3 ,0 ,1 ,0 ,1,20875 , 0 
57600.96,8,193 ,1 ,256 ,0 ,0 ,1 ,0 ,0 ,0 ,0 ,1 ,0 ,1 ,0 ,1,23431 , 0 
57601.078,11,193 ,5 ,813 ,0 ,0 ,1 ,1 ,0 ,0 ,0 ,2 ,0 ,2 ,0 ,2,36662 , 0 
57601.123,2,193 ,1 ,256 ,0 ,0 ,1 ,0 ,1 ,0 ,0 ,2 ,0 ,3 ,1 ,4,42870 , 0 
57601.138,6,193 ,2 ,512 ,0 ,0 ,1 ,0 ,1 ,0 ,0 ,2 ,0 ,0 ,1 ,1,59835 , 0 
57601.214,18,193 ,19 ,527 ,0 ,0 ,0 ,0 ,0 ,0 ,0 ,0 ,0 ,2 ,0 ,2,29832 , 0 
57601.236,4,193 ,8 ,512 ,0 ,0 ,1 ,0 ,0 ,0 ,0 ,1 ,0 ,0 ,0 ,0,27104 , 0 
57601.289,7,193 ,17 ,1070 ,0 ,0 ,2 ,1 ,0 ,0 ,0 ,3 ,0 ,4 ,0 ,4,42729 , 0 
57601.337,14,193 ,1 ,256 ,0 ,0 ,1 ,0 ,0 ,0 ,0 ,1 ,0 ,2 ,0 ,2,26913 , 0 
57601.35,15,193 ,11 ,1165 ,0 ,0 ,1 ,0 ,0 ,0 ,0 ,1 ,0 ,4 ,0 ,4,32814 , 0 
57601.36,20,193 ,5 ,813 ,0 ,0 ,1 ,1 ,0 ,0 ,0 ,2 ,0 ,1 ,0 ,1,28417 , 0 
57601.36,16,193 ,2 ,512 ,0 ,0 ,1 ,0 ,0 ,0 ,0 ,1 ,0 ,2 ,0 ,2,61721 , 1 
57601.444,10,193 ,14 ,512 ,0 ,0 ,0 ,0 ,0 ,0 ,0 ,0 ,0 ,0 ,0 ,0,30683 , 0 
57601.482,12,193 ,18 ,875 ,0 ,0 ,1 ,0 ,0 ,0 ,0 ,1 ,0 ,2 ,0 ,2,31231 , 0 
57601.596,9,193 ,5 ,802 ,0 ,0 ,2 ,2 ,0 ,0 ,0 ,4 ,0 ,3 ,0 ,3,53075 , 0 
57601.603,5,193 ,13 ,519 ,0 ,0 ,3 ,0 ,4 ,0 ,0 ,7 ,0 ,2 ,4 ,6,50398 , 0 
57601.606,19,193 ,1 ,256 ,0 ,0 ,1 ,0 ,0 ,0 ,0 ,1 ,0 ,2 ,0 ,2,32430 , 0 
57601.696,17,193 ,6 ,786 ,0 ,0 ,1 ,0 ,1 ,0 ,0 ,2 ,0 ,2 ,1 ,3,40213 , 0 
57601.771,13,193 ,1 ,256 ,0 ,0 ,2 ,0 ,4 ,0 ,0 ,6 ,0 ,1 ,4 ,5,28964 , 0 
57601.787,3,193 ,1 ,256 ,0 ,0 ,1 ,0 ,0 ,0 ,0 ,1 ,0 ,1 ,0 ,1,20326 , 0 
57720.96,8,193 ,1 ,256 ,0 ,0 ,1 ,0 ,0 ,0 ,0 ,1 ,0 ,1 ,0 ,1,23976 , 0 
57721.078,11,193 ,5 ,813 ,0 ,0 ,2 ,0 ,1 ,0 ,0 ,3 ,0 ,1 ,1 ,2,38784 , 0 
57721.123,2,193 ,1 ,256 ,0 ,0 ,1 ,0 ,0 ,0 ,0 ,1 ,0 ,1 ,0 ,1,40752 , 0 
57721.138,6,193 ,2 ,512 ,0 ,0 ,2 ,0 ,0 ,0 ,0 ,2 ,0 ,2 ,0 ,2,50996 , 0 
57721.214,18,193 ,19 ,527 ,0 ,0 ,1 ,0 ,1 ,0 ,0 ,2 ,0 ,0 ,1 ,1,32119 , 0 
57721.236,4,193 ,8 ,512 ,0 ,0 ,1 ,0 ,0 ,0 ,0 ,1 ,0 ,3 ,0 ,3,28554 , 0 
57721.289,7,193 ,17 ,1070 ,0 ,0 ,1 ,0 ,0 ,0 ,0 ,1 ,0 ,2 ,0 ,2,42593 , 0 
57721.337,14,193 ,1 ,256 ,0 ,0 ,0 ,0 ,0 ,0 ,0 ,0 ,0 ,0 ,0 ,0,27325 , 0 
57721.35,15,193 ,11 ,1110 ,0 ,0 ,1 ,1 ,0 ,0 ,0 ,2 ,0 ,3 ,0 ,3,34595 , 0 
57721.36,20,193 ,5 ,813 ,0 ,0 ,0 ,0 ,0 ,0 ,0 ,0 ,0 ,1 ,0 ,1,30912 , 0 
57721.36,16,193 ,2 ,512 ,0 ,0 ,2 ,0 ,0 ,0 ,0 ,2 ,0 ,5 ,0 ,5,56780 , 0 
57721.444,10,193 ,14 ,512 ,0 ,0 ,1 ,0 ,0 ,0 ,0 ,1 ,0 ,2 ,0 ,2,29864 , 0 
57721.482,12,193 ,18 ,815 ,0 ,0 ,1 ,1 ,0 ,0 ,0 ,2 ,0 ,2 ,0 ,2,33911 , 0 
57721.596,9,193 ,5 ,802 ,0 ,0 ,2 ,0 ,0 ,0 ,0 ,2 ,0 ,2 ,0 ,2,50699 , 0 
57721.603,5,193 ,13 ,519 ,0 ,0 ,1 ,0 ,1 ,0 ,0 ,2 ,0 ,1 ,1 ,2,51644 , 0 
57721.606,19,193 ,1 ,256 ,0 ,0 ,1 ,0 ,1 ,0 ,0 ,2 ,0 ,3 ,1 ,4,33297 , 0 
57721.696,17,193 ,6 ,786 ,0 ,0 ,1 ,0 ,0 ,0 ,0 ,1 ,0 ,3 ,0 ,3,39044 , 0 
57721.771,13,193 ,1 ,256 ,0 ,0 ,1 ,0 ,1 ,0 ,0 ,2 ,0 ,1 ,1 ,2,29620 , 0 
57721.787,3,193 ,1 ,256 ,0 ,0 ,1 ,0 ,0 ,0 ,0 ,1 ,0 ,1 ,0 ,1,20938 , 0 
57840.96,8,193 ,1 ,256 ,0 ,0 ,1 ,0 ,0 ,0 ,0 ,1 ,0 ,1 ,0 ,1,23493 , 0 
57841.078,11,193 ,5 ,813 ,0 ,0 ,0 ,0 ,0 ,0 ,0 ,0 ,0 ,3 ,0 ,3,36722 , 0 
57841.123,2,193 ,1 ,256 ,0 ,0 ,2 ,0 ,2 ,0 ,0 ,4 ,0 ,2 ,2 ,4,42977 , 0 
57841.138,6,193 ,2 ,512 ,0 ,0 ,1 ,1 ,0 ,0 ,0 ,2 ,0 ,3 ,0 ,3,59907 , 0 
57841.214,18,193 ,19 ,527 ,0 ,0 ,1 ,0 ,0 ,0 ,0 ,1 ,0 ,1 ,0 ,1,29920 , 0 
57841.236,4,193 ,8 ,512 ,0 ,0 ,2 ,0 ,0 ,0 ,0 ,2 ,0 ,0 ,0 ,0,27185 , 0 
57841.289,7,193 ,17 ,1050 ,0 ,0 ,2 ,0 ,0 ,0 ,0 ,2 ,0 ,2 ,0 ,2,42797 , 0 
57841.337,14,193 ,1 ,256 ,0 ,0 ,2 ,0 ,0 ,0 ,0 ,2 ,0 ,3 ,0 ,3,27009 , 0 
57841.35,15,193 ,11 ,1110 ,0 ,0 ,1 ,0 ,0 ,0 ,0 ,1 ,0 ,0 ,0 ,0,32870 , 0 
57841.36,20,193 ,5 ,813 ,0 ,0 ,2 ,0 ,0 ,0 ,0 ,2 ,0 ,0 ,0 ,0,28506 , 0 
57841.36,16,193 ,2 ,512 ,0 ,0 ,0 ,1 ,0 ,0 ,0 ,1 ,0 ,3 ,0 ,3,61806 , 0 
57841.444,10,193 ,14 ,512 ,0 ,0 ,2 ,0 ,0 ,0 ,0 ,2 ,0 ,0 ,0 ,0,30746 , 0 
57841.482,12,193 ,18 ,815 ,0 ,0 ,1 ,0 ,0 ,0 ,0 ,1 ,0 ,1 ,0 ,1,31300 , 0 
57841.596,9,193 ,5 ,802 ,0 ,0 ,1 ,0 ,0 ,0 ,0 ,1 ,0 ,2 ,0 ,2,53139 , 0 
57841.602,5,193 ,13 ,519 ,0 ,0 ,0 ,0 ,0 ,0 ,0 ,0 ,0 ,3 ,0 ,3,50502 , 0 
57841.606,19,193 ,1 ,256 ,0 ,0 ,1 ,0 ,0 ,0 ,0 ,1 ,0 ,2 ,0 ,2,32523 , 0 
57841.696,17,193 ,6 ,786 ,0 ,0 ,2 ,0 ,0 ,0 ,0 ,2 ,0 ,0 ,0 ,0,40276 , 0 
57841.771,13,193 ,1 ,256 ,0 ,0 ,0 ,0 ,0 ,0 ,0 ,0 ,0 ,1 ,0 ,1,29045 , 0 
57841.787,3,193 ,1 ,256 ,0 ,0 ,0 ,0 ,0 ,0 ,0 ,0 ,0 ,1 ,0 ,1,20385 , 0 
57960.96,8,193 ,1 ,256 ,0 ,0 ,2 ,0 ,1 ,0 ,0 ,3 ,0 ,3 ,1 ,4,24049 , 0 
57961.078,11,193 ,5 ,813 ,0 ,0 ,1 ,0 ,0 ,0 ,0 ,1 ,0 ,2 ,0 ,2,38848 , 0 
57961.123,2,193 ,1 ,256 ,0 ,0 ,2 ,0 ,0 ,0 ,0 ,2 ,0 ,1 ,0 ,1,40835 , 0 
57961.138,6,193 ,2 ,512 ,0 ,0 ,1 ,0 ,0 ,0 ,0 ,1 ,0 ,3 ,0 ,3,51060 , 0 
57961.214,18,193 ,19 ,527 ,0 ,0 ,0 ,0 ,0 ,0 ,0 ,0 ,0 ,3 ,0 ,3,32177 , 0 
57961.236,4,193 ,8 ,512 ,0 ,0 ,3 ,1 ,0 ,0 ,0 ,4 ,0 ,1 ,0 ,1,28651 , 0 
57961.289,7,193 ,17 ,1050 ,0 ,0 ,2 ,0 ,0 ,0 ,0 ,2 ,0 ,3 ,0 ,3,42677 , 0 
57961.337,14,193 ,1 ,256 ,0 ,0 ,1 ,0 ,0 ,0 ,0 ,1 ,0 ,3 ,0 ,3,27396 , 0 
57961.35,15,193 ,11 ,1110 ,0 ,0 ,2 ,0 ,0 ,0 ,0 ,2 ,0 ,4 ,0 ,4,34662 , 0 
57961.36,20,193 ,5 ,813 ,0 ,0 ,1 ,0 ,0 ,0 ,0 ,1 ,0 ,1 ,0 ,1,30984 , 0 
57961.36,16,193 ,2 ,512 ,0 ,0 ,1 ,0 ,0 ,0 ,0 ,1 ,0 ,3 ,0 ,3,56838 , 0 
57961.444,10,193 ,14 ,512 ,0 ,0 ,2 ,0 ,0 ,0 ,0 ,2 ,0 ,0 ,0 ,0,29932 , 0 
57961.482,12,193 ,18 ,815 ,0 ,0 ,1 ,0 ,0 ,0 ,0 ,1 ,0 ,0 ,0 ,0,33973 , 0 
57961.596,9,193 ,5 ,802 ,0 ,0 ,3 ,0 ,0 ,0 ,0 ,3 ,0 ,1 ,0 ,1,50807 , 0 
57961.603,5,193 ,13 ,519 ,0 ,0 ,1 ,0 ,0 ,0 ,0 ,1 ,0 ,2 ,0 ,2,51741 , 0 
57961.606,19,193 ,1 ,256 ,0 ,0 ,2 ,0 ,0 ,0 ,0 ,2 ,0 ,4 ,0 ,4,33393 , 0 
57961.696,17,193 ,6 ,786 ,0 ,0 ,1 ,0 ,0 ,0 ,0 ,1 ,0 ,1 ,0 ,1,39115 , 0 
57961.771,13,193 ,1 ,256 ,0 ,0 ,1 ,0 ,0 ,0 ,0 ,1 ,0 ,1 ,0 ,1,29702 , 0 
57961.787,3,193 ,1 ,256 ,0 ,0 ,1 ,0 ,0 ,0 ,0 ,1 ,0 ,1 ,0 ,1,20994 , 0 
58080.96,8,193 ,1 ,256 ,0 ,0 ,1 ,0 ,0 ,0 ,0 ,1 ,0 ,0 ,0 ,0,23553 , 0 
58081.078,11,193 ,5 ,813 ,0 ,0 ,1 ,0 ,0 ,0 ,0 ,1 ,0 ,0 ,0 ,0,36794 , 0 
58081.123,2,193 ,1 ,256 ,0 ,0 ,1 ,0 ,2 ,0 ,0 ,3 ,0 ,0 ,2 ,2,43052 , 0 
58081.138,6,193 ,2 ,512 ,0 ,0 ,1 ,0 ,1 ,0 ,0 ,2 ,0 ,1 ,1 ,2,59991 , 0 
58081.214,18,193 ,19 ,516 ,0 ,0 ,0 ,1 ,0 ,0 ,0 ,1 ,0 ,1 ,0 ,1,29981 , 0 
58081.236,4,193 ,8 ,512 ,0 ,0 ,0 ,0 ,0 ,0 ,0 ,0 ,0 ,0 ,0 ,0,27236 , 0 
58081.289,7,194 ,17 ,1050 ,0 ,0 ,1 ,0 ,0 ,0 ,0 ,1 ,0 ,0 ,0 ,0,42853 , 1 
58081.337,14,193 ,1 ,256 ,0 ,0 ,1 ,0 ,0 ,0 ,0 ,1 ,0 ,1 ,0 ,1,27076 , 0 
58081.35,15,193 ,11 ,1110 ,0 ,0 ,0 ,0 ,0 ,0 ,0 ,0 ,0 ,0 ,0 ,0,32939 , 0 
58081.36,20,193 ,5 ,813 ,0 ,0 ,1 ,0 ,0 ,0 ,0 ,1 ,0 ,0 ,0 ,0,28559 , 0 
58081.36,16,193 ,2 ,512 ,0 ,0 ,1 ,1 ,0 ,0 ,0 ,2 ,0 ,4 ,0 ,4,61898 , 0 
58081.444,10,193 ,14 ,512 ,0 ,0 ,1 ,0 ,0 ,0 ,0 ,1 ,0 ,0 ,0 ,0,30801 , 0 
58081.482,12,193 ,18 ,815 ,0 ,0 ,0 ,0 ,0 ,0 ,0 ,0 ,0 ,3 ,0 ,3,31376 , 0 
58081.596,9,193 ,5 ,802 ,0 ,0 ,1 ,0 ,0 ,0 ,0 ,1 ,0 ,1 ,0 ,1,53217 , 0 
58081.603,5,193 ,13 ,519 ,0 ,0 ,1 ,0 ,0 ,0 ,0 ,1 ,0 ,0 ,0 ,0,50578 , 0 
58081.606,19,193 ,1 ,256 ,0 ,0 ,1 ,0 ,1 ,0 ,0 ,2 ,0 ,1 ,1 ,2,32589 , 0 
58081.696,17,193 ,6 ,778 ,0 ,0 ,1 ,1 ,0 ,0 ,0 ,2 ,0 ,1 ,0 ,1,40344 , 0 
58081.771,13,193 ,1 ,256 ,0 ,0 ,1 ,0 ,0 ,0 ,0 ,1 ,0 ,1 ,0 ,1,29114 , 0 
58081.787,3,193 ,1 ,256 ,0 ,0 ,1 ,0 ,0 ,0 ,0 ,1 ,0 ,0 ,0 ,0,20441 , 0 
58200.961,8,230 ,1 ,256 ,0 ,0 ,14 ,10 ,2 ,11 ,1 ,38 ,0 ,31 ,4 ,35,24583 , 0 
58201.078,11,229 ,9 ,1936 ,0 ,0 ,18 ,2 ,2 ,2 ,3 ,27 ,0 ,47 ,7 ,54,39308 , 0 
58201.124,2,230 ,1 ,256 ,0 ,0 ,13 ,3 ,0 ,9 ,3 ,28 ,0 ,52 ,5 ,57,41164 , 0 
58201.138,6,230 ,0 ,0 ,0 ,0 ,20 ,2 ,1 ,6 ,1 ,30 ,0 ,44 ,7 ,51,51622 , 0 
58201.214,18,229 ,0 ,0 ,0 ,0 ,16 ,5 ,2 ,7 ,3 ,33 ,0 ,36 ,9 ,45,32756 , 0 
58201.236,4,230 ,8 ,512 ,0 ,0 ,14 ,6 ,0 ,8 ,0 ,28 ,0 ,27 ,3 ,30,29163 , 0 
58201.29,7,234 ,15 ,65535 ,0 ,0 ,20 ,0 ,2 ,2 ,0 ,24 ,0 ,32 ,14 ,46,43062 , 1 
58201.338,14,230 ,1 ,256 ,0 ,0 ,16 ,9 ,3 ,13 ,5 ,46 ,0 ,46 ,14 ,60,27846 , 0 
58201.351,15,231 ,7 ,65535 ,0 ,0 ,19 ,2 ,0 ,3 ,0 ,24 ,0 ,35 ,1 ,36,35009 , 0 
58201.36,20,229 ,5 ,2097 ,0 ,0 ,17 ,4 ,0 ,6 ,0 ,27 ,0 ,33 ,0 ,33,31562 , 0 
58201.361,16,229 ,2 ,512 ,0 ,0 ,15 ,1 ,5 ,3 ,1 ,25 ,0 ,42 ,10 ,52,57427 , 0 
58201.488,12,229 ,0 ,0 ,0 ,0 ,19 ,3 ,1 ,5 ,0 ,28 ,0 ,46 ,3 ,49,34434 , 0 
58201.509,10,229 ,14 ,972 ,0 ,0 ,14 ,4 ,1 ,9 ,1 ,29 ,0 ,23 ,7 ,30,30413 , 0 
58201.597,9,231 ,16 ,1599 ,0 ,0 ,18 ,2 ,6 ,3 ,2 ,31 ,0 ,49 ,15 ,64,51400 , 0 
58201.603,5,230 ,2 ,512 ,0 ,0 ,19 ,3 ,6 ,6 ,7 ,41 ,0 ,67 ,20 ,87,52561 , 0 
58201.607,19,230 ,1 ,256 ,0 ,0 ,15 ,8 ,4 ,10 ,2 ,39 ,0 ,60 ,13 ,73,33932 , 0 
58201.697,17,229 ,0 ,0 ,0 ,0 ,18 ,2 ,0 ,4 ,0 ,24 ,0 ,40 ,5 ,45,39462 , 0 
58201.772,13,230 ,1 ,256 ,0 ,0 ,15 ,6 ,0 ,12 ,3 ,36 ,0 ,41 ,5 ,46,30190 , 0 
58201.787,3,230 ,1 ,256 ,0 ,0 ,12 ,8 ,0 ,9 ,0 ,29 ,0 ,26 ,0 ,26,21269 , 0 
58320.961,8,13 ,1 ,256 ,0 ,0 ,17 ,15 ,5 ,11 ,4 ,52 ,0 ,44 ,13 ,57,23896 , 0 
58321.078,11,13 ,5 ,768 ,0 ,0 ,20 ,1 ,0 ,2 ,0 ,23 ,0 ,66 ,0 ,66,37057 , 0 
58321.124,2,13 ,1 ,256 ,0 ,0 ,18 ,6 ,1 ,9 ,1 ,35 ,0 ,72 ,5 ,77,43373 , 0 
58321.138,6,13 ,2 ,512 ,0 ,0 ,19 ,2 ,0 ,5 ,0 ,26 ,0 ,46 ,1 ,47,60317 , 0 
58321.214,18,13 ,4 ,768 ,0 ,0 ,21 ,6 ,5 ,7 ,3 ,42 ,0 ,41 ,10 ,51,30489 , 0 
58321.236,4,6 ,8 ,512 ,0 ,0 ,17 ,8 ,0 ,11 ,0 ,36 ,0 ,37 ,1 ,38,27731 , 0 
58321.29,7,16 ,15 ,65535 ,0 ,0 ,19 ,0 ,0 ,0 ,0 ,19 ,0 ,54 ,0 ,54,43058 , 1 
58321.338,14,10 ,14 ,0 ,0 ,0 ,16 ,11 ,7 ,15 ,5 ,54 ,0 ,50 ,17 ,67,27500 , 0 
58321.35,15,15 ,7 ,65535 ,0 ,0 ,18 ,0 ,0 ,0 ,0 ,18 ,0 ,44 ,0 ,44,33131 , 0 
58321.36,20,13 ,5 ,768 ,0 ,0 ,17 ,3 ,0 ,4 ,0 ,24 ,0 ,37 ,0 ,37,28854 , 0 
58321.361,16,13 ,2 ,512 ,0 ,0 ,21 ,0 ,0 ,0 ,0 ,21 ,0 ,56 ,0 ,56,62126 , 0 
58321.444,10,9 ,14 ,768 ,0 ,0 ,15 ,4 ,1 ,7 ,1 ,28 ,0 ,25 ,4 ,29,31190 , 0 
58321.482,12,13 ,18 ,768 ,0 ,0 ,19 ,3 ,1 ,4 ,1 ,28 ,0 ,50 ,2 ,52,31701 , 0 
58321.596,9,15 ,16 ,1599 ,0 ,0 ,20 ,0 ,0 ,0 ,0 ,20 ,0 ,61 ,0 ,61,53439 , 0 
58321.603,5,15 ,19 ,512 ,0 ,0 ,20 ,3 ,2 ,4 ,0 ,29 ,0 ,80 ,9 ,89,50967 , 0 
58321.607,19,14 ,1 ,256 ,0 ,0 ,20 ,7 ,9 ,14 ,4 ,54 ,0 ,79 ,27 ,106,32989 , 0 
58321.697,17,13 ,6 ,799 ,0 ,0 ,20 ,0 ,0 ,1 ,0 ,21 ,0 ,44 ,0 ,44,40577 , 0 
58321.771,13,14 ,0 ,0 ,0 ,0 ,18 ,8 ,3 ,11 ,0 ,40 ,0 ,52 ,6 ,58,29440 , 0 
58321.787,3,10 ,0 ,0 ,0 ,0 ,15 ,13 ,0 ,11 ,0 ,39 ,0 ,35 ,0 ,35,20761 , 0 
58440.96,8,18 ,1 ,256 ,0 ,0 ,9 ,6 ,6 ,5 ,1 ,27 ,0 ,24 ,10 ,34,24826 , 0 
58441.078,11,18 ,5 ,774 ,0 ,0 ,13 ,3 ,2 ,0 ,0 ,18 ,0 ,39 ,3 ,42,39564 , 0 
58441.124,2,18 ,1 ,256 ,0 ,0 ,11 ,4 ,14 ,3 ,3 ,35 ,0 ,30 ,21 ,51,41495 , 0 
58441.138,6,18 ,2 ,512 ,0 ,0 ,11 ,4 ,4 ,1 ,1 ,21 ,0 ,30 ,6 ,36,52001 , 0 
58441.214,18,18 ,19 ,518 ,0 ,0 ,10 ,5 ,0 ,4 ,0 ,19 ,0 ,25 ,0 ,25,33047 , 0 
58441.236,4,18 ,8 ,512 ,0 ,0 ,10 ,6 ,1 ,3 ,1 ,21 ,0 ,20 ,2 ,22,29443 , 0 
58441.29,7,18 ,9 ,1047 ,0 ,0 ,16 ,4 ,0 ,2 ,0 ,22 ,0 ,25 ,0 ,25,43350 , 0 
58441.338,14,18 ,1 ,256 ,0 ,0 ,12 ,6 ,3 ,6 ,0 ,27 ,0 ,30 ,5 ,35,28078 , 0 
58441.35,15,18 ,11 ,1198 ,0 ,0 ,14 ,3 ,0 ,2 ,0 ,19 ,0 ,26 ,0 ,26,35347 , 0 
58441.36,20,18 ,12 ,1299 ,0 ,0 ,11 ,4 ,0 ,1 ,0 ,16 ,0 ,19 ,0 ,19,31789 , 0 
58441.444,10,18 ,14 ,512 ,0 ,0 ,12 ,5 ,0 ,3 ,0 ,20 ,0 ,14 ,0 ,14,30655 , 0 
58441.482,12,18 ,5 ,813 ,0 ,0 ,11 ,2 ,2 ,0 ,0 ,15 ,0 ,26 ,3 ,29,34687 , 0 
58441.495,16,18 ,2 ,512 ,0 ,0 ,10 ,2 ,3 ,2 ,2 ,19 ,0 ,26 ,5 ,31,57730 , 0 
58441.596,9,18 ,5 ,774 ,0 ,0 ,11 ,3 ,1 ,0 ,0 ,15 ,0 ,33 ,2 ,35,51655 , 0 
58441.603,5,18 ,19 ,518 ,0 ,0 ,12 ,4 ,13 ,2 ,0 ,31 ,0 ,44 ,14 ,58,53025 , 0 
58441.607,19,18 ,1 ,256 ,0 ,0 ,10 ,6 ,13 ,6 ,1 ,36 ,0 ,37 ,19 ,56,34212 , 0 
58441.697,17,18 ,6 ,1244 ,0 ,0 ,13 ,4 ,1 ,1 ,0 ,19 ,0 ,22 ,2 ,24,39761 , 0 
58441.772,13,18 ,1 ,256 ,0 ,0 ,10 ,4 ,1 ,2 ,0 ,17 ,0 ,25 ,3 ,28,30428 , 0 
58441.787,3,18 ,1 ,256 ,0 ,0 ,8 ,6 ,2 ,4 ,2 ,22 ,0 ,15 ,4 ,19,21426 , 0 
58560.96,8,18 ,1 ,256 ,0 ,0 ,3 ,1 ,1 ,0 ,1 ,6 ,0 ,8 ,2 ,10,23981 , 0 
58561.078,11,18 ,5 ,830 ,0 ,0 ,2 ,2 ,1 ,0 ,0 ,5 ,0 ,6 ,1 ,7,37161 , 0 
58561.123,2,18 ,1 ,256 ,0 ,0 ,2 ,0 ,3 ,2 ,1 ,8 ,0 ,6 ,4 ,10,43467 , 0 
58561.138,6,18 ,2 ,512 ,0 ,0 ,3 ,1 ,1 ,0 ,0 ,5 ,0 ,5 ,1 ,6,60410 , 0 
58561.214,18,18 ,19 ,512 ,0 ,0 ,2 ,1 ,0 ,0 ,0 ,3 ,0 ,9 ,0 ,9,30590 , 0 
58561.236,4,18 ,19 ,512 ,0 ,0 ,5 ,2 ,0 ,1 ,0 ,8 ,0 ,5 ,0 ,5,27859 , 0 
58561.289,7,18 ,9 ,1085 ,0 ,0 ,3 ,1 ,0 ,0 ,0 ,4 ,0 ,4 ,0 ,4,43137 , 0 
58561.337,14,18 ,1 ,256 ,0 ,0 ,2 ,1 ,1 ,0 ,0 ,4 ,0 ,6 ,1 ,7,27606 , 0 
58561.35,15,18 ,11 ,1184 ,0 ,0 ,2 ,1 ,0 ,0 ,0 ,3 ,0 ,5 ,0 ,5,33196 , 0 
58561.36,20,18 ,12 ,1236 ,0 ,0 ,2 ,1 ,0 ,0 ,0 ,3 ,0 ,4 ,0 ,4,28953 , 0 
58561.36,16,18 ,2 ,512 ,0 ,0 ,2 ,1 ,0 ,0 ,0 ,3 ,0 ,7 ,0 ,7,62235 , 0 
58561.444,10,18 ,14 ,512 ,0 ,0 ,3 ,1 ,0 ,0 ,0 ,4 ,0 ,4 ,0 ,4,31285 , 0 
58561.482,12,18 ,5 ,830 ,0 ,0 ,1 ,2 ,1 ,0 ,0 ,4 ,0 ,5 ,1 ,6,31799 , 0 
58561.596,9,18 ,5 ,830 ,0 ,0 ,2 ,2 ,1 ,0 ,0 ,5 ,0 ,9 ,1 ,10,53549 , 0 
58561.603,5,18 ,19 ,512 ,0 ,0 ,3 ,1 ,9 ,0 ,0 ,13 ,0 ,8 ,9 ,17,51185 , 0 
58561.607,19,18 ,1 ,256 ,0 ,0 ,2 ,0 ,12 ,0 ,0 ,14 ,0 ,12 ,12 ,24,33130 , 0 
58561.696,17,18 ,6 ,1081 ,0 ,0 ,2 ,1 ,0 ,0 ,0 ,3 ,0 ,5 ,0 ,5,40653 , 0 
58561.771,13,18 ,1 ,256 ,0 ,0 ,3 ,0 ,0 ,0 ,0 ,3 ,0 ,6 ,0 ,6,29555 , 0 
58561.787,3,18 ,1 ,256 ,0 ,0 ,3 ,1 ,0 ,0 ,0 ,4 ,0 ,4 ,0 ,4,20832 , 0 
58680.96,8,18 ,1 ,256 ,0 ,0 ,2 ,1 ,0 ,1 ,0 ,4 ,0 ,6 ,0 ,6,24915 , 0 
58681.078,11,18 ,5 ,786 ,0 ,0 ,2 ,1 ,1 ,0 ,0 ,4 ,0 ,7 ,1 ,8,39639 , 0 
58681.123,2,18 ,1 ,256 ,0 ,0 ,2 ,1 ,4 ,0 ,0 ,7 ,0 ,7 ,4 ,11,41567 , 0 
58681.138,6,18 ,2 ,512 ,0 ,0 ,1 ,2 ,1 ,0 ,0 ,4 ,0 ,7 ,1 ,8,52095 , 0 
58681.214,18,18 ,4 ,768 ,0 ,0 ,5 ,3 ,0 ,1 ,0 ,9 ,0 ,6 ,0 ,6,33200 , 0 
58681.236,4,18 ,19 ,512 ,0 ,0 ,3 ,1 ,2 ,0 ,0 ,6 ,0 ,7 ,2 ,9,29544 , 0 
58681.289,7,18 ,9 ,1132 ,0 ,0 ,2 ,2 ,0 ,0 ,0 ,4 ,0 ,7 ,0 ,7,43463 , 0 
58681.337,14,18 ,1 ,256 ,0 ,0 ,2 ,1 ,1 ,0 ,0 ,4 ,0 ,4 ,1 ,5,28154 , 0 
58681.35,15,18 ,11 ,1183 ,0 ,0 ,2 ,1 ,0 ,0 ,0 ,3 ,0 ,4 ,0 ,4,35421 , 0 
58681.36,20,18 ,12 ,1237 ,0 ,0 ,3 ,1 ,0 ,0 ,0 ,4 ,0 ,4 ,0 ,4,31861 , 0 
58681.36,16,18 ,2 ,512 ,0 ,0 ,2 ,1 ,0 ,0 ,0 ,3 ,0 ,5 ,0 ,5,57813 , 0 
58681.444,10,18 ,14 ,512 ,0 ,0 ,2 ,1 ,0 ,0 ,0 ,3 ,0 ,1 ,0 ,1,30730 , 0 
58681.482,12,18 ,5 ,786 ,0 ,0 ,2 ,1 ,1 ,0 ,0 ,4 ,0 ,8 ,1 ,9,34770 , 0 
58681.596,9,18 ,5 ,786 ,0 ,0 ,3 ,1 ,2 ,0 ,0 ,6 ,0 ,5 ,2 ,7,51766 , 0 
58681.603,5,18 ,19 ,512 ,0 ,0 ,2 ,1 ,7 ,0 ,0 ,10 ,0 ,12 ,7 ,19,53165 , 0 
58681.607,19,18 ,1 ,256 ,0 ,0 ,2 ,1 ,11 ,0 ,1 ,15 ,0 ,11 ,12 ,23,34309 , 0 
58681.696,17,18 ,6 ,1081 ,0 ,0 ,2 ,1 ,0 ,0 ,0 ,3 ,0 ,2 ,0 ,2,39836 , 0 
58681.771,13,18 ,1 ,256 ,0 ,0 ,2 ,1 ,0 ,0 ,0 ,3 ,0 ,5 ,0 ,5,30502 , 0 
58681.787,3,18 ,1 ,256 ,0 ,0 ,2 ,1 ,0 ,0 ,0 ,3 ,0 ,4 ,0 ,4,21496 , 0 
58800.96,8,18 ,1 ,256 ,0 ,0 ,1 ,0 ,0 ,0 ,0 ,1 ,0 ,3 ,0 ,3,24044 , 0 
58801.078,11,18 ,9 ,300 ,0 ,0 ,7 ,1 ,2 ,7 ,0 ,17 ,0 ,15 ,19 ,34,37420 , 0 
58801.123,2,18 ,1 ,256 ,0 ,0 ,1 ,0 ,1 ,0 ,1 ,3 ,0 ,7 ,3 ,10,43586 , 0 
58801.138,6,18 ,2 ,512 ,0 ,0 ,2 ,0 ,1 ,0 ,0 ,3 ,0 ,6 ,1 ,7,60504 , 0 
58801.214,18,18 ,4 ,768 ,0 ,0 ,4 ,2 ,0 ,0 ,0 ,6 ,0 ,8 ,0 ,8,30694 , 0 
58801.236,4,18 ,19 ,512 ,0 ,0 ,2 ,1 ,2 ,0 ,0 ,5 ,0 ,5 ,2 ,7,27944 , 0 
58801.337,14,18 ,1 ,256 ,0 ,0 ,1 ,0 ,0 ,0 ,0 ,1 ,0 ,1 ,0 ,1,27678 , 0 
58801.343,7,18 ,9 ,65535 ,0 ,0 ,6 ,5 ,1 ,7 ,0 ,19 ,0 ,12 ,6 ,18,43397 , 0 
58801.35,15,18 ,7 ,673 ,0 ,0 ,3 ,3 ,0 ,1 ,0 ,7 ,0 ,15 ,0 ,15,33342 , 0 
58801.36,20,18 ,11 ,596 ,0 ,0 ,4 ,2 ,0 ,2 ,0 ,8 ,0 ,8 ,0 ,8,29130 , 0 
58801.361,16,18 ,9 ,300 ,0 ,0 ,6 ,4 ,1 ,4 ,1 ,16 ,0 ,11 ,8 ,19,62488 , 0 
58801.444,10,18 ,14 ,512 ,0 ,0 ,1 ,0 ,0 ,0 ,0 ,1 ,0 ,1 ,0 ,1,31345 , 0 
58801.482,12,18 ,11 ,596 ,0 ,0 ,5 ,3 ,0 ,3 ,1 ,12 ,0 ,13 ,1 ,14,32008 , 0 
58801.603,5,18 ,19 ,512 ,0 ,0 ,4 ,1 ,3 ,0 ,6 ,14 ,0 ,22 ,13 ,35,51472 , 0 
58801.607,19,18 ,1 ,256 ,0 ,0 ,2 ,0 ,7 ,0 ,6 ,15 ,0 ,7 ,13 ,20,33223 , 0 
58801.608,9,18 ,11 ,65535 ,0 ,0 ,7 ,6 ,5 ,11 ,3 ,32 ,0 ,20 ,23 ,43,53885 , 1 
58801.696,17,18 ,6 ,994 ,0 ,0 ,2 ,1 ,0 ,0 ,0 ,3 ,0 ,11 ,0 ,11,40812 , 0 
58801.771,13,18 ,1 ,256 ,0 ,0 ,0 ,0 ,0 ,0 ,0 ,0 ,0 ,3 ,0 ,3,29631 , 0 
58801.786,3,18 ,1 ,256 ,0 ,0 ,1 ,0 ,0 ,0 ,0 ,1 ,0 ,1 ,0 ,1,20897 , 0 
58920.96,8,18 ,1 ,256 ,0 ,0 ,1 ,1 ,0 ,0 ,0 ,2 ,0 ,3 ,0 ,3,24994 , 0 
58921.079,11,18 ,9 ,300 ,0 ,0 ,16 ,14 ,29 ,11 ,5 ,75 ,0 ,33 ,54 ,87,40584 , 0 
58921.124,2,18 ,1 ,256 ,0 ,0 ,2 ,1 ,5 ,1 ,0 ,9 ,0 ,13 ,6 ,19,41702 , 0 
58921.138,6,18 ,2 ,512 ,0 ,0 ,3 ,1 ,1 ,0 ,0 ,5 ,0 ,12 ,1 ,13,52310 , 0 
58921.214,18,18 ,4 ,768 ,0 ,0 ,4 ,0 ,1 ,0 ,0 ,5 ,0 ,12 ,1 ,13,33412 , 0 
58921.236,4,18 ,8 ,512 ,0 ,0 ,1 ,1 ,1 ,1 ,0 ,4 ,0 ,3 ,1 ,4,29722 , 0 
58921.29,7,18 ,9 ,300 ,0 ,0 ,14 ,15 ,4 ,10 ,1 ,44 ,0 ,29 ,20 ,49,44032 , 0 
58921.337,14,18 ,1 ,256 ,0 ,0 ,2 ,1 ,1 ,0 ,0 ,4 ,0 ,7 ,1 ,8,28272 , 0 
58921.35,15,18 ,7 ,765 ,0 ,0 ,9 ,9 ,0 ,4 ,0 ,22 ,0 ,34 ,0 ,34,35765 , 0 
58921.36,20,18 ,11 ,605 ,0 ,0 ,15 ,10 ,0 ,6 ,0 ,31 ,0 ,19 ,0 ,19,32284 , 0 
58921.361,16,18 ,2 ,512 ,0 ,0 ,10 ,12 ,5 ,5 ,4 ,36 ,0 ,26 ,15 ,41,58382 , 0 
58921.444,10,18 ,14 ,512 ,0 ,0 ,2 ,1 ,0 ,0 ,0 ,3 ,0 ,2 ,0 ,2,30850 , 0 
58921.482,12,18 ,18 ,1024 ,0 ,0 ,10 ,11 ,6 ,5 ,2 ,34 ,0 ,24 ,12 ,36,35263 , 0 
58921.597,9,18 ,7 ,65535 ,0 ,0 ,20 ,11 ,34 ,21 ,5 ,91 ,0 ,31 ,86 ,117,52850 , 1 
58921.607,19,18 ,1 ,256 ,0 ,0 ,1 ,1 ,16 ,2 ,4 ,24 ,0 ,11 ,22 ,33,34560 , 0 
58921.608,5,18 ,11 ,595 ,0 ,0 ,9 ,2 ,34 ,3 ,5 ,53 ,0 ,37 ,58 ,95,53912 , 0 
58921.696,17,18 ,6 ,991 ,0 ,0 ,2 ,1 ,0 ,0 ,0 ,3 ,0 ,19 ,0 ,19,40010 , 0 
58921.771,13,18 ,1 ,256 ,0 ,0 ,3 ,1 ,0 ,0 ,0 ,4 ,0 ,12 ,0 ,12,30712 , 0 
58921.787,3,18 ,1 ,256 ,0 ,0 ,2 ,1 ,0 ,0 ,0 ,3 ,0 ,3 ,0 ,3,21590 , 0 
59040.96,8,18 ,1 ,256 ,0 ,0 ,1 ,0 ,5 ,0 ,0 ,6 ,0 ,5 ,7 ,12,24174 , 0 
59041.078,11,18 ,9 ,300 ,0 ,0 ,7 ,13 ,5 ,3 ,1 ,29 ,0 ,33 ,17 ,50,37920 , 0 
59041.124,2,18 ,1 ,256 ,0 ,0 ,1 ,0 ,6 ,3 ,3 ,13 ,0 ,10 ,10 ,20,43776 , 0 
59041.138,6,18 ,2 ,512 ,0 ,0 ,1 ,0 ,0 ,0 ,0 ,1 ,0 ,15 ,1 ,16,60686 , 0 
59041.214,18,18 ,4 ,855 ,0 ,0 ,2 ,2 ,2 ,1 ,1 ,8 ,0 ,12 ,4 ,16,30850 , 0 
59041.236,4,18 ,8 ,512 ,0 ,0 ,6 ,0 ,4 ,1 ,1 ,12 ,0 ,1 ,6 ,7,28140 , 0 
59041.29,7,18 ,9 ,300 ,0 ,0 ,19 ,14 ,75 ,19 ,9 ,136 ,0 ,36 ,122 ,158,44374 , 0 
59041.337,14,18 ,1 ,256 ,0 ,0 ,0 ,0 ,0 ,0 ,0 ,0 ,0 ,1 ,0 ,1,27739 , 0 
59041.35,15,18 ,11 ,738 ,0 ,0 ,14 ,14 ,0 ,8 ,1 ,37 ,0 ,35 ,7 ,42,33880 , 0 
59041.36,20,18 ,11 ,706 ,0 ,0 ,8 ,3 ,0 ,2 ,0 ,13 ,0 ,8 ,2 ,10,29334 , 0 
59041.409,16,18 ,7 ,573 ,0 ,0 ,12 ,7 ,76 ,6 ,11 ,112 ,0 ,28 ,115 ,143,63434 , 0 
59041.444,10,18 ,14 ,512 ,0 ,0 ,1 ,0 ,0 ,0 ,0 ,1 ,0 ,0 ,0 ,0,31403 , 0 
59041.482,12,18 ,11 ,738 ,0 ,0 ,9 ,2 ,1 ,3 ,1 ,16 ,0 ,11 ,2 ,13,32265 , 0 
59041.603,5,18 ,2 ,534 ,0 ,0 ,6 ,3 ,0 ,3 ,0 ,12 ,0 ,26 ,0 ,26,51748 , 0 
59041.606,19,18 ,1 ,256 ,0 ,0 ,1 ,0 ,0 ,4 ,0 ,5 ,0 ,7 ,0 ,7,33329 , 0 
59041.612,9,18 ,16 ,980 ,0 ,0 ,19 ,17 ,80 ,25 ,10 ,151 ,0 ,43 ,126 ,169,55246 , 1 
59041.696,17,18 ,6 ,968 ,0 ,0 ,5 ,0 ,0 ,0 ,0 ,5 ,0 ,27 ,0 ,27,40976 , 0 
59041.771,13,18 ,1 ,256 ,0 ,0 ,1 ,0 ,0 ,0 ,0 ,1 ,0 ,3 ,0 ,3,29734 , 0 
59041.787,3,18 ,1 ,256 ,0 ,0 ,1 ,0 ,0 ,0 ,0 ,1 ,0 ,1 ,0 ,1,20963 , 0 
59160.96,8,18 ,1 ,256 ,0 ,0 ,1 ,0 ,1 ,0 ,0 ,2 ,0 ,1 ,1 ,2,25065 , 0 
59161.078,11,18 ,5 ,945 ,0 ,0 ,5 ,4 ,8 ,2 ,0 ,19 ,0 ,15 ,13 ,28,40836 , 0 
59161.124,2,18 ,1 ,256 ,0 ,0 ,1 ,0 ,17 ,0 ,0 ,18 ,0 ,4 ,17 ,21,41809 , 0 
59161.138,6,18 ,2 ,512 ,0 ,0 ,1 ,0 ,5 ,0 ,0 ,6 ,0 ,6 ,6 ,12,52466 , 0 
59161.214,18,18 ,4 ,824 ,0 ,0 ,1 ,1 ,0 ,0 ,0 ,2 ,0 ,6 ,0 ,6,33501 , 0 
59161.236,4,18 ,8 ,523 ,0 ,0 ,1 ,0 ,1 ,0 ,0 ,2 ,0 ,1 ,1 ,2,29807 , 0 
59161.29,7,18 ,17 ,1295 ,0 ,0 ,6 ,2 ,14 ,5 ,2 ,29 ,0 ,10 ,16 ,26,44329 , 0 
59161.337,14,18 ,1 ,256 ,0 ,0 ,1 ,0 ,0 ,0 ,0 ,1 ,0 ,3 ,0 ,3,28374 , 0 
59161.35,15,18 ,11 ,1376 ,0 ,0 ,6 ,5 ,2 ,0 ,1 ,14 ,0 ,11 ,8 ,19,36042 , 0 
59161.36,20,18 ,11 ,1376 ,0 ,0 ,6 ,5 ,0 ,2 ,0 ,13 ,0 ,10 ,3 ,13,32480 , 0 
59161.361,16,18 ,6 ,931 ,0 ,0 ,6 ,1 ,16 ,2 ,1 ,26 ,0 ,11 ,20 ,31,58605 , 0 
59161.444,10,18 ,14 ,512 ,0 ,0 ,2 ,0 ,0 ,0 ,0 ,2 ,0 ,1 ,0 ,1,30929 , 0 
59161.482,12,18 ,5 ,945 ,0 ,0 ,7 ,2 ,0 ,2 ,0 ,11 ,0 ,10 ,2 ,12,35451 , 0 
59161.596,9,18 ,16 ,1204 ,0 ,0 ,5 ,3 ,12 ,3 ,1 ,24 ,0 ,16 ,14 ,30,53196 , 0 
59161.603,5,18 ,2 ,534 ,0 ,0 ,2 ,0 ,12 ,0 ,0 ,14 ,0 ,17 ,12 ,29,54155 , 0 
59161.606,19,18 ,1 ,256 ,0 ,0 ,1 ,0 ,0 ,0 ,0 ,1 ,0 ,4 ,0 ,4,34653 , 0 
59161.696,17,18 ,6 ,968 ,0 ,0 ,3 ,0 ,1 ,0 ,0 ,4 ,0 ,9 ,1 ,10,40113 , 0 
59161.771,13,18 ,1 ,256 ,0 ,0 ,1 ,0 ,0 ,0 ,0 ,1 ,0 ,2 ,0 ,2,30788 , 0 
59161.786,3,18 ,1 ,256 ,0 ,0 ,1 ,0 ,0 ,0 ,0 ,1 ,0 ,2 ,0 ,2,21662 , 0 
59280.96,8,18 ,1 ,256 ,0 ,0 ,3 ,0 ,3 ,1 ,1 ,8 ,0 ,2 ,5 ,7,24264 , 0 
59281.078,11,18 ,5 ,945 ,0 ,0 ,3 ,0 ,4 ,0 ,0 ,7 ,0 ,6 ,5 ,11,38028 , 0 
59281.123,2,18 ,1 ,256 ,0 ,0 ,1 ,0 ,7 ,0 ,1 ,9 ,0 ,2 ,9 ,11,43870 , 0 
59281.138,6,18 ,2 ,512 ,0 ,0 ,1 ,0 ,1 ,1 ,1 ,4 ,0 ,3 ,3 ,6,60776 , 0 
59281.214,18,18 ,19 ,512 ,0 ,0 ,6 ,2 ,0 ,1 ,0 ,9 ,0 ,5 ,0 ,5,30984 , 0 
59281.236,4,18 ,8 ,521 ,0 ,0 ,2 ,2 ,1 ,1 ,1 ,7 ,0 ,4 ,2 ,6,28262 , 0 
59281.289,7,18 ,17 ,1295 ,0 ,0 ,5 ,0 ,0 ,0 ,0 ,5 ,0 ,6 ,0 ,6,44457 , 0 
59281.337,14,18 ,1 ,256 ,0 ,0 ,1 ,0 ,0 ,0 ,0 ,1 ,0 ,1 ,0 ,1,27807 , 0 
59281.35,15,18 ,11 ,1314 ,0 ,0 ,2 ,2 ,0 ,1 ,0 ,5 ,0 ,9 ,0 ,9,33971 , 0 
59281.36,20,18 ,11 ,1314 ,0 ,0 ,2 ,2 ,0 ,0 ,0 ,4 ,0 ,5 ,0 ,5,29421 , 0 
59281.36,16,18 ,6 ,966 ,0 ,0 ,2 ,1 ,0 ,1 ,1 ,5 ,0 ,9 ,1 ,10,63526 , 0 
59281.444,10,18 ,14 ,512 ,0 ,0 ,2 ,0 ,0 ,0 ,0 ,2 ,0 ,0 ,0 ,0,31466 , 0 
59281.482,12,18 ,5 ,864 ,0 ,0 ,3 ,1 ,0 ,0 ,0 ,4 ,0 ,10 ,0 ,10,32386 , 0 
59281.596,9,18 ,5 ,864 ,0 ,0 ,4 ,1 ,0 ,1 ,0 ,6 ,0 ,10 ,0 ,10,55342 , 0 
59281.602,5,18 ,2 ,534 ,0 ,0 ,2 ,0 ,6 ,0 ,0 ,8 ,0 ,15 ,6 ,21,51925 , 0 
59281.606,19,18 ,1 ,256 ,0 ,0 ,1 ,0 ,1 ,0 ,0 ,2 ,0 ,9 ,1 ,10,33443 , 0 
59281.696,17,18 ,6 ,968 ,0 ,0 ,1 ,0 ,0 ,0 ,0 ,1 ,0 ,4 ,0 ,4,41048 , 0 
59281.771,13,18 ,1 ,256 ,0 ,0 ,1 ,0 ,0 ,0 ,0 ,1 ,0 ,3 ,0 ,3,29832 , 0 
59281.787,3,18 ,1 ,256 ,0 ,0 ,1 ,0 ,0 ,0 ,0 ,1 ,0 ,0 ,0 ,0,21026 , 0 
59400.96,8,18 ,1 ,256 ,0 ,0 ,0 ,1 ,0 ,0 ,0 ,1 ,0 ,4 ,0 ,4,25131 , 0 
59401.078,11,18 ,5 ,945 ,0 ,0 ,1 ,0 ,1 ,0 ,0 ,2 ,0 ,4 ,1 ,5,40908 , 0 
59401.123,2,18 ,1 ,256 ,0 ,0 ,2 ,1 ,5 ,0 ,0 ,8 ,0 ,7 ,5 ,12,41899 , 0 
59401.138,6,18 ,2 ,512 ,0 ,0 ,3 ,1 ,3 ,0 ,0 ,7 ,0 ,2 ,3 ,5,52598 , 0 
59401.214,18,18 ,19 ,518 ,0 ,0 ,1 ,1 ,0 ,0 ,0 ,2 ,0 ,2 ,0 ,2,33567 , 0 
59401.236,4,18 ,8 ,521 ,0 ,0 ,1 ,0 ,0 ,0 ,0 ,1 ,0 ,2 ,0 ,2,29873 , 0 
59401.289,7,18 ,17 ,1218 ,0 ,0 ,2 ,1 ,0 ,0 ,0 ,3 ,0 ,5 ,0 ,5,44402 , 0 
59401.337,14,18 ,1 ,256 ,0 ,0 ,2 ,1 ,1 ,0 ,0 ,4 ,0 ,6 ,1 ,7,28439 , 0 
59401.35,15,18 ,11 ,1291 ,0 ,0 ,1 ,1 ,0 ,0 ,0 ,2 ,0 ,5 ,0 ,5,36112 , 0 
59401.36,20,18 ,11 ,1314 ,0 ,0 ,2 ,0 ,0 ,0 ,0 ,2 ,0 ,0 ,0 ,0,32539 , 0 
59401.36,16,18 ,6 ,912 ,0 ,0 ,2 ,1 ,0 ,0 ,0 ,3 ,0 ,6 ,0 ,6,58687 , 0 
59401.444,10,18 ,14 ,512 ,0 ,0 ,1 ,1 ,0 ,0 ,0 ,2 ,0 ,3 ,0 ,3,31004 , 0 
59401.482,12,18 ,5 ,864 ,0 ,0 ,0 ,0 ,0 ,0 ,0 ,0 ,0 ,3 ,0 ,3,35503 , 0 
59401.596,9,18 ,5 ,864 ,0 ,0 ,3 ,0 ,0 ,0 ,0 ,3 ,0 ,2 ,0 ,2,53290 , 0 
59401.602,5,18 ,2 ,512 ,0 ,0 ,1 ,0 ,1 ,0 ,0 ,2 ,0 ,7 ,1 ,8,54252 , 0 
59401.606,19,18 ,1 ,256 ,0 ,0 ,2 ,1 ,1 ,0 ,0 ,4 ,0 ,5 ,1 ,6,34736 , 0 
59401.696,17,18 ,6 ,912 ,0 ,0 ,2 ,1 ,1 ,0 ,0 ,4 ,0 ,4 ,1 ,5,40196 , 0 
59401.771,13,18 ,1 ,256 ,0 ,0 ,2 ,1 ,0 ,0 ,0 ,3 ,0 ,5 ,0 ,5,30866 , 0 
59401.787,3,18 ,1 ,256 ,0 ,0 ,2 ,1 ,0 ,0 ,0 ,3 ,0 ,2 ,0 ,2,21730 , 0 
59520.96,8,18 ,1 ,256 ,0 ,0 ,2 ,0 ,1 ,0 ,0 ,3 ,0 ,1 ,1 ,2,24345 , 0 
59521.078,11,18 ,5 ,945 ,0 ,0 ,2 ,0 ,1 ,0 ,0 ,3 ,0 ,2 ,1 ,3,38169 , 0 
59521.139,6,18 ,2 ,512 ,0 ,120 ,1 ,15 ,11 ,1 ,2 ,150 ,0 ,72 ,13 ,85,61738 , 1 
59521.141,2,18 ,1 ,256 ,0 ,0 ,26 ,0 ,54 ,0 ,2 ,82 ,107 ,22 ,57 ,186,44248 , 0 
59521.214,18,18 ,19 ,518 ,0 ,0 ,3 ,0 ,0 ,0 ,0 ,3 ,0 ,1 ,0 ,1,31066 , 0 
59521.236,4,18 ,8 ,514 ,0 ,0 ,2 ,1 ,0 ,0 ,0 ,3 ,0 ,3 ,0 ,3,28348 , 0 
59521.29,7,18 ,16 ,873 ,0 ,0 ,4 ,18 ,0 ,1 ,0 ,23 ,0 ,40 ,0 ,40,44735 , 0 
59521.338,14,18 ,1 ,256 ,0 ,0 ,1 ,0 ,0 ,0 ,0 ,1 ,0 ,37 ,0 ,37,27910 , 0 
59521.35,15,18 ,11 ,1291 ,0 ,0 ,2 ,0 ,0 ,0 ,0 ,2 ,0 ,4 ,0 ,4,34075 , 0 
59521.36,20,18 ,11 ,1265 ,0 ,0 ,2 ,1 ,0 ,0 ,0 ,3 ,0 ,1 ,0 ,1,29508 , 0 
59521.362,16,18 ,2 ,512 ,0 ,0 ,25 ,7 ,8 ,1 ,0 ,41 ,107 ,40 ,8 ,155,63951 , 0 
59521.444,10,18 ,14 ,512 ,0 ,0 ,25 ,0 ,0 ,0 ,0 ,25 ,107 ,0 ,0 ,107,31744 , 0 
59521.482,12,18 ,5 ,864 ,0 ,0 ,1 ,0 ,0 ,0 ,0 ,1 ,0 ,4 ,0 ,4,32488 , 0 
59521.596,9,18 ,5 ,823 ,0 ,0 ,1 ,1 ,0 ,0 ,0 ,2 ,0 ,27 ,0 ,27,55470 , 0 
59521.603,5,18 ,2 ,512 ,0 ,0 ,1 ,12 ,1 ,0 ,0 ,14 ,0 ,22 ,1 ,23,52173 , 0 
59521.606,19,18 ,1 ,256 ,0 ,0 ,0 ,0 ,0 ,0 ,0 ,0 ,0 ,24 ,0 ,24,33546 , 0 
59521.697,17,18 ,6 ,912 ,0 ,0 ,25 ,0 ,10 ,0 ,1 ,36 ,111 ,23 ,11 ,145,41411 , 0 
59521.771,13,18 ,1 ,256 ,0 ,0 ,1 ,0 ,0 ,0 ,0 ,1 ,0 ,18 ,0 ,18,29926 , 0 
59521.787,3,18 ,1 ,256 ,0 ,0 ,2 ,0 ,0 ,0 ,0 ,2 ,0 ,1 ,0 ,1,21116 , 0 
59640.96,8,18 ,1 ,256 ,0 ,0 ,1 ,0 ,0 ,0 ,0 ,1 ,0 ,2 ,0 ,2,25194 , 0 
59641.078,11,18 ,5 ,864 ,0 ,0 ,1 ,3 ,0 ,0 ,1 ,5 ,0 ,13 ,1 ,14,41056 , 0 
59641.124,2,18 ,1 ,256 ,0 ,0 ,24 ,0 ,52 ,1 ,1 ,78 ,94 ,16 ,54 ,164,42248 , 0 
59641.214,18,18 ,19 ,518 ,0 ,0 ,2 ,0 ,1 ,0 ,0 ,3 ,0 ,9 ,1 ,10,33738 , 0 
59641.236,4,18 ,8 ,514 ,0 ,0 ,1 ,0 ,0 ,0 ,0 ,1 ,0 ,3 ,0 ,3,29965 , 0 
59641.27,6,18 ,2 ,512 ,0 ,120 ,0 ,14 ,0 ,1 ,0 ,135 ,0 ,73 ,1 ,74,53528 , 1 
59641.29,7,18 ,16 ,808 ,0 ,0 ,4 ,14 ,1 ,0 ,0 ,19 ,0 ,38 ,1 ,39,44687 , 0 
59641.337,14,18 ,1 ,256 ,0 ,0 ,1 ,0 ,0 ,0 ,0 ,1 ,0 ,39 ,0 ,39,28586 , 0 
59641.35,15,18 ,7 ,1167 ,0 ,0 ,4 ,1 ,0 ,1 ,0 ,6 ,0 ,3 ,0 ,3,36236 , 0 
59641.36,20,18 ,11 ,1265 ,0 ,0 ,1 ,0 ,0 ,0 ,0 ,1 ,0 ,5 ,0 ,5,32627 , 0 
59641.361,16,18 ,2 ,512 ,0 ,0 ,24 ,11 ,27 ,0 ,0 ,62 ,100 ,31 ,27 ,158,59338 , 0 
59641.444,10,18 ,14 ,512 ,0 ,0 ,26 ,0 ,0 ,0 ,0 ,26 ,109 ,0 ,0 ,109,31262 , 0 
59641.482,12,18 ,18 ,904 ,0 ,0 ,5 ,3 ,0 ,1 ,0 ,9 ,0 ,5 ,0 ,5,35690 , 0 
59641.596,9,18 ,16 ,808 ,0 ,0 ,5 ,12 ,0 ,1 ,0 ,18 ,0 ,25 ,0 ,25,53557 , 0 
59641.603,5,18 ,13 ,512 ,0 ,0 ,5 ,2 ,5 ,2 ,3 ,17 ,0 ,19 ,8 ,27,54495 , 0 
59641.606,19,18 ,1 ,256 ,0 ,0 ,2 ,0 ,1 ,0 ,0 ,3 ,0 ,21 ,1 ,22,34858 , 0 
59641.697,17,18 ,6 ,912 ,0 ,0 ,25 ,0 ,0 ,1 ,0 ,26 ,103 ,20 ,0 ,123,40480 , 0 
59641.771,13,18 ,1 ,256 ,0 ,0 ,1 ,0 ,6 ,0 ,1 ,8 ,0 ,20 ,10 ,30,31034 , 0 
59641.787,3,18 ,1 ,256 ,0 ,0 ,1 ,0 ,0 ,0 ,0 ,1 ,0 ,0 ,0 ,0,21807 , 0 
59760.96,8,18 ,1 ,256 ,0 ,0 ,1 ,0 ,0 ,0 ,0 ,1 ,0 ,0 ,0 ,0,24464 , 0 
59761.078,11,18 ,5 ,864 ,0 ,0 ,0 ,0 ,0 ,1 ,0 ,1 ,0 ,8 ,0 ,8,38259 , 0 
59761.124,2,18 ,1 ,256 ,0 ,0 ,26 ,0 ,71 ,0 ,0 ,97 ,106 ,18 ,71 ,195,44671 , 0 
59761.147,6,18 ,2 ,517 ,0 ,120 ,1 ,19 ,0 ,0 ,0 ,140 ,0 ,80 ,0 ,80,62689 , 1 
59761.214,18,18 ,19 ,518 ,0 ,0 ,2 ,0 ,1 ,0 ,0 ,3 ,0 ,1 ,1 ,2,31137 , 0 
59761.236,4,18 ,8 ,514 ,0 ,0 ,1 ,0 ,0 ,0 ,0 ,1 ,0 ,1 ,0 ,1,28430 , 0 
59761.29,7,18 ,16 ,815 ,0 ,0 ,1 ,16 ,0 ,0 ,0 ,17 ,0 ,49 ,0 ,49,44999 , 0 
59761.337,14,18 ,1 ,256 ,0 ,0 ,1 ,0 ,0 ,0 ,0 ,1 ,0 ,38 ,0 ,38,28007 , 0 
59761.35,15,18 ,7 ,1204 ,0 ,0 ,2 ,0 ,0 ,0 ,0 ,2 ,0 ,3 ,0 ,3,34158 , 0 
59761.36,20,18 ,11 ,1265 ,0 ,0 ,1 ,0 ,0 ,0 ,0 ,1 ,0 ,3 ,0 ,3,29582 , 0 
59761.365,16,18 ,2 ,517 ,0 ,0 ,25 ,17 ,35 ,0 ,0 ,77 ,105 ,42 ,35 ,182,64706 , 0 
59761.444,10,18 ,14 ,512 ,0 ,0 ,25 ,0 ,0 ,0 ,0 ,25 ,106 ,1 ,0 ,107,32014 , 0 
59761.482,12,18 ,18 ,891 ,0 ,0 ,4 ,1 ,0 ,0 ,0 ,5 ,0 ,1 ,0 ,1,32584 , 0 
59761.596,9,18 ,16 ,815 ,0 ,0 ,3 ,20 ,0 ,0 ,0 ,23 ,0 ,23 ,0 ,23,55785 , 0 
59761.603,5,18 ,13 ,512 ,0 ,0 ,2 ,0 ,0 ,2 ,0 ,4 ,0 ,26 ,1 ,27,52380 , 0 
59761.606,19,18 ,1 ,256 ,0 ,0 ,1 ,0 ,1 ,0 ,0 ,2 ,0 ,24 ,1 ,25,33635 , 0 
59761.697,17,18 ,6 ,912 ,0 ,0 ,26 ,0 ,0 ,0 ,0 ,26 ,108 ,19 ,0 ,127,41714 , 0 
59761.771,13,18 ,1 ,256 ,0 ,0 ,2 ,0 ,0 ,1 ,0 ,3 ,0 ,23 ,2 ,25,30059 , 0 
59761.787,3,18 ,1 ,256 ,0 ,0 ,1 ,0 ,0 ,0 ,0 ,1 ,0 ,1 ,0 ,1,21186 , 0 
59880.96,8,18 ,1 ,256 ,0 ,0 ,1 ,0 ,0 ,0 ,0 ,1 ,0 ,2 ,0 ,2,25252 , 0 
59881.078,11,18 ,5 ,864 ,0 ,0 ,2 ,0 ,0 ,0 ,0 ,2 ,0 ,3 ,0 ,3,41164 , 0 
59881.124,2,18 ,1 ,256 ,0 ,0 ,5 ,0 ,18 ,0 ,0 ,23 ,1 ,4 ,18 ,23,42383 , 0 
59881.138,6,18 ,2 ,512 ,0 ,0 ,1 ,5 ,0 ,0 ,0 ,6 ,0 ,18 ,0 ,18,53640 , 0 
59881.214,18,18 ,19 ,518 ,0 ,0 ,1 ,0 ,0 ,0 ,0 ,1 ,0 ,3 ,0 ,3,33800 , 0 
59881.236,4,18 ,8 ,512 ,0 ,0 ,2 ,0 ,0 ,0 ,0 ,2 ,0 ,1 ,0 ,1,30026 , 0 
59881.289,7,18 ,16 ,806 ,0 ,0 ,1 ,4 ,0 ,0 ,0 ,5 ,0 ,6 ,0 ,6,44823 , 0 
59881.338,14,18 ,1 ,256 ,0 ,0 ,1 ,0 ,0 ,0 ,0 ,1 ,0 ,12 ,0 ,12,28701 , 0 
59881.35,15,18 ,7 ,1204 ,0 ,0 ,3 ,0 ,0 ,0 ,0 ,3 ,0 ,1 ,0 ,1,36349 , 0 
59881.36,20,18 ,11 ,1265 ,0 ,0 ,2 ,0 ,0 ,0 ,0 ,2 ,0 ,1 ,0 ,1,32699 , 0 
59881.36,16,18 ,2 ,512 ,0 ,0 ,5 ,5 ,8 ,0 ,0 ,18 ,0 ,9 ,8 ,17,59577 , 0 
59881.444,10,18 ,14 ,512 ,0 ,0 ,6 ,0 ,0 ,0 ,0 ,6 ,0 ,0 ,0 ,0,31353 , 0 
59881.482,12,18 ,18 ,891 ,0 ,0 ,2 ,0 ,0 ,0 ,0 ,2 ,0 ,4 ,0 ,4,35783 , 0 
59881.596,9,18 ,16 ,806 ,0 ,0 ,0 ,4 ,0 ,0 ,0 ,4 ,0 ,6 ,0 ,6,53655 , 0 
59881.602,5,18 ,13 ,512 ,0 ,0 ,1 ,0 ,0 ,0 ,0 ,1 ,0 ,8 ,0 ,8,54579 , 0 
59881.606,19,18 ,1 ,256 ,0 ,0 ,1 ,0 ,0 ,0 ,0 ,1 ,0 ,5 ,0 ,5,34944 , 0 
59881.696,17,18 ,6 ,811 ,0 ,0 ,7 ,0 ,0 ,0 ,0 ,7 ,0 ,7 ,0 ,7,40612 , 0 
59881.771,13,18 ,1 ,256 ,0 ,0 ,1 ,0 ,0 ,0 ,0 ,1 ,0 ,4 ,0 ,4,31100 , 0 
59881.787,3,18 ,1 ,256 ,0 ,0 ,1 ,0 ,0 ,0 ,0 ,1 ,0 ,1 ,0 ,1,21862 , 0 
60000.96,8,18 ,1 ,256 ,0 ,0 ,2 ,0 ,0 ,0 ,0 ,2 ,0 ,2 ,0 ,2,24528 , 0 
60001.078,11,18 ,5 ,902 ,0 ,0 ,1 ,1 ,0 ,0 ,0 ,2 ,0 ,5 ,0 ,5,38327 , 0 
60001.123,2,18 ,1 ,256 ,0 ,0 ,2 ,0 ,4 ,0 ,0 ,6 ,0 ,2 ,4 ,6,44751 , 0 
60001.138,6,18 ,2 ,512 ,0 ,0 ,0 ,1 ,0 ,0 ,0 ,1 ,0 ,7 ,0 ,7,62746 , 0 
60001.214,18,18 ,19 ,518 ,0 ,0 ,1 ,0 ,0 ,0 ,0 ,1 ,0 ,2 ,0 ,2,31215 , 0 
60001.236,4,18 ,8 ,512 ,0 ,0 ,1 ,0 ,0 ,0 ,0 ,1 ,0 ,1 ,0 ,1,28535 , 0 
60001.289,7,18 ,16 ,792 ,0 ,0 ,2 ,1 ,1 ,0 ,0 ,4 ,0 ,3 ,1 ,4,45074 , 0 
60001.337,14,18 ,1 ,256 ,0 ,0 ,1 ,0 ,0 ,0 ,0 ,1 ,0 ,4 ,0 ,4,28075 , 0 
60001.35,15,18 ,7 ,1099 ,0 ,0 ,2 ,1 ,0 ,0 ,0 ,3 ,0 ,2 ,0 ,2,34227 , 0 
60001.36,20,18 ,11 ,1265 ,0 ,0 ,2 ,0 ,0 ,0 ,0 ,2 ,0 ,2 ,0 ,2,29658 , 0 
60001.36,16,18 ,2 ,512 ,0 ,0 ,3 ,1 ,2 ,0 ,0 ,6 ,0 ,3 ,2 ,5,64799 , 0 
60001.444,10,18 ,14 ,512 ,0 ,0 ,3 ,0 ,0 ,0 ,0 ,3 ,0 ,0 ,0 ,0,32073 , 0 
60001.482,12,18 ,18 ,891 ,0 ,0 ,1 ,0 ,0 ,0 ,0 ,1 ,0 ,1 ,0 ,1,32669 , 0 
60001.596,9,18 ,16 ,806 ,0 ,0 ,2 ,0 ,0 ,0 ,0 ,2 ,0 ,4 ,0 ,4,55864 , 0 
60001.602,5,18 ,13 ,512 ,0 ,0 ,2 ,0 ,1 ,0 ,0 ,3 ,0 ,5 ,1 ,6,52491 , 0 
60001.606,19,18 ,1 ,256 ,0 ,0 ,1 ,0 ,0 ,0 ,0 ,1 ,0 ,3 ,0 ,3,33722 , 0 
60001.696,17,18 ,6 ,811 ,0 ,0 ,1 ,0 ,0 ,0 ,0 ,1 ,0 ,3 ,0 ,3,41771 , 0 
60001.771,13,18 ,1 ,256 ,0 ,0 ,1 ,0 ,1 ,0 ,0 ,2 ,0 ,5 ,1 ,6,30157 , 0 
60001.787,3,18 ,1 ,256 ,0 ,0 ,2 ,0 ,0 ,0 ,0 ,2 ,0 ,1 ,0 ,1,21245 , 0 
60120.96,8,18 ,1 ,256 ,0 ,0 ,1 ,0 ,0 ,0 ,0 ,1 ,0 ,0 ,0 ,0,25312 , 0 
60121.078,11,18 ,5 ,902 ,0 ,0 ,2 ,0 ,1 ,0 ,0 ,3 ,0 ,1 ,1 ,2,41265 , 0 
60121.123,2,18 ,1 ,256 ,0 ,0 ,0 ,0 ,1 ,0 ,0 ,1 ,0 ,1 ,1 ,2,42482 , 0 
60121.138,6,18 ,2 ,512 ,0 ,0 ,1 ,0 ,0 ,0 ,0 ,1 ,0 ,1 ,0 ,1,53721 , 0 
60121.214,18,18 ,19 ,518 ,0 ,0 ,2 ,0 ,0 ,0 ,0 ,2 ,0 ,1 ,0 ,1,33861 , 0 
60121.236,4,18 ,8 ,512 ,0 ,0 ,1 ,0 ,0 ,0 ,0 ,1 ,0 ,1 ,0 ,1,30080 , 0 
60121.289,7,18 ,16 ,784 ,0 ,0 ,1 ,1 ,0 ,0 ,0 ,2 ,0 ,4 ,0 ,4,44932 , 0 
60121.337,14,18 ,1 ,256 ,0 ,0 ,1 ,0 ,0 ,0 ,0 ,1 ,0 ,1 ,0 ,1,28769 , 0 
60121.35,15,18 ,7 ,1099 ,0 ,0 ,1 ,0 ,0 ,0 ,0 ,1 ,0 ,2 ,0 ,2,36411 , 0 
60121.36,20,18 ,11 ,1323 ,0 ,0 ,1 ,1 ,0 ,0 ,0 ,2 ,0 ,2 ,0 ,2,32809 , 0 
60121.36,16,18 ,2 ,512 ,0 ,0 ,2 ,0 ,1 ,0 ,0 ,3 ,0 ,1 ,1 ,2,59675 , 0 
60121.444,10,18 ,14 ,512 ,0 ,0 ,0 ,0 ,0 ,0 ,0 ,0 ,0 ,1 ,0 ,1,31414 , 0 
60121.482,12,18 ,18 ,858 ,0 ,0 ,1 ,0 ,0 ,0 ,0 ,1 ,0 ,2 ,0 ,2,35845 , 0 
60121.596,9,18 ,16 ,806 ,0 ,0 ,2 ,0 ,0 ,0 ,0 ,2 ,0 ,3 ,0 ,3,53748 , 0 
60121.602,5,18 ,13 ,512 ,0 ,0 ,1 ,0 ,1 ,0 ,0 ,2 ,0 ,3 ,1 ,4,54678 , 0 
60121.606,19,18 ,1 ,256 ,0 ,0 ,1 ,0 ,0 ,0 ,0 ,1 ,0 ,5 ,0 ,5,35020 , 0 
60121.696,17,18 ,6 ,811 ,0 ,0 ,2 ,0 ,0 ,0 ,0 ,2 ,0 ,2 ,0 ,2,40690 , 0 
60121.771,13,18 ,1 ,256 ,0 ,0 ,1 ,0 ,1 ,0 ,0 ,2 ,0 ,0 ,1 ,1,31159 , 0 
60121.787,3,18 ,1 ,256 ,0 ,0 ,0 ,0 ,0 ,0 ,0 ,0 ,0 ,1 ,0 ,1,21924 , 0 
60240.96,8,18 ,1 ,256 ,0 ,0 ,0 ,0 ,0 ,0 ,0 ,0 ,0 ,2 ,0 ,2,24602 , 0 
60241.078,11,18 ,5 ,843 ,0 ,0 ,5 ,4 ,6 ,0 ,0 ,15 ,0 ,19 ,6 ,25,38466 , 0 
60241.124,2,18 ,1 ,256 ,0 ,0 ,10 ,0 ,23 ,1 ,2 ,36 ,0 ,13 ,27 ,40,44923 , 0 
60241.138,6,18 ,2 ,512 ,0 ,0 ,7 ,8 ,10 ,0 ,0 ,25 ,0 ,20 ,10 ,30,63030 , 0 
60241.214,18,18 ,19 ,518 ,0 ,0 ,1 ,0 ,1 ,0 ,0 ,2 ,0 ,5 ,1 ,6,31301 , 0 
60241.236,4,18 ,8 ,512 ,0 ,0 ,1 ,0 ,0 ,0 ,0 ,1 ,0 ,0 ,0 ,0,28601 , 0 
60241.29,7,18 ,17 ,1205 ,0 ,0 ,8 ,4 ,0 ,1 ,0 ,13 ,0 ,22 ,1 ,23,45272 , 0 
60241.338,14,18 ,1 ,256 ,0 ,0 ,1 ,0 ,0 ,0 ,0 ,1 ,0 ,11 ,0 ,11,28153 , 0 
60241.35,15,18 ,11 ,1156 ,0 ,0 ,6 ,3 ,0 ,1 ,0 ,10 ,0 ,17 ,0 ,17,34378 , 0 
60241.36,20,18 ,11 ,1156 ,0 ,0 ,1 ,3 ,0 ,0 ,0 ,4 ,0 ,7 ,0 ,7,29739 , 0 
60241.36,16,18 ,2 ,512 ,0 ,0 ,5 ,6 ,0 ,2 ,2 ,15 ,0 ,32 ,2 ,34,64998 , 1 
60241.444,10,18 ,14 ,512 ,0 ,0 ,3 ,0 ,0 ,0 ,0 ,3 ,0 ,6 ,0 ,6,32165 , 0 
60241.482,12,18 ,18 ,849 ,0 ,0 ,1 ,1 ,0 ,0 ,0 ,2 ,0 ,11 ,0 ,11,32782 , 0 
60241.596,9,18 ,5 ,843 ,0 ,0 ,10 ,4 ,0 ,1 ,0 ,15 ,0 ,24 ,0 ,24,56062 , 0 
60241.603,5,18 ,13 ,512 ,0 ,0 ,5 ,0 ,14 ,0 ,0 ,19 ,0 ,19 ,14 ,33,52687 , 0 
60241.606,19,18 ,1 ,256 ,0 ,0 ,1 ,0 ,1 ,0 ,0 ,2 ,0 ,11 ,1 ,12,33819 , 0 
60241.697,17,18 ,6 ,909 ,0 ,0 ,8 ,6 ,4 ,0 ,0 ,18 ,0 ,15 ,4 ,19,41986 , 0 
60241.772,13,18 ,1 ,256 ,0 ,0 ,1 ,0 ,14 ,0 ,0 ,15 ,0 ,11 ,14 ,25,30250 , 0 
60241.787,3,18 ,1 ,256 ,0 ,0 ,2 ,0 ,0 ,0 ,0 ,2 ,0 ,0 ,0 ,0,21312 , 0 
60360.96,8,18 ,1 ,256 ,0 ,0 ,3 ,0 ,1 ,0 ,0 ,4 ,0 ,0 ,1 ,1,25392 , 0 
60361.078,11,18 ,5 ,802 ,0 ,0 ,2 ,1 ,3 ,0 ,0 ,6 ,0 ,9 ,3 ,12,41356 , 0 
60361.124,2,18 ,1 ,256 ,0 ,0 ,6 ,0 ,19 ,0 ,0 ,25 ,0 ,7 ,19 ,26,42638 , 0 
60361.138,6,18 ,2 ,512 ,0 ,0 ,6 ,6 ,9 ,0 ,0 ,21 ,0 ,11 ,9 ,20,53944 , 0 
60361.214,18,18 ,19 ,518 ,0 ,0 ,1 ,0 ,0 ,0 ,0 ,1 ,0 ,2 ,0 ,2,33929 , 0 
60361.236,4,18 ,8 ,512 ,0 ,0 ,1 ,1 ,0 ,0 ,0 ,2 ,0 ,2 ,0 ,2,30165 , 0 
60361.29,7,18 ,17 ,1096 ,0 ,0 ,7 ,4 ,0 ,0 ,0 ,11 ,0 ,12 ,0 ,12,45053 , 0 
60361.337,14,18 ,1 ,256 ,0 ,0 ,1 ,0 ,0 ,0 ,0 ,1 ,0 ,6 ,0 ,6,28835 , 0 
60361.35,15,18 ,11 ,1138 ,0 ,0 ,2 ,1 ,0 ,0 ,0 ,3 ,0 ,10 ,0 ,10,36509 , 0 
60361.36,20,18 ,11 ,1130 ,0 ,0 ,1 ,2 ,0 ,0 ,0 ,3 ,0 ,4 ,0 ,4,32873 , 0 
60361.36,16,18 ,2 ,512 ,0 ,0 ,2 ,4 ,0 ,0 ,0 ,6 ,0 ,23 ,0 ,23,59784 , 1 
60361.444,10,18 ,14 ,512 ,0 ,0 ,1 ,0 ,0 ,0 ,0 ,1 ,0 ,4 ,0 ,4,31488 , 0 
60361.482,12,18 ,18 ,849 ,0 ,0 ,2 ,0 ,0 ,0 ,0 ,2 ,0 ,2 ,0 ,2,35918 , 0 
60361.596,9,18 ,5 ,843 ,0 ,0 ,7 ,0 ,0 ,0 ,0 ,7 ,0 ,8 ,0 ,8,53881 , 0 
60361.603,5,18 ,13 ,512 ,0 ,0 ,3 ,0 ,4 ,0 ,0 ,7 ,0 ,13 ,4 ,17,54789 , 0 
60361.606,19,18 ,1 ,256 ,0 ,0 ,0 ,0 ,0 ,0 ,0 ,0 ,0 ,8 ,0 ,8,35101 , 0 
60361.697,17,18 ,6 ,804 ,0 ,0 ,6 ,5 ,4 ,0 ,0 ,15 ,0 ,10 ,4 ,14,40845 , 0 
60361.771,13,18 ,1 ,256 ,0 ,0 ,1 ,0 ,4 ,0 ,0 ,5 ,0 ,6 ,4 ,10,31263 , 0 
60361.787,3,18 ,1 ,256 ,0 ,0 ,0 ,0 ,0 ,0 ,0 ,0 ,0 ,2 ,0 ,2,21975 , 0 
60480.96,8,18 ,1 ,256 ,0 ,0 ,2 ,0 ,0 ,0 ,0 ,2 ,0 ,0 ,0 ,0,24673 , 0 
60481.078,11,18 ,5 ,802 ,0 ,0 ,3 ,0 ,3 ,0 ,0 ,6 ,0 ,6 ,3 ,9,38567 , 0 
60481.124,2,18 ,1 ,256 ,0 ,0 ,5 ,0 ,17 ,0 ,0 ,22 ,0 ,6 ,17 ,23,45067 , 0 
60481.138,6,18 ,2 ,512 ,0 ,0 ,5 ,3 ,11 ,0 ,0 ,19 ,0 ,12 ,11 ,23,63247 , 0 
60481.214,18,18 ,19 ,518 ,0 ,0 ,2 ,0 ,0 ,0 ,0 ,2 ,0 ,3 ,0 ,3,31374 , 0 
60481.236,4,18 ,8 ,512 ,0 ,0 ,2 ,0 ,0 ,0 ,0 ,2 ,0 ,0 ,0 ,0,28674 , 0 
60481.29,7,18 ,17 ,1101 ,0 ,0 ,4 ,7 ,0 ,0 ,0 ,11 ,0 ,14 ,0 ,14,45395 , 0 
60481.337,14,18 ,1 ,256 ,0 ,0 ,1 ,0 ,0 ,0 ,0 ,1 ,0 ,5 ,0 ,5,28258 , 0 
60481.35,15,18 ,11 ,1091 ,0 ,0 ,2 ,2 ,0 ,0 ,0 ,4 ,0 ,9 ,0 ,9,34460 , 0 
60481.36,20,18 ,11 ,1100 ,0 ,0 ,2 ,1 ,0 ,0 ,0 ,3 ,0 ,2 ,0 ,2,29835 , 0 
60481.36,16,18 ,2 ,512 ,0 ,0 ,2 ,3 ,0 ,0 ,0 ,5 ,0 ,23 ,0 ,23,65137 , 1 
60481.444,10,18 ,14 ,512 ,0 ,0 ,1 ,0 ,0 ,0 ,0 ,1 ,0 ,5 ,0 ,5,32239 , 0 
60481.482,12,18 ,18 ,822 ,0 ,0 ,2 ,0 ,0 ,0 ,0 ,2 ,0 ,3 ,0 ,3,32859 , 0 
60481.596,9,18 ,5 ,843 ,0 ,0 ,5 ,0 ,0 ,0 ,0 ,5 ,0 ,7 ,0 ,7,56158 , 0 
60481.603,5,18 ,13 ,512 ,0 ,0 ,1 ,0 ,3 ,0 ,0 ,4 ,0 ,11 ,3 ,14,52809 , 0 
60481.606,19,18 ,1 ,256 ,0 ,0 ,1 ,0 ,0 ,0 ,0 ,1 ,0 ,9 ,0 ,9,33915 , 0 
60481.697,17,18 ,6 ,831 ,0 ,0 ,7 ,4 ,7 ,0 ,0 ,18 ,0 ,10 ,7 ,17,42149 , 0 
60481.771,13,18 ,1 ,256 ,0 ,0 ,1 ,0 ,3 ,0 ,0 ,4 ,0 ,5 ,3 ,8,30333 , 0 
60481.787,3,18 ,1 ,256 ,0 ,0 ,1 ,0 ,0 ,0 ,0 ,1 ,0 ,2 ,0 ,2,21375 , 0 
60600.96,8,18 ,1 ,256 ,0 ,0 ,0 ,0 ,0 ,0 ,0 ,0 ,0 ,3 ,0 ,3,25458 , 0 
60601.078,11,18 ,5 ,786 ,0 ,0 ,1 ,0 ,1 ,0 ,0 ,2 ,0 ,3 ,1 ,4,41424 , 0 
60601.123,2,18 ,1 ,256 ,0 ,0 ,1 ,0 ,7 ,0 ,1 ,9 ,0 ,7 ,8 ,15,42737 , 0 
60601.138,6,18 ,2 ,512 ,0 ,0 ,3 ,1 ,4 ,0 ,1 ,9 ,0 ,5 ,5 ,10,54080 , 0 
60601.214,18,18 ,19 ,518 ,0 ,0 ,1 ,0 ,0 ,0 ,0 ,1 ,0 ,3 ,0 ,3,34000 , 0 
60601.236,4,18 ,8 ,512 ,0 ,0 ,3 ,0 ,0 ,0 ,0 ,3 ,0 ,0 ,0 ,0,30249 , 0 
60601.289,7,18 ,16 ,791 ,0 ,0 ,5 ,3 ,0 ,1 ,0 ,9 ,0 ,4 ,0 ,4,45208 , 0 
60601.337,14,18 ,1 ,256 ,0 ,0 ,1 ,0 ,0 ,0 ,0 ,1 ,0 ,1 ,0 ,1,28900 , 0 
60601.35,15,18 ,11 ,1087 ,0 ,0 ,1 ,0 ,0 ,0 ,0 ,1 ,0 ,6 ,0 ,6,36578 , 0 
60601.36,20,18 ,11 ,1087 ,0 ,0 ,0 ,1 ,0 ,0 ,0 ,1 ,0 ,2 ,0 ,2,32926 , 0 
60601.36,16,18 ,2 ,512 ,0 ,0 ,2 ,1 ,1 ,0 ,0 ,4 ,0 ,13 ,1 ,14,59901 , 0 
60601.444,10,18 ,14 ,512 ,0 ,0 ,2 ,0 ,0 ,0 ,0 ,2 ,0 ,2 ,0 ,2,31556 , 0 
60601.482,12,18 ,18 ,822 ,0 ,0 ,2 ,0 ,0 ,0 ,0 ,2 ,0 ,2 ,0 ,2,36008 , 0 
60601.596,9,18 ,5 ,786 ,0 ,0 ,2 ,1 ,0 ,0 ,0 ,3 ,0 ,10 ,0 ,10,53982 , 0 
60601.602,5,18 ,13 ,512 ,0 ,0 ,2 ,0 ,2 ,0 ,0 ,4 ,0 ,5 ,2 ,7,54894 , 0 
60601.606,19,18 ,1 ,256 ,0 ,0 ,1 ,0 ,0 ,0 ,0 ,1 ,0 ,2 ,0 ,2,35176 , 0 
60601.696,17,18 ,6 ,804 ,0 ,0 ,4 ,2 ,2 ,0 ,1 ,9 ,0 ,7 ,3 ,10,40975 , 0 
60601.771,13,18 ,1 ,256 ,0 ,0 ,1 ,0 ,2 ,0 ,0 ,3 ,0 ,1 ,2 ,3,31323 , 0 
60601.787,3,18 ,1 ,256 ,0 ,0 ,1 ,0 ,0 ,0 ,0 ,1 ,0 ,0 ,0 ,0,22035 , 0 
60720.96,8,18 ,1 ,256 ,0 ,0 ,1 ,0 ,0 ,0 ,0 ,1 ,0 ,1 ,0 ,1,24743 , 0 
60721.078,11,18 ,5 ,786 ,0 ,0 ,2 ,0 ,0 ,0 ,0 ,2 ,0 ,3 ,0 ,3,38645 , 0 
60721.123,2,18 ,1 ,256 ,0 ,0 ,3 ,0 ,4 ,0 ,0 ,7 ,0 ,0 ,5 ,5,45160 , 0 
60721.138,6,18 ,2 ,512 ,0 ,0 ,1 ,1 ,1 ,1 ,0 ,4 ,0 ,3 ,2 ,5,63351 , 0 
60721.214,18,18 ,19 ,518 ,0 ,0 ,0 ,0 ,0 ,0 ,0 ,0 ,0 ,1 ,0 ,1,31446 , 0 
60721.236,4,18 ,8 ,512 ,0 ,0 ,1 ,0 ,0 ,0 ,0 ,1 ,0 ,1 ,0 ,1,28757 , 0 
60721.289,7,18 ,16 ,791 ,0 ,0 ,3 ,0 ,0 ,0 ,0 ,3 ,0 ,3 ,0 ,3,45476 , 0 
60721.337,14,18 ,1 ,256 ,0 ,0 ,1 ,0 ,0 ,0 ,0 ,1 ,0 ,3 ,0 ,3,28316 , 0 
60721.35,15,18 ,11 ,1087 ,0 ,0 ,2 ,0 ,0 ,0 ,0 ,2 ,0 ,5 ,0 ,5,34548 , 0 
60721.36,20,18 ,11 ,1087 ,0 ,0 ,2 ,0 ,0 ,0 ,0 ,2 ,0 ,0 ,0 ,0,29893 , 0 
60721.36,16,18 ,2 ,512 ,0 ,0 ,1 ,2 ,0 ,0 ,0 ,3 ,0 ,6 ,0 ,6,65214 , 0 
60721.444,10,18 ,14 ,512 ,0 ,0 ,1 ,0 ,0 ,0 ,0 ,1 ,0 ,0 ,0 ,0,32296 , 0 
60721.482,12,18 ,18 ,822 ,0 ,0 ,0 ,0 ,0 ,0 ,0 ,0 ,0 ,2 ,0 ,2,32923 , 0 
60721.596,9,18 ,5 ,786 ,0 ,0 ,2 ,0 ,0 ,0 ,0 ,2 ,0 ,4 ,0 ,4,56256 , 0 
60721.602,5,18 ,13 ,512 ,0 ,0 ,1 ,1 ,0 ,0 ,0 ,2 ,0 ,4 ,0 ,4,52894 , 0 
60721.606,19,18 ,1 ,256 ,0 ,0 ,1 ,0 ,0 ,0 ,0 ,1 ,0 ,2 ,0 ,2,33998 , 0 
60721.696,17,18 ,6 ,800 ,0 ,0 ,1 ,1 ,0 ,1 ,0 ,3 ,0 ,4 ,0 ,4,42227 , 0 
60721.771,13,18 ,1 ,256 ,0 ,0 ,1 ,0 ,1 ,0 ,0 ,2 ,0 ,2 ,1 ,3,30402 , 0 
60721.787,3,18 ,1 ,256 ,0 ,0 ,1 ,0 ,0 ,0 ,0 ,1 ,0 ,0 ,0 ,0,21434 , 0 
60840.96,8,18 ,1 ,256 ,0 ,0 ,1 ,0 ,0 ,0 ,0 ,1 ,0 ,1 ,0 ,1,25516 , 0 
60841.078,11,18 ,5 ,786 ,0 ,0 ,1 ,0 ,1 ,0 ,0 ,2 ,0 ,1 ,1 ,2,41493 , 0 
60841.123,2,18 ,1 ,256 ,0 ,0 ,2 ,0 ,2 ,0 ,0 ,4 ,0 ,3 ,2 ,5,42834 , 0 
60841.138,6,18 ,2 ,512 ,0 ,0 ,2 ,1 ,1 ,0 ,0 ,4 ,0 ,4 ,1 ,5,54170 , 0 
60841.214,18,18 ,19 ,518 ,0 ,0 ,2 ,0 ,0 ,0 ,0 ,2 ,0 ,1 ,0 ,1,34068 , 0 
60841.236,4,18 ,8 ,512 ,0 ,0 ,1 ,0 ,0 ,0 ,0 ,1 ,0 ,1 ,0 ,1,30316 , 0 
60841.289,7,18 ,16 ,791 ,0 ,0 ,2 ,0 ,0 ,0 ,0 ,2 ,0 ,3 ,0 ,3,45274 , 0 
60841.337,14,18 ,1 ,256 ,0 ,0 ,1 ,0 ,0 ,0 ,0 ,1 ,0 ,3 ,0 ,3,28977 , 0 
60841.35,15,18 ,11 ,1065 ,0 ,0 ,1 ,1 ,0 ,0 ,0 ,2 ,0 ,3 ,0 ,3,36652 , 0 
60841.36,20,18 ,11 ,1087 ,0 ,0 ,1 ,0 ,0 ,0 ,0 ,1 ,0 ,2 ,0 ,2,33015 , 0 
60841.36,16,18 ,2 ,512 ,0 ,0 ,1 ,0 ,0 ,0 ,0 ,1 ,0 ,6 ,0 ,6,59985 , 0 
60841.444,10,18 ,14 ,512 ,0 ,0 ,2 ,0 ,0 ,0 ,0 ,2 ,0 ,2 ,0 ,2,31643 , 0 
60841.482,12,18 ,18 ,804 ,0 ,0 ,2 ,0 ,0 ,0 ,0 ,2 ,0 ,2 ,0 ,2,36088 , 0 
60841.596,9,18 ,5 ,786 ,0 ,0 ,2 ,0 ,0 ,0 ,0 ,2 ,0 ,3 ,0 ,3,54053 , 0 
60841.602,5,18 ,13 ,512 ,0 ,0 ,1 ,0 ,1 ,0 ,0 ,2 ,0 ,3 ,1 ,4,54981 , 0 
60841.606,19,18 ,1 ,256 ,0 ,0 ,2 ,0 ,0 ,0 ,0 ,2 ,0 ,1 ,0 ,1,35270 , 0 
60841.696,17,18 ,6 ,785 ,0 ,0 ,2 ,1 ,0 ,0 ,0 ,3 ,0 ,2 ,0 ,2,41047 , 0 
60841.771,13,18 ,1 ,256 ,0 ,0 ,2 ,0 ,1 ,0 ,0 ,3 ,0 ,2 ,1 ,3,31415 , 0 
60841.787,3,18 ,1 ,256 ,0 ,0 ,1 ,0 ,0 ,0 ,0 ,1 ,0 ,1 ,0 ,1,22094 , 0 
60960.96,8,18 ,1 ,256 ,0 ,0 ,2 ,0 ,0 ,0 ,0 ,2 ,0 ,0 ,0 ,0,24817 , 0 
60961.078,11,18 ,5 ,786 ,0 ,0 ,1 ,0 ,0 ,0 ,0 ,1 ,0 ,0 ,0 ,0,38706 , 0 
60961.123,2,18 ,1 ,256 ,0 ,0 ,1 ,0 ,1 ,0 ,1 ,3 ,0 ,1 ,3 ,4,45243 , 0 
60961.138,6,18 ,2 ,512 ,0 ,0 ,1 ,0 ,1 ,0 ,0 ,2 ,0 ,0 ,1 ,1,63430 , 0 
60961.214,18,18 ,19 ,518 ,0 ,0 ,0 ,0 ,0 ,0 ,0 ,0 ,0 ,0 ,0 ,0,31507 , 0 
60961.236,4,18 ,8 ,512 ,0 ,0 ,1 ,0 ,0 ,0 ,0 ,1 ,0 ,1 ,0 ,1,28816 , 0 
60961.289,7,18 ,17 ,1051 ,0 ,0 ,4 ,1 ,0 ,1 ,0 ,6 ,0 ,3 ,0 ,3,45585 , 0 
60961.337,14,18 ,1 ,256 ,0 ,0 ,1 ,0 ,0 ,0 ,0 ,1 ,0 ,2 ,0 ,2,28399 , 0 
60961.35,15,18 ,11 ,1065 ,0 ,0 ,1 ,0 ,0 ,0 ,0 ,1 ,0 ,4 ,0 ,4,34602 , 0 
60961.36,20,18 ,11 ,1087 ,0 ,0 ,0 ,0 ,0 ,0 ,0 ,0 ,0 ,0 ,0 ,0,29944 , 0 
60961.36,16,18 ,2 ,512 ,0 ,0 ,1 ,0 ,0 ,1 ,1 ,3 ,0 ,5 ,1 ,6,65318 , 1 
60961.444,10,18 ,14 ,512 ,0 ,0 ,0 ,0 ,0 ,0 ,0 ,0 ,0 ,0 ,0 ,0,32345 , 0 
60961.482,12,18 ,18 ,804 ,0 ,0 ,0 ,0 ,0 ,0 ,0 ,0 ,0 ,1 ,0 ,1,32982 , 0 
60961.596,9,18 ,5 ,786 ,0 ,0 ,1 ,0 ,0 ,0 ,0 ,1 ,0 ,3 ,0 ,3,56339 , 0 
60961.602,5,18 ,13 ,512 ,0 ,0 ,1 ,0 ,0 ,0 ,0 ,1 ,0 ,2 ,0 ,2,52993 , 0 
60961.606,19,18 ,1 ,256 ,0 ,0 ,1 ,0 ,0 ,0 ,0 ,1 ,0 ,1 ,0 ,1,34080 , 0 
60961.696,17,18 ,6 ,785 ,0 ,0 ,1 ,0 ,1 ,0 ,0 ,2 ,0 ,3 ,1 ,4,42310 , 0 
60961.771,13,18 ,1 ,256 ,0 ,0 ,1 ,0 ,0 ,0 ,0 ,1 ,0 ,1 ,0 ,1,30480 , 0 
60961.787,3,18 ,1 ,256 ,0 ,0 ,1 ,0 ,0 ,0 ,0 ,1 ,0 ,1 ,0 ,1,21502 , 0 
61080.96,8,18 ,1 ,256 ,0 ,0 ,0 ,0 ,0 ,0 ,0 ,0 ,0 ,0 ,0 ,0,25573 , 0 
61081.078,11,18 ,5 ,775 ,0 ,0 ,2 ,1 ,1 ,0 ,0 ,4 ,0 ,4 ,1 ,5,41575 , 0 
61081.123,2,18 ,1 ,256 ,0 ,0 ,1 ,0 ,1 ,0 ,0 ,2 ,0 ,3 ,1 ,4,42926 , 0 
61081.138,6,18 ,2 ,512 ,0 ,0 ,1 ,0 ,0 ,0 ,0 ,1 ,0 ,0 ,0 ,0,54248 , 0 
61081.214,18,18 ,19 ,518 ,0 ,0 ,1 ,0 ,0 ,0 ,0 ,1 ,0 ,3 ,0 ,3,34139 , 0 
61081.236,4,18 ,8 ,512 ,0 ,0 ,1 ,0 ,0 ,0 ,0 ,1 ,0 ,1 ,0 ,1,30395 , 0 
61081.289,7,18 ,17 ,1051 ,0 ,0 ,2 ,0 ,0 ,0 ,0 ,2 ,0 ,1 ,0 ,1,45339 , 0 
61081.337,14,18 ,1 ,256 ,0 ,0 ,1 ,0 ,0 ,0 ,0 ,1 ,0 ,2 ,0 ,2,29037 , 0 
61081.35,15,18 ,11 ,1060 ,0 ,0 ,2 ,0 ,0 ,0 ,0 ,2 ,0 ,4 ,0 ,4,36723 , 0 
61081.36,20,18 ,11 ,1060 ,0 ,0 ,2 ,1 ,0 ,0 ,0 ,3 ,0 ,2 ,0 ,2,33080 , 0 
61081.36,16,18 ,2 ,512 ,0 ,0 ,1 ,1 ,0 ,0 ,0 ,2 ,0 ,4 ,0 ,4,60051 , 1 
61081.444,10,18 ,14 ,512 ,0 ,0 ,1 ,0 ,0 ,0 ,0 ,1 ,0 ,1 ,0 ,1,31698 , 0 
61081.482,12,18 ,18 ,804 ,0 ,0 ,1 ,0 ,0 ,0 ,0 ,1 ,0 ,2 ,0 ,2,36155 , 0 
61081.596,9,18 ,5 ,775 ,0 ,0 ,1 ,1 ,0 ,0 ,0 ,2 ,0 ,7 ,0 ,7,54137 , 0 
61081.602,5,18 ,13 ,512 ,0 ,0 ,2 ,0 ,3 ,0 ,0 ,5 ,0 ,5 ,3 ,8,55099 , 0 
61081.606,19,18 ,1 ,256 ,0 ,0 ,1 ,0 ,0 ,0 ,0 ,1 ,0 ,2 ,0 ,2,35345 , 0 
61081.696,17,18 ,6 ,785 ,0 ,0 ,1 ,0 ,0 ,0 ,0 ,1 ,0 ,2 ,0 ,2,41114 , 0 
61081.771,13,18 ,1 ,256 ,0 ,0 ,1 ,0 ,3 ,0 ,0 ,4 ,0 ,1 ,3 ,4,31487 , 0 
61081.787,3,18 ,1 ,256 ,0 ,0 ,1 ,0 ,0 ,0 ,0 ,1 ,0 ,0 ,0 ,0,22143 , 0 
61200.96,8,18 ,1 ,256 ,0 ,0 ,2 ,0 ,0 ,0 ,0 ,2 ,0 ,3 ,0 ,3,24890 , 0 
61201.078,11,18 ,5 ,775 ,0 ,0 ,1 ,0 ,0 ,0 ,0 ,1 ,0 ,5 ,0 ,5,38781 , 0 
61201.123,2,18 ,1 ,256 ,0 ,0 ,1 ,0 ,1 ,0 ,0 ,2 ,0 ,3 ,1 ,4,45332 , 0 
61201.138,6,18 ,2 ,512 ,0 ,0 ,1 ,0 ,1 ,0 ,0 ,2 ,0 ,2 ,1 ,3,63495 , 0 
61201.214,18,18 ,19 ,517 ,0 ,0 ,2 ,1 ,1 ,0 ,0 ,4 ,0 ,2 ,1 ,3,31587 , 0 
61201.236,4,18 ,8 ,512 ,0 ,0 ,1 ,0 ,0 ,0 ,0 ,1 ,0 ,4 ,0 ,4,28874 , 0 
61201.289,7,18 ,17 ,1048 ,0 ,0 ,2 ,1 ,0 ,0 ,0 ,3 ,0 ,5 ,0 ,5,45663 , 0 
61201.337,14,18 ,1 ,256 ,0 ,0 ,2 ,0 ,0 ,0 ,0 ,2 ,0 ,1 ,0 ,1,28482 , 0 
61201.35,15,18 ,11 ,1060 ,0 ,0 ,1 ,0 ,0 ,0 ,0 ,1 ,0 ,2 ,0 ,2,34677 , 0 
61201.36,20,18 ,11 ,1060 ,0 ,0 ,1 ,0 ,0 ,0 ,0 ,1 ,0 ,2 ,0 ,2,30000 , 0 
61201.36,16,18 ,2 ,512 ,0 ,0 ,3 ,0 ,0 ,0 ,0 ,3 ,0 ,3 ,0 ,3,65408 , 1 
61201.444,10,18 ,14 ,512 ,0 ,0 ,1 ,0 ,0 ,0 ,0 ,1 ,0 ,0 ,0 ,0,32404 , 0 
61201.482,12,18 ,18 ,794 ,0 ,0 ,2 ,1 ,0 ,0 ,0 ,3 ,0 ,2 ,0 ,2,33063 , 0 
61201.596,9,18 ,5 ,775 ,0 ,0 ,2 ,0 ,0 ,0 ,0 ,2 ,0 ,3 ,0 ,3,56425 , 0 
61201.602,5,18 ,13 ,512 ,0 ,0 ,1 ,0 ,0 ,0 ,0 ,1 ,0 ,6 ,0 ,6,53060 , 0 
61201.606,19,18 ,1 ,256 ,0 ,0 ,2 ,0 ,2 ,0 ,0 ,4 ,0 ,4 ,2 ,6,34189 , 0 
61201.696,17,18 ,6 ,785 ,0 ,0 ,1 ,0 ,1 ,0 ,0 ,2 ,0 ,3 ,1 ,4,42368 , 0 
61201.771,13,18 ,1 ,256 ,0 ,0 ,2 ,0 ,0 ,0 ,0 ,2 ,0 ,3 ,0 ,3,30576 , 0 
61201.787,3,18 ,1 ,256 ,0 ,0 ,1 ,0 ,0 ,0 ,0 ,1 ,0 ,2 ,0 ,2,21562 , 0 
61320.96,8,18 ,1 ,256 ,0 ,0 ,2 ,0 ,0 ,0 ,0 ,2 ,0 ,0 ,0 ,0,25645 , 0 
61321.078,11,18 ,5 ,775 ,0 ,0 ,0 ,0 ,0 ,1 ,1 ,2 ,0 ,4 ,1 ,5,41638 , 0 
61321.123,2,18 ,1 ,256 ,0 ,0 ,2 ,0 ,4 ,0 ,0 ,6 ,0 ,2 ,4 ,6,43005 , 0 
61321.138,6,18 ,2 ,512 ,0 ,0 ,2 ,1 ,3 ,0 ,0 ,6 ,0 ,3 ,3 ,6,54373 , 0 
61321.214,18,18 ,19 ,517 ,0 ,0 ,1 ,0 ,1 ,0 ,0 ,2 ,0 ,1 ,1 ,2,34221 , 0 
61321.236,4,18 ,8 ,512 ,0 ,0 ,1 ,0 ,0 ,0 ,0 ,1 ,0 ,1 ,0 ,1,30477 , 0 
61321.289,7,18 ,17 ,1034 ,0 ,0 ,2 ,1 ,0 ,0 ,0 ,3 ,0 ,1 ,0 ,1,45440 , 0 
61321.337,14,18 ,1 ,256 ,0 ,0 ,1 ,0 ,1 ,0 ,0 ,2 ,0 ,2 ,1 ,3,29114 , 0 
61321.35,15,18 ,11 ,1060 ,0 ,0 ,0 ,0 ,0 ,0 ,0 ,0 ,0 ,0 ,0 ,0,36779 , 0 
61321.36,20,18 ,5 ,773 ,0 ,0 ,5 ,1 ,0 ,1 ,0 ,7 ,0 ,1 ,0 ,1,33188 , 0 
61321.36,16,18 ,2 ,512 ,0 ,0 ,1 ,0 ,0 ,0 ,0 ,1 ,0 ,4 ,0 ,4,60142 , 0 
61321.444,10,18 ,14 ,512 ,0 ,0 ,1 ,1 ,0 ,0 ,0 ,2 ,0 ,2 ,0 ,2,31774 , 0 
61321.482,12,18 ,18 ,791 ,0 ,0 ,2 ,1 ,0 ,0 ,0 ,3 ,0 ,5 ,0 ,5,36242 , 0 
61321.596,9,18 ,5 ,775 ,0 ,0 ,1 ,0 ,0 ,0 ,0 ,1 ,0 ,1 ,0 ,1,54222 , 0 
61321.603,5,18 ,13 ,512 ,0 ,0 ,1 ,0 ,1 ,0 ,1 ,3 ,0 ,8 ,3 ,11,55230 , 0 
61321.606,19,18 ,1 ,256 ,0 ,0 ,1 ,0 ,1 ,0 ,0 ,2 ,0 ,3 ,1 ,4,35430 , 0 
61321.696,17,18 ,6 ,774 ,0 ,0 ,2 ,2 ,1 ,0 ,0 ,5 ,0 ,2 ,1 ,3,41215 , 0 
61321.771,13,18 ,1 ,256 ,0 ,0 ,0 ,0 ,1 ,0 ,1 ,2 ,0 ,2 ,2 ,4,31561 , 0 
61321.786,3,18 ,1 ,256 ,0 ,0 ,1 ,0 ,0 ,0 ,0 ,1 ,0 ,2 ,0 ,2,22218 , 0 
61440.96,8,18 ,1 ,256 ,0 ,0 ,0 ,0 ,0 ,0 ,0 ,0 ,0 ,2 ,0 ,2,24943 , 0 
61441.078,11,18 ,5 ,775 ,0 ,0 ,1 ,0 ,0 ,0 ,0 ,1 ,0 ,2 ,0 ,2,38841 , 0 
61441.123,2,18 ,1 ,256 ,0 ,0 ,1 ,0 ,0 ,0 ,0 ,1 ,0 ,4 ,0 ,4,45425 , 0 
61441.138,6,18 ,2 ,512 ,0 ,0 ,1 ,0 ,0 ,0 ,0 ,1 ,0 ,2 ,0 ,2,63574 , 0 
61441.214,18,18 ,19 ,517 ,0 ,0 ,2 ,0 ,0 ,0 ,0 ,2 ,0 ,0 ,0 ,0,31659 , 0 
61441.236,4,18 ,8 ,512 ,0 ,0 ,0 ,0 ,0 ,0 ,0 ,0 ,0 ,0 ,0 ,0,28924 , 0 
61441.289,7,18 ,17 ,1053 ,0 ,0 ,1 ,0 ,0 ,0 ,0 ,1 ,0 ,1 ,0 ,1,45725 , 0 
61441.337,14,18 ,1 ,256 ,0 ,0 ,1 ,0 ,0 ,0 ,0 ,1 ,0 ,4 ,0 ,4,28557 , 0 
61441.35,15,18 ,11 ,1060 ,0 ,0 ,1 ,0 ,0 ,0 ,0 ,1 ,0 ,1 ,0 ,1,34742 , 0 
61441.36,20,18 ,5 ,773 ,0 ,0 ,2 ,0 ,0 ,0 ,0 ,2 ,0 ,1 ,0 ,1,30064 , 0 
61441.36,16,18 ,2 ,512 ,0 ,0 ,1 ,0 ,0 ,0 ,0 ,1 ,0 ,3 ,0 ,3,65484 , 0 
61441.444,10,18 ,14 ,512 ,0 ,0 ,2 ,0 ,0 ,0 ,0 ,2 ,0 ,0 ,0 ,0,32464 , 0 
61441.482,12,18 ,18 ,791 ,0 ,0 ,0 ,0 ,0 ,0 ,0 ,0 ,0 ,2 ,0 ,2,33116 , 0 
61441.596,9,18 ,5 ,775 ,0 ,0 ,1 ,0 ,0 ,0 ,0 ,1 ,0 ,2 ,0 ,2,56506 , 0 
61441.602,5,18 ,13 ,512 ,0 ,0 ,1 ,0 ,0 ,0 ,0 ,1 ,0 ,2 ,0 ,2,53148 , 0 
61441.606,19,18 ,1 ,256 ,0 ,0 ,1 ,0 ,0 ,0 ,0 ,1 ,0 ,2 ,0 ,2,34251 , 0 
61441.696,17,18 ,6 ,774 ,0 ,0 ,1 ,0 ,0 ,0 ,0 ,1 ,0 ,1 ,0 ,1,42435 , 0 
61441.771,13,18 ,1 ,256 ,0 ,0 ,2 ,0 ,0 ,0 ,0 ,2 ,0 ,1 ,0 ,1,30645 , 0 
61441.787,3,18 ,1 ,256 ,0 ,0 ,3 ,0 ,0 ,0 ,0 ,3 ,0 ,0 ,0 ,0,21622 , 0 
61560.96,8,18 ,1 ,256 ,0 ,0 ,2 ,0 ,1 ,0 ,0 ,3 ,0 ,1 ,1 ,2,25716 , 0 
61561.078,11,18 ,5 ,775 ,0 ,0 ,1 ,0 ,0 ,0 ,0 ,1 ,0 ,4 ,0 ,4,41716 , 0 
61561.123,2,18 ,1 ,256 ,0 ,0 ,1 ,0 ,1 ,0 ,1 ,3 ,0 ,0 ,3 ,3,43080 , 0 
61561.138,6,18 ,2 ,512 ,0 ,0 ,1 ,0 ,0 ,1 ,1 ,3 ,0 ,1 ,2 ,3,54455 , 0 
61561.214,18,18 ,19 ,517 ,0 ,0 ,1 ,0 ,0 ,0 ,0 ,1 ,0 ,1 ,0 ,1,34293 , 0 
61561.236,4,18 ,8 ,512 ,0 ,0 ,2 ,1 ,0 ,0 ,0 ,3 ,0 ,1 ,0 ,1,30553 , 0 
61561.289,7,18 ,16 ,771 ,0 ,0 ,5 ,1 ,0 ,1 ,0 ,7 ,0 ,2 ,0 ,2,45536 , 0 
61561.337,14,18 ,1 ,256 ,0 ,0 ,1 ,0 ,0 ,0 ,0 ,1 ,0 ,1 ,0 ,1,29174 , 0 
61561.35,15,18 ,11 ,1060 ,0 ,0 ,1 ,0 ,0 ,0 ,0 ,1 ,0 ,5 ,0 ,5,36855 , 0 
61561.36,20,18 ,5 ,773 ,0 ,0 ,3 ,0 ,0 ,0 ,0 ,3 ,0 ,0 ,0 ,0,33262 , 0 
61561.36,16,18 ,2 ,512 ,0 ,0 ,2 ,0 ,1 ,0 ,0 ,3 ,0 ,5 ,1 ,6,60214 , 0 
61561.444,10,18 ,14 ,512 ,0 ,0 ,1 ,0 ,0 ,0 ,0 ,1 ,0 ,1 ,0 ,1,31829 , 0 
61561.482,12,18 ,18 ,783 ,0 ,0 ,1 ,0 ,0 ,0 ,0 ,1 ,0 ,4 ,0 ,4,36338 , 0 
61561.596,9,18 ,5 ,775 ,0 ,0 ,1 ,0 ,0 ,0 ,0 ,1 ,0 ,5 ,0 ,5,54302 , 0 
61561.602,5,18 ,13 ,512 ,0 ,0 ,1 ,0 ,0 ,0 ,0 ,1 ,0 ,3 ,0 ,3,55324 , 0 
61561.606,19,18 ,1 ,256 ,0 ,0 ,1 ,0 ,0 ,0 ,0 ,1 ,0 ,2 ,0 ,2,35537 , 0 
61561.696,17,18 ,6 ,774 ,0 ,0 ,2 ,0 ,0 ,1 ,1 ,4 ,0 ,4 ,1 ,5,41290 , 0 
61561.771,13,18 ,1 ,256 ,0 ,0 ,1 ,0 ,0 ,0 ,0 ,1 ,0 ,1 ,0 ,1,31618 , 0 
61561.787,3,18 ,1 ,256 ,0 ,0 ,0 ,0 ,0 ,0 ,0 ,0 ,0 ,1 ,0 ,1,22269 , 0 
61680.96,8,23 ,1 ,256 ,0 ,0 ,6 ,4 ,0 ,3 ,1 ,14 ,0 ,12 ,2 ,14,25267 , 0 
61681.078,11,32 ,9 ,1506 ,0 ,0 ,7 ,2 ,1 ,2 ,0 ,12 ,0 ,16 ,7 ,23,39115 , 0 
61681.123,2,23 ,2 ,0 ,0 ,0 ,8 ,1 ,0 ,3 ,3 ,15 ,0 ,16 ,7 ,23,45688 , 0 
61681.138,6,32 ,2 ,512 ,0 ,0 ,7 ,1 ,0 ,3 ,1 ,12 ,0 ,16 ,1 ,17,63867 , 0 
61681.214,18,23 ,12 ,1075 ,0 ,0 ,8 ,2 ,0 ,4 ,0 ,14 ,0 ,13 ,0 ,13,32044 , 0 
61681.236,4,23 ,18 ,1843 ,0 ,0 ,8 ,3 ,0 ,4 ,0 ,15 ,0 ,9 ,1 ,10,29200 , 0 
61681.29,7,39 ,16 ,65535 ,0 ,0 ,11 ,0 ,1 ,1 ,0 ,13 ,0 ,15 ,20 ,35,46063 , 1 
61681.337,14,32 ,0 ,0 ,0 ,0 ,8 ,2 ,0 ,4 ,1 ,15 ,0 ,20 ,2 ,22,28888 , 0 
61681.35,15,38 ,7 ,1043 ,0 ,0 ,9 ,2 ,0 ,3 ,0 ,14 ,0 ,15 ,0 ,15,35008 , 0 
61681.36,20,32 ,12 ,1075 ,0 ,0 ,7 ,5 ,3 ,5 ,2 ,22 ,0 ,12 ,6 ,18,30488 , 0 
61681.361,16,32 ,2 ,512 ,0 ,0 ,8 ,2 ,1 ,5 ,0 ,16 ,0 ,14 ,5 ,19,65782 , 0 
61681.444,10,32 ,14 ,2067 ,0 ,0 ,8 ,0 ,0 ,2 ,0 ,10 ,0 ,7 ,0 ,7,32632 , 0 
61681.482,12,23 ,5 ,790 ,0 ,0 ,6 ,5 ,2 ,5 ,0 ,18 ,0 ,16 ,3 ,19,33454 , 0 
61681.596,9,36 ,7 ,1043 ,0 ,0 ,9 ,1 ,4 ,3 ,2 ,19 ,0 ,17 ,8 ,25,56845 , 0 
61681.603,5,23 ,13 ,512 ,0 ,0 ,8 ,5 ,5 ,7 ,4 ,29 ,0 ,17 ,12 ,29,53771 , 0 
61681.607,19,23 ,19 ,0 ,0 ,0 ,6 ,2 ,8 ,4 ,2 ,22 ,0 ,20 ,17 ,37,34560 , 0 
61681.697,17,38 ,7 ,1043 ,0 ,0 ,8 ,2 ,0 ,3 ,0 ,13 ,0 ,18 ,0 ,18,42746 , 0 
61681.771,13,32 ,1 ,256 ,0 ,0 ,8 ,3 ,5 ,6 ,3 ,25 ,0 ,14 ,9 ,23,31225 , 0 
61681.787,3,23 ,0 ,0 ,0 ,0 ,5 ,4 ,0 ,3 ,0 ,12 ,0 ,13 ,1 ,14,21991 , 0 
61800.961,8,69 ,3 ,512 ,0 ,0 ,18 ,11 ,9 ,12 ,3 ,53 ,0 ,36 ,21 ,57,26180 , 0 
61801.078,11,68 ,5 ,1264 ,0 ,0 ,16 ,8 ,5 ,9 ,4 ,42 ,0 ,45 ,9 ,54,42229 , 0 
61801.124,2,68 ,1 ,256 ,0 ,0 ,19 ,4 ,1 ,7 ,0 ,31 ,0 ,54 ,6 ,60,43533 , 0 
61801.138,6,68 ,2 ,573 ,0 ,0 ,19 ,2 ,0 ,6 ,0 ,27 ,0 ,38 ,2 ,40,54836 , 0 
61801.215,18,68 ,19 ,839 ,0 ,0 ,19 ,12 ,1 ,15 ,3 ,50 ,0 ,34 ,9 ,43,35143 , 0 
61801.29,7,75 ,16 ,65535 ,0 ,0 ,18 ,0 ,0 ,0 ,0 ,18 ,0 ,30 ,0 ,30,45745 , 1 
61801.338,14,69 ,1 ,256 ,0 ,0 ,17 ,8 ,7 ,10 ,3 ,45 ,0 ,43 ,14 ,57,29604 , 0 
61801.35,15,68 ,9 ,1536 ,0 ,0 ,18 ,2 ,0 ,4 ,0 ,24 ,0 ,31 ,0 ,31,37226 , 0 
61801.36,20,68 ,5 ,1264 ,0 ,0 ,15 ,6 ,0 ,7 ,0 ,28 ,0 ,28 ,0 ,28,33725 , 0 
61801.361,16,68 ,9 ,1536 ,0 ,0 ,18 ,2 ,0 ,3 ,0 ,23 ,0 ,31 ,1 ,32,60559 , 0 
61801.371,4,65 ,8 ,512 ,0 ,0 ,15 ,10 ,1 ,10 ,1 ,37 ,0 ,28 ,3 ,31,31089 , 0 
61801.444,10,69 ,14 ,1024 ,0 ,0 ,18 ,5 ,1 ,6 ,1 ,31 ,0 ,20 ,2 ,22,32325 , 0 
61801.482,12,65 ,5 ,1264 ,0 ,0 ,17 ,10 ,1 ,14 ,2 ,44 ,0 ,42 ,5 ,47,37016 , 0 
61801.596,9,65 ,5 ,1264 ,0 ,0 ,17 ,6 ,1 ,7 ,1 ,32 ,0 ,33 ,4 ,37,54938 , 0 
61801.603,5,68 ,19 ,820 ,0 ,0 ,17 ,7 ,23 ,9 ,14 ,70 ,0 ,63 ,52 ,115,56255 , 0 
61801.607,19,65 ,8 ,512 ,0 ,0 ,18 ,8 ,31 ,11 ,13 ,81 ,0 ,58 ,58 ,116,36200 , 0 
61801.697,17,72 ,7 ,1043 ,0 ,0 ,18 ,0 ,0 ,0 ,0 ,18 ,0 ,27 ,0 ,27,41483 , 0 
61801.772,13,65 ,19 ,839 ,0 ,0 ,16 ,7 ,8 ,15 ,4 ,50 ,0 ,39 ,16 ,55,32162 , 0 
61801.787,3,69 ,1 ,256 ,0 ,0 ,17 ,13 ,5 ,9 ,0 ,44 ,0 ,32 ,5 ,37,22624 , 0 
61920.961,8,111 ,1 ,256 ,0 ,0 ,17 ,9 ,2 ,14 ,3 ,45 ,0 ,47 ,10 ,57,25648 , 0 
61921.078,11,110 ,5 ,816 ,0 ,0 ,20 ,1 ,1 ,3 ,0 ,25 ,0 ,61 ,2 ,63,39465 , 0 
61921.124,2,110 ,1 ,256 ,0 ,0 ,19 ,4 ,2 ,9 ,1 ,35 ,0 ,63 ,9 ,72,46143 , 0 
61921.138,6,110 ,2 ,512 ,0 ,0 ,19 ,4 ,0 ,5 ,0 ,28 ,0 ,47 ,0 ,47,64229 , 0 
61921.214,18,110 ,0 ,0 ,0 ,0 ,16 ,3 ,1 ,6 ,1 ,27 ,0 ,37 ,2 ,39,32412 , 0 
61921.236,4,111 ,8 ,512 ,0 ,0 ,17 ,8 ,0 ,8 ,0 ,33 ,0 ,35 ,1 ,36,29636 , 0 
61921.292,7,119 ,16 ,65535 ,0 ,0 ,22 ,0 ,0 ,0 ,0 ,22 ,0 ,45 ,0 ,45,46294 , 1 
61921.338,14,111 ,1 ,256 ,0 ,0 ,19 ,7 ,3 ,11 ,2 ,42 ,0 ,47 ,11 ,58,29311 , 0 
61921.35,15,110 ,9 ,1536 ,0 ,0 ,19 ,0 ,0 ,0 ,0 ,19 ,0 ,41 ,0 ,41,35208 , 0 
61921.36,20,110 ,11 ,1328 ,0 ,0 ,17 ,2 ,0 ,3 ,0 ,22 ,0 ,39 ,2 ,41,30857 , 0 
61921.361,16,110 ,2 ,750 ,0 ,0 ,18 ,2 ,0 ,3 ,0 ,23 ,0 ,46 ,1 ,47,66232 , 0 
61921.444,10,110 ,14 ,512 ,0 ,0 ,16 ,3 ,1 ,5 ,1 ,26 ,0 ,22 ,2 ,24,32973 , 0 
61921.482,12,110 ,18 ,768 ,0 ,0 ,20 ,3 ,0 ,4 ,0 ,27 ,0 ,44 ,1 ,45,33843 , 0 
61921.596,9,110 ,5 ,1264 ,0 ,0 ,22 ,0 ,0 ,0 ,0 ,22 ,0 ,58 ,0 ,58,57095 , 0 
61921.603,5,110 ,0 ,0 ,0 ,0 ,20 ,2 ,4 ,6 ,2 ,34 ,0 ,80 ,11 ,91,54307 , 0 
61921.607,19,111 ,8 ,512 ,0 ,0 ,19 ,6 ,14 ,9 ,9 ,57 ,0 ,70 ,38 ,108,35076 , 0 
61921.697,17,118 ,16 ,1024 ,0 ,0 ,19 ,0 ,0 ,1 ,0 ,20 ,0 ,34 ,2 ,36,43048 , 0 
61921.772,13,110 ,1 ,256 ,0 ,0 ,17 ,5 ,1 ,10 ,0 ,33 ,0 ,51 ,3 ,54,31599 , 0 
61921.787,3,111 ,8 ,512 ,0 ,0 ,14 ,8 ,0 ,12 ,2 ,36 ,0 ,27 ,3 ,30,22235 , 0 
62040.961,8,121 ,1 ,256 ,0 ,0 ,8 ,6 ,6 ,4 ,4 ,28 ,0 ,27 ,10 ,37,26419 , 0 
62041.079,11,121 ,9 ,1246 ,0 ,0 ,14 ,6 ,6 ,5 ,1 ,32 ,0 ,36 ,10 ,46,42710 , 0 
62041.124,2,121 ,1 ,256 ,0 ,0 ,9 ,6 ,10 ,4 ,3 ,32 ,0 ,25 ,15 ,40,43827 , 0 
62041.138,6,121 ,2 ,625 ,0 ,0 ,11 ,3 ,2 ,2 ,1 ,19 ,0 ,24 ,3 ,27,55108 , 0 
62041.214,18,121 ,19 ,512 ,0 ,0 ,10 ,6 ,3 ,3 ,1 ,23 ,0 ,23 ,5 ,28,35514 , 0 
62041.236,4,121 ,19 ,512 ,0 ,0 ,11 ,7 ,0 ,4 ,0 ,22 ,0 ,14 ,0 ,14,31489 , 0 
62041.29,7,121 ,9 ,1246 ,0 ,0 ,12 ,2 ,2 ,1 ,0 ,17 ,0 ,25 ,2 ,27,45984 , 0 
62041.338,14,121 ,1 ,256 ,0 ,0 ,10 ,7 ,6 ,4 ,3 ,30 ,0 ,29 ,9 ,38,29834 , 0 
62041.35,15,121 ,7 ,1519 ,0 ,0 ,15 ,4 ,0 ,3 ,0 ,22 ,0 ,21 ,0 ,21,37595 , 0 
62041.36,20,121 ,11 ,1547 ,0 ,0 ,12 ,7 ,0 ,5 ,0 ,24 ,0 ,26 ,0 ,26,34142 , 0 
62041.361,16,121 ,2 ,512 ,0 ,0 ,10 ,1 ,0 ,1 ,1 ,13 ,0 ,20 ,1 ,21,60760 , 0 
62041.444,10,121 ,14 ,529 ,0 ,0 ,9 ,4 ,0 ,1 ,0 ,14 ,0 ,16 ,1 ,17,32487 , 0 
62041.482,12,121 ,18 ,897 ,0 ,0 ,13 ,5 ,0 ,6 ,0 ,24 ,0 ,29 ,5 ,34,37502 , 0 
62041.596,9,121 ,5 ,816 ,0 ,0 ,9 ,6 ,11 ,1 ,1 ,28 ,0 ,30 ,13 ,43,55402 , 0 
62041.603,5,121 ,19 ,512 ,0 ,0 ,13 ,7 ,21 ,5 ,5 ,51 ,0 ,38 ,31 ,69,57009 , 0 
62041.607,19,121 ,1 ,256 ,0 ,0 ,9 ,8 ,34 ,6 ,8 ,65 ,0 ,31 ,47 ,78,36522 , 0 
62041.697,17,121 ,6 ,810 ,0 ,0 ,12 ,2 ,0 ,2 ,0 ,16 ,0 ,17 ,0 ,17,41750 , 0 
62041.772,13,121 ,1 ,256 ,0 ,0 ,10 ,7 ,0 ,2 ,0 ,19 ,0 ,20 ,0 ,20,32451 , 0 
62041.787,3,121 ,1 ,256 ,0 ,0 ,10 ,7 ,0 ,4 ,0 ,21 ,0 ,17 ,0 ,17,22878 , 0 
62160.96,8,121 ,1 ,256 ,0 ,0 ,2 ,1 ,0 ,0 ,0 ,3 ,0 ,5 ,0 ,5,25719 , 0 
62161.078,11,121 ,12 ,1071 ,0 ,0 ,5 ,3 ,1 ,2 ,1 ,12 ,0 ,10 ,2 ,12,39599 , 0 
62161.124,2,121 ,1 ,256 ,0 ,0 ,3 ,1 ,4 ,0 ,0 ,8 ,0 ,8 ,4 ,12,46264 , 0 
62161.138,6,121 ,2 ,557 ,0 ,0 ,2 ,2 ,2 ,0 ,0 ,6 ,0 ,9 ,2 ,11,64346 , 0 
62161.214,18,121 ,19 ,512 ,0 ,0 ,2 ,0 ,2 ,0 ,1 ,5 ,0 ,5 ,3 ,8,32547 , 0 
62161.236,4,121 ,19 ,512 ,0 ,0 ,2 ,1 ,0 ,0 ,0 ,3 ,0 ,2 ,0 ,2,29727 , 0 
62161.289,7,121 ,9 ,1246 ,0 ,0 ,2 ,0 ,1 ,0 ,0 ,3 ,0 ,4 ,1 ,5,46365 , 0 
62161.337,14,121 ,1 ,256 ,0 ,0 ,1 ,1 ,1 ,0 ,0 ,3 ,0 ,8 ,1 ,9,29399 , 0 
62161.35,15,121 ,7 ,1517 ,0 ,0 ,1 ,1 ,0 ,0 ,0 ,2 ,0 ,7 ,0 ,7,35294 , 0 
62161.36,20,121 ,12 ,1071 ,0 ,0 ,5 ,3 ,0 ,1 ,0 ,9 ,0 ,9 ,0 ,9,30958 , 0 
62161.36,16,121 ,2 ,512 ,0 ,0 ,4 ,0 ,0 ,0 ,0 ,4 ,0 ,4 ,0 ,4,66342 , 0 
62161.444,10,121 ,14 ,539 ,0 ,0 ,3 ,1 ,0 ,0 ,0 ,4 ,0 ,2 ,0 ,2,33068 , 0 
62161.482,12,121 ,5 ,798 ,0 ,0 ,5 ,3 ,5 ,1 ,0 ,14 ,0 ,12 ,6 ,18,34009 , 0 
62161.596,9,121 ,5 ,792 ,0 ,0 ,2 ,2 ,2 ,0 ,1 ,7 ,0 ,11 ,4 ,15,57231 , 0 
62161.603,5,121 ,19 ,512 ,0 ,0 ,3 ,1 ,10 ,0 ,1 ,15 ,0 ,16 ,11 ,27,54516 , 0 
62161.607,19,121 ,1 ,256 ,0 ,0 ,2 ,1 ,14 ,0 ,2 ,19 ,0 ,9 ,16 ,25,35228 , 0 
62161.696,17,121 ,6 ,1031 ,0 ,0 ,1 ,2 ,0 ,0 ,0 ,3 ,0 ,5 ,0 ,5,43123 , 0 
62161.771,13,121 ,1 ,256 ,0 ,0 ,3 ,1 ,0 ,0 ,0 ,4 ,0 ,7 ,0 ,7,31712 , 0 
62161.787,3,121 ,1 ,256 ,0 ,0 ,2 ,1 ,0 ,0 ,0 ,3 ,0 ,2 ,0 ,2,22296 , 0 
62280.96,8,121 ,1 ,256 ,0 ,0 ,2 ,1 ,0 ,0 ,0 ,3 ,0 ,5 ,0 ,5,26500 , 0 
62281.078,11,121 ,12 ,1049 ,0 ,0 ,3 ,2 ,0 ,1 ,0 ,6 ,0 ,8 ,0 ,8,42819 , 0 
62281.123,2,121 ,1 ,256 ,0 ,0 ,1 ,1 ,1 ,0 ,0 ,3 ,0 ,6 ,1 ,7,43906 , 0 
62281.138,6,121 ,2 ,557 ,0 ,0 ,2 ,0 ,1 ,0 ,0 ,3 ,0 ,2 ,1 ,3,55176 , 0 
62281.214,18,121 ,19 ,512 ,0 ,0 ,2 ,1 ,0 ,1 ,0 ,4 ,0 ,4 ,0 ,4,35595 , 0 
62281.236,4,121 ,19 ,512 ,0 ,0 ,2 ,1 ,0 ,0 ,0 ,3 ,0 ,3 ,0 ,3,31586 , 0 
62281.289,7,121 ,9 ,1087 ,0 ,0 ,2 ,2 ,1 ,0 ,0 ,5 ,0 ,6 ,1 ,7,46061 , 0 
62281.337,14,121 ,1 ,256 ,0 ,0 ,3 ,1 ,1 ,0 ,0 ,5 ,0 ,4 ,1 ,5,29932 , 0 
62281.35,15,121 ,7 ,1384 ,0 ,0 ,2 ,1 ,0 ,0 ,0 ,3 ,0 ,4 ,0 ,4,37672 , 0 
62281.36,20,121 ,12 ,1049 ,0 ,0 ,3 ,3 ,0 ,0 ,0 ,6 ,0 ,7 ,0 ,7,34238 , 0 
62281.36,16,121 ,2 ,512 ,0 ,0 ,1 ,0 ,0 ,0 ,0 ,1 ,0 ,4 ,0 ,4,60829 , 0 
62281.444,10,121 ,14 ,536 ,0 ,0 ,1 ,1 ,0 ,0 ,0 ,2 ,0 ,2 ,0 ,2,32548 , 0 
62281.482,12,121 ,5 ,787 ,0 ,0 ,3 ,1 ,5 ,0 ,0 ,9 ,0 ,6 ,6 ,12,37651 , 0 
62281.596,9,121 ,5 ,787 ,0 ,0 ,2 ,1 ,3 ,1 ,0 ,7 ,0 ,4 ,3 ,7,55519 , 0 
62281.603,5,121 ,19 ,512 ,0 ,0 ,2 ,2 ,10 ,0 ,0 ,14 ,0 ,12 ,11 ,23,57213 , 0 
62281.607,19,121 ,1 ,256 ,0 ,0 ,2 ,1 ,14 ,0 ,0 ,17 ,0 ,5 ,15 ,20,36627 , 0 
62281.696,17,121 ,6 ,1002 ,0 ,0 ,3 ,1 ,0 ,0 ,0 ,4 ,0 ,2 ,0 ,2,41841 , 0 
62281.771,13,121 ,1 ,256 ,0 ,0 ,1 ,1 ,0 ,0 ,0 ,2 ,0 ,5 ,0 ,5,32520 , 0 
62281.787,3,121 ,1 ,256 ,0 ,0 ,2 ,1 ,0 ,0 ,0 ,3 ,0 ,5 ,0 ,5,22977 , 0 
62400.96,8,121 ,1 ,256 ,0 ,0 ,2 ,0 ,0 ,0 ,0 ,2 ,0 ,3 ,0 ,3,25922 , 0 
62401.078,11,121 ,9 ,300 ,0 ,0 ,5 ,5 ,4 ,6 ,0 ,20 ,0 ,15 ,10 ,25,39895 , 0 
62401.123,2,121 ,1 ,256 ,0 ,0 ,1 ,0 ,1 ,0 ,1 ,3 ,0 ,6 ,2 ,8,46363 , 0 
62401.138,6,121 ,2 ,557 ,0 ,0 ,1 ,0 ,1 ,0 ,0 ,2 ,0 ,4 ,1 ,5,64449 , 0 
62401.214,18,121 ,19 ,512 ,0 ,0 ,2 ,1 ,0 ,0 ,0 ,3 ,0 ,7 ,0 ,7,32645 , 0 
62401.236,4,121 ,19 ,512 ,0 ,0 ,2 ,1 ,0 ,0 ,0 ,3 ,0 ,2 ,0 ,2,29825 , 0 
62401.289,7,121 ,9 ,300 ,0 ,0 ,1 ,2 ,0 ,0 ,1 ,4 ,0 ,6 ,1 ,7,46500 , 0 
62401.337,14,121 ,1 ,256 ,0 ,0 ,0 ,0 ,0 ,0 ,0 ,0 ,0 ,3 ,0 ,3,29454 , 0 
62401.35,15,121 ,11 ,604 ,0 ,0 ,3 ,3 ,0 ,1 ,0 ,7 ,0 ,6 ,0 ,6,35449 , 0 
62401.36,20,121 ,12 ,1045 ,0 ,0 ,6 ,5 ,0 ,2 ,0 ,13 ,0 ,7 ,2 ,9,31141 , 0 
62401.36,16,121 ,9 ,300 ,0 ,0 ,4 ,2 ,0 ,2 ,0 ,8 ,0 ,5 ,3 ,8,66506 , 0 
62401.444,10,121 ,14 ,536 ,0 ,0 ,2 ,0 ,0 ,0 ,0 ,2 ,0 ,0 ,0 ,0,33134 , 0 
62401.482,12,121 ,5 ,584 ,0 ,0 ,2 ,2 ,4 ,0 ,2 ,10 ,0 ,11 ,9 ,20,34188 , 0 
62401.596,9,121 ,5 ,584 ,0 ,0 ,4 ,2 ,4 ,6 ,2 ,18 ,0 ,11 ,21 ,32,57518 , 1 
62401.603,5,121 ,9 ,300 ,0 ,0 ,4 ,2 ,7 ,4 ,4 ,21 ,0 ,14 ,14 ,28,54800 , 0 
62401.607,19,121 ,1 ,256 ,0 ,0 ,2 ,0 ,6 ,0 ,5 ,13 ,0 ,4 ,12 ,16,35344 , 0 
62401.696,17,121 ,6 ,983 ,0 ,0 ,2 ,1 ,0 ,0 ,0 ,3 ,0 ,3 ,0 ,3,43216 , 0 
62401.771,13,121 ,1 ,256 ,0 ,0 ,2 ,0 ,0 ,0 ,0 ,2 ,0 ,4 ,0 ,4,31786 , 0 
62401.787,3,121 ,1 ,256 ,0 ,0 ,1 ,0 ,0 ,0 ,0 ,1 ,0 ,0 ,0 ,0,22359 , 0 
62520.96,8,121 ,1 ,256 ,0 ,0 ,2 ,1 ,0 ,0 ,0 ,3 ,0 ,5 ,0 ,5,26595 , 0 
62521.079,11,121 ,9 ,300 ,0 ,0 ,17 ,14 ,23 ,15 ,6 ,75 ,0 ,42 ,52 ,94,43684 , 0 
62521.124,2,121 ,1 ,256 ,0 ,0 ,5 ,0 ,3 ,2 ,1 ,11 ,0 ,17 ,4 ,21,44101 , 0 
62521.138,6,121 ,2 ,521 ,0 ,0 ,5 ,3 ,0 ,1 ,1 ,10 ,0 ,18 ,1 ,19,55425 , 0 
62521.214,18,121 ,19 ,512 ,0 ,0 ,1 ,0 ,1 ,0 ,0 ,2 ,0 ,14 ,1 ,15,35825 , 0 
62521.236,4,121 ,18 ,851 ,0 ,0 ,5 ,1 ,0 ,1 ,0 ,7 ,0 ,1 ,0 ,1,31888 , 0 
62521.29,7,121 ,9 ,300 ,0 ,0 ,9 ,12 ,12 ,5 ,0 ,38 ,0 ,25 ,26 ,51,46682 , 0 
62521.337,14,121 ,1 ,256 ,0 ,0 ,2 ,0 ,1 ,0 ,0 ,3 ,0 ,4 ,1 ,5,30078 , 0 
62521.351,15,121 ,7 ,886 ,0 ,0 ,9 ,12 ,15 ,3 ,2 ,41 ,0 ,35 ,22 ,57,38179 , 0 
62521.36,20,121 ,11 ,770 ,0 ,0 ,17 ,10 ,0 ,9 ,0 ,36 ,0 ,21 ,1 ,22,34773 , 0 
62521.361,16,121 ,9 ,300 ,0 ,0 ,11 ,9 ,2 ,4 ,0 ,26 ,0 ,25 ,12 ,37,61330 , 0 
62521.444,10,121 ,14 ,526 ,0 ,0 ,1 ,1 ,0 ,0 ,0 ,2 ,0 ,5 ,0 ,5,32678 , 0 
62521.482,12,121 ,5 ,798 ,0 ,0 ,5 ,8 ,7 ,1 ,8 ,29 ,0 ,29 ,22 ,51,38156 , 0 
62521.603,5,121 ,9 ,300 ,0 ,0 ,16 ,14 ,16 ,13 ,8 ,67 ,0 ,38 ,36 ,74,58015 , 0 
62521.607,19,121 ,1 ,256 ,0 ,0 ,1 ,0 ,15 ,4 ,9 ,29 ,0 ,17 ,25 ,42,36947 , 0 
62521.697,17,121 ,7 ,854 ,0 ,0 ,7 ,6 ,0 ,1 ,0 ,14 ,0 ,14 ,0 ,14,42065 , 0 
62521.723,9,121 ,15 ,1192 ,0 ,0 ,20 ,12 ,42 ,21 ,3 ,98 ,0 ,31 ,95 ,126,56639 , 1 
62521.771,13,121 ,1 ,256 ,0 ,0 ,2 ,0 ,0 ,0 ,0 ,2 ,0 ,12 ,0 ,12,32772 , 0 
62521.787,3,121 ,1 ,256 ,0 ,0 ,1 ,1 ,0 ,0 ,0 ,2 ,0 ,2 ,0 ,2,23046 , 0 
62640.96,8,121 ,1 ,256 ,0 ,0 ,0 ,0 ,0 ,0 ,0 ,0 ,0 ,2 ,0 ,2,25989 , 0 
62641.078,11,121 ,9 ,300 ,0 ,0 ,9 ,13 ,2 ,6 ,1 ,31 ,0 ,36 ,9 ,45,40319 , 0 
62641.124,2,121 ,1 ,256 ,0 ,0 ,8 ,0 ,4 ,0 ,1 ,13 ,0 ,29 ,7 ,36,46665 , 0 
62641.139,6,121 ,10 ,827 ,0 ,0 ,11 ,6 ,0 ,1 ,0 ,18 ,0 ,26 ,0 ,26,64696 , 0 
62641.214,18,121 ,19 ,512 ,0 ,0 ,1 ,0 ,0 ,0 ,0 ,1 ,0 ,11 ,0 ,11,32753 , 0 
62641.236,4,121 ,18 ,851 ,0 ,0 ,2 ,0 ,0 ,0 ,0 ,2 ,0 ,0 ,0 ,0,29900 , 0 
62641.301,7,121 ,9 ,65535 ,0 ,0 ,14 ,12 ,56 ,14 ,2 ,98 ,0 ,39 ,82 ,121,47284 , 0 
62641.337,14,121 ,1 ,256 ,0 ,0 ,1 ,0 ,1 ,0 ,0 ,2 ,0 ,7 ,1 ,8,29544 , 0 
62641.35,15,121 ,7 ,571 ,0 ,0 ,6 ,8 ,42 ,1 ,2 ,59 ,0 ,27 ,51 ,78,35965 , 0 
62641.362,16,121 ,9 ,300 ,0 ,0 ,17 ,11 ,4 ,17 ,1 ,50 ,0 ,39 ,34 ,73,67128 , 0 
62641.424,20,121 ,11 ,795 ,0 ,0 ,9 ,4 ,0 ,2 ,0 ,15 ,0 ,13 ,1 ,14,31415 , 0 
62641.444,10,121 ,14 ,526 ,0 ,0 ,1 ,0 ,1 ,0 ,0 ,2 ,0 ,8 ,1 ,9,33230 , 0 
62641.482,12,121 ,5 ,839 ,0 ,0 ,6 ,2 ,1 ,2 ,1 ,12 ,0 ,12 ,2 ,14,34379 , 0 
62641.603,5,121 ,13 ,529 ,0 ,0 ,9 ,8 ,8 ,3 ,3 ,31 ,0 ,34 ,19 ,53,55274 , 0 
62641.607,19,121 ,1 ,256 ,0 ,0 ,1 ,0 ,0 ,2 ,0 ,3 ,0 ,10 ,0 ,10,35444 , 0 
62641.671,9,121 ,7 ,65535 ,0 ,0 ,20 ,10 ,67 ,27 ,3 ,127 ,0 ,30 ,126 ,156,58687 , 1 
62641.697,17,121 ,7 ,571 ,0 ,0 ,6 ,9 ,0 ,0 ,0 ,15 ,0 ,31 ,0 ,31,43524 , 0 
62641.771,13,121 ,1 ,256 ,0 ,0 ,1 ,0 ,8 ,0 ,0 ,9 ,0 ,12 ,10 ,22,31934 , 0 
62641.787,3,121 ,1 ,256 ,0 ,0 ,1 ,0 ,0 ,0 ,0 ,1 ,0 ,1 ,0 ,1,22448 , 0 
62760.96,8,121 ,1 ,256 ,0 ,0 ,0 ,0 ,0 ,0 ,0 ,0 ,0 ,4 ,0 ,4,26670 , 0 
62761.078,11,121 ,9 ,1145 ,0 ,0 ,7 ,5 ,4 ,2 ,1 ,19 ,0 ,16 ,7 ,23,43942 , 0 
62761.124,2,121 ,1 ,256 ,0 ,0 ,2 ,0 ,5 ,2 ,2 ,11 ,0 ,11 ,10 ,21,44257 , 0 
62761.138,6,121 ,10 ,918 ,0 ,0 ,2 ,0 ,0 ,0 ,0 ,2 ,0 ,12 ,1 ,13,55561 , 0 
62761.214,18,121 ,19 ,512 ,0 ,0 ,1 ,0 ,0 ,0 ,1 ,2 ,0 ,7 ,1 ,8,35914 , 0 
62761.236,4,121 ,19 ,512 ,0 ,0 ,3 ,1 ,0 ,1 ,0 ,5 ,0 ,1 ,0 ,1,31970 , 0 
62761.29,7,121 ,16 ,1096 ,0 ,0 ,9 ,5 ,4 ,5 ,4 ,27 ,0 ,16 ,12 ,28,47042 , 0 
62761.337,14,121 ,1 ,256 ,0 ,0 ,1 ,0 ,0 ,0 ,0 ,1 ,0 ,3 ,0 ,3,30153 , 0 
62761.35,15,121 ,11 ,1448 ,0 ,0 ,9 ,6 ,1 ,4 ,1 ,21 ,0 ,15 ,2 ,17,38502 , 0 
62761.36,20,121 ,11 ,1448 ,0 ,0 ,2 ,4 ,0 ,0 ,0 ,6 ,0 ,11 ,0 ,11,34961 , 0 
62761.361,16,121 ,2 ,542 ,0 ,0 ,7 ,2 ,6 ,3 ,3 ,21 ,0 ,14 ,14 ,28,61639 , 0 
62761.482,12,121 ,5 ,795 ,0 ,0 ,2 ,5 ,0 ,1 ,0 ,8 ,0 ,10 ,0 ,10,38365 , 0 
62761.586,10,121 ,14 ,526 ,0 ,0 ,3 ,0 ,0 ,0 ,1 ,4 ,0 ,1 ,1 ,2,32792 , 0 
62761.596,9,121 ,5 ,843 ,0 ,0 ,7 ,5 ,9 ,3 ,4 ,28 ,0 ,26 ,19 ,45,57082 , 0 
62761.603,5,121 ,19 ,521 ,0 ,0 ,7 ,1 ,19 ,2 ,5 ,34 ,0 ,9 ,25 ,34,58443 , 0 
62761.607,19,121 ,1 ,256 ,0 ,0 ,1 ,0 ,17 ,0 ,5 ,23 ,0 ,9 ,22 ,31,37076 , 0 
62761.697,17,121 ,6 ,1083 ,0 ,0 ,6 ,3 ,0 ,1 ,0 ,10 ,0 ,11 ,0 ,11,42323 , 0 
62761.771,13,121 ,1 ,256 ,0 ,0 ,1 ,0 ,3 ,2 ,2 ,8 ,0 ,7 ,6 ,13,32884 , 0 
62761.787,3,121 ,1 ,256 ,0 ,0 ,1 ,0 ,0 ,0 ,0 ,1 ,0 ,0 ,0 ,0,23110 , 0 
62880.96,8,121 ,1 ,256 ,0 ,0 ,0 ,0 ,0 ,0 ,0 ,0 ,0 ,5 ,0 ,5,26057 , 0 
62881.078,11,121 ,9 ,1145 ,0 ,0 ,1 ,0 ,0 ,1 ,0 ,2 ,0 ,5 ,0 ,5,40395 , 0 
62881.126,2,121 ,1 ,256 ,0 ,0 ,1 ,0 ,7 ,0 ,0 ,8 ,0 ,7 ,7 ,14,46791 , 0 
62881.138,6,121 ,2 ,515 ,0 ,0 ,6 ,1 ,3 ,1 ,0 ,11 ,0 ,4 ,3 ,7,64837 , 0 
62881.214,18,121 ,19 ,512 ,0 ,0 ,1 ,0 ,0 ,1 ,0 ,2 ,0 ,7 ,0 ,7,32857 , 0 
62881.236,4,121 ,19 ,512 ,0 ,0 ,5 ,1 ,0 ,0 ,0 ,6 ,0 ,1 ,0 ,1,30021 , 0 
62881.289,7,121 ,16 ,1010 ,0 ,0 ,4 ,2 ,0 ,0 ,0 ,6 ,0 ,5 ,0 ,5,47395 , 0 
62881.337,14,121 ,1 ,256 ,0 ,0 ,1 ,0 ,0 ,1 ,1 ,3 ,0 ,2 ,2 ,4,29639 , 0 
62881.35,15,121 ,11 ,1448 ,0 ,0 ,3 ,0 ,0 ,0 ,0 ,3 ,0 ,4 ,0 ,4,36055 , 0 
62881.36,20,121 ,11 ,1448 ,0 ,0 ,2 ,0 ,0 ,0 ,0 ,2 ,0 ,4 ,0 ,4,31494 , 0 
62881.361,16,121 ,2 ,515 ,0 ,0 ,2 ,1 ,2 ,0 ,0 ,5 ,0 ,10 ,2 ,12,67242 , 0 
62881.444,10,121 ,14 ,526 ,0 ,0 ,0 ,0 ,0 ,1 ,0 ,1 ,0 ,5 ,0 ,5,33357 , 0 
62881.482,12,121 ,5 ,917 ,0 ,0 ,1 ,1 ,0 ,0 ,0 ,2 ,0 ,3 ,0 ,3,34472 , 0 
62881.596,9,121 ,5 ,917 ,0 ,0 ,1 ,1 ,0 ,3 ,0 ,5 ,0 ,8 ,1 ,9,58847 , 0 
62881.603,5,121 ,19 ,521 ,0 ,0 ,4 ,0 ,2 ,3 ,0 ,9 ,0 ,5 ,5 ,10,55476 , 0 
62881.607,19,121 ,1 ,256 ,0 ,0 ,1 ,0 ,3 ,3 ,0 ,7 ,0 ,6 ,7 ,13,35601 , 0 
62881.697,17,121 ,6 ,1027 ,0 ,0 ,2 ,3 ,0 ,0 ,0 ,5 ,0 ,10 ,0 ,10,43612 , 0 
62881.771,13,121 ,1 ,256 ,0 ,0 ,1 ,0 ,0 ,0 ,0 ,1 ,0 ,2 ,0 ,2,32018 , 0 
62881.787,3,121 ,1 ,256 ,0 ,0 ,2 ,0 ,0 ,0 ,0 ,2 ,0 ,1 ,0 ,1,22510 , 0 
63000.96,8,121 ,1 ,256 ,0 ,0 ,1 ,0 ,0 ,0 ,0 ,1 ,0 ,3 ,0 ,3,26732 , 0 
63001.078,11,121 ,9 ,1326 ,0 ,0 ,2 ,1 ,2 ,0 ,0 ,5 ,0 ,4 ,2 ,6,44032 , 0 
63001.123,2,121 ,1 ,256 ,0 ,0 ,1 ,0 ,1 ,0 ,0 ,2 ,0 ,5 ,1 ,6,44355 , 0 
63001.138,6,121 ,2 ,515 ,0 ,0 ,1 ,0 ,0 ,0 ,0 ,1 ,0 ,1 ,0 ,1,55645 , 0 
63001.214,18,121 ,19 ,512 ,0 ,0 ,2 ,0 ,0 ,0 ,0 ,2 ,0 ,2 ,0 ,2,35996 , 0 
63001.236,4,121 ,19 ,512 ,0 ,0 ,1 ,0 ,0 ,0 ,0 ,1 ,0 ,3 ,0 ,3,32043 , 0 
63001.289,7,121 ,16 ,944 ,0 ,0 ,3 ,1 ,0 ,0 ,0 ,4 ,0 ,4 ,0 ,4,47142 , 0 
63001.337,14,121 ,1 ,256 ,0 ,0 ,2 ,0 ,1 ,0 ,0 ,3 ,0 ,2 ,1 ,3,30240 , 0 
63001.35,15,121 ,11 ,1434 ,0 ,0 ,2 ,1 ,0 ,0 ,0 ,3 ,0 ,4 ,0 ,4,38582 , 0 
63001.36,20,121 ,11 ,1434 ,0 ,0 ,1 ,1 ,0 ,0 ,0 ,2 ,0 ,1 ,0 ,1,35023 , 0 
63001.36,16,121 ,2 ,515 ,0 ,0 ,1 ,0 ,1 ,0 ,0 ,2 ,0 ,4 ,1 ,5,61729 , 0 
63001.444,10,121 ,14 ,518 ,0 ,0 ,1 ,1 ,0 ,0 ,0 ,2 ,0 ,1 ,0 ,1,32864 , 0 
63001.482,12,121 ,5 ,917 ,0 ,0 ,1 ,0 ,0 ,0 ,0 ,1 ,0 ,4 ,0 ,4,38432 , 0 
63001.596,9,121 ,5 ,917 ,0 ,0 ,2 ,0 ,3 ,0 ,0 ,5 ,0 ,4 ,3 ,7,57196 , 0 
63001.603,5,121 ,19 ,512 ,0 ,0 ,1 ,0 ,3 ,0 ,0 ,4 ,0 ,7 ,3 ,10,58579 , 0 
63001.606,19,121 ,1 ,256 ,0 ,0 ,2 ,0 ,3 ,0 ,0 ,5 ,0 ,4 ,3 ,7,37168 , 0 
63001.696,17,121 ,6 ,1027 ,0 ,0 ,1 ,0 ,0 ,0 ,0 ,1 ,0 ,2 ,0 ,2,42397 , 0 
63001.771,13,121 ,1 ,256 ,0 ,0 ,2 ,0 ,0 ,0 ,0 ,2 ,0 ,3 ,0 ,3,32975 , 0 
63001.787,3,121 ,1 ,256 ,0 ,0 ,2 ,0 ,0 ,0 ,0 ,2 ,0 ,2 ,0 ,2,23174 , 0 
63120.96,8,121 ,1 ,256 ,0 ,0 ,0 ,0 ,0 ,0 ,0 ,0 ,0 ,2 ,0 ,2,26132 , 0 
63121.078,11,121 ,9 ,1186 ,0 ,0 ,2 ,4 ,0 ,0 ,0 ,6 ,0 ,7 ,0 ,7,40545 , 0 
63121.124,2,121 ,1 ,256 ,0 ,0 ,25 ,0 ,59 ,0 ,0 ,84 ,102 ,20 ,59 ,181,47154 , 0 
63121.214,18,121 ,19 ,512 ,0 ,0 ,1 ,1 ,0 ,0 ,0 ,2 ,0 ,2 ,0 ,2,32928 , 0 
63121.236,4,121 ,19 ,512 ,0 ,0 ,1 ,0 ,0 ,0 ,0 ,1 ,0 ,0 ,0 ,0,30091 , 0 
63121.27,6,121 ,2 ,512 ,0 ,120 ,2 ,16 ,1 ,0 ,0 ,139 ,0 ,69 ,1 ,70,65749 , 1 
63121.29,7,121 ,16 ,790 ,0 ,0 ,0 ,14 ,0 ,0 ,0 ,14 ,0 ,41 ,0 ,41,47602 , 0 
63121.338,14,121 ,1 ,256 ,0 ,0 ,0 ,0 ,0 ,0 ,0 ,0 ,0 ,34 ,0 ,34,29751 , 0 
63121.35,15,121 ,11 ,1434 ,0 ,0 ,2 ,0 ,0 ,0 ,0 ,2 ,0 ,2 ,0 ,2,36173 , 0 
63121.36,20,121 ,11 ,1434 ,0 ,0 ,2 ,0 ,0 ,0 ,0 ,2 ,0 ,1 ,0 ,1,31570 , 0 
63121.361,16,121 ,2 ,512 ,0 ,0 ,24 ,13 ,29 ,0 ,0 ,66 ,105 ,39 ,29 ,173,67882 , 0 
63121.445,10,121 ,14 ,518 ,0 ,0 ,24 ,0 ,0 ,0 ,0 ,24 ,105 ,2 ,0 ,107,33613 , 0 
63121.482,12,121 ,5 ,917 ,0 ,0 ,3 ,0 ,0 ,0 ,0 ,3 ,0 ,2 ,0 ,2,34548 , 0 
63121.596,9,121 ,16 ,790 ,0 ,0 ,4 ,11 ,4 ,1 ,0 ,20 ,0 ,21 ,4 ,25,59093 , 0 
63121.603,5,121 ,19 ,512 ,0 ,0 ,1 ,0 ,0 ,1 ,1 ,3 ,0 ,27 ,1 ,28,55629 , 0 
63121.607,19,121 ,1 ,256 ,0 ,0 ,1 ,0 ,1 ,1 ,1 ,4 ,0 ,22 ,3 ,25,35721 , 0 
63121.697,17,121 ,6 ,1001 ,0 ,0 ,25 ,1 ,0 ,0 ,0 ,26 ,110 ,22 ,0 ,132,43911 , 0 
63121.771,13,121 ,1 ,256 ,0 ,0 ,1 ,0 ,0 ,0 ,0 ,1 ,0 ,19 ,0 ,19,32144 , 0 
63121.787,3,121 ,1 ,256 ,0 ,0 ,2 ,0 ,0 ,0 ,0 ,2 ,0 ,0 ,0 ,0,22636 , 0 
63240.96,8,121 ,1 ,256 ,0 ,0 ,0 ,0 ,0 ,0 ,0 ,0 ,0 ,2 ,0 ,2,26815 , 0 
63241.078,11,121 ,9 ,1162 ,0 ,0 ,1 ,1 ,0 ,0 ,0 ,2 ,0 ,3 ,0 ,3,44134 , 0 
63241.124,2,121 ,1 ,256 ,0 ,0 ,24 ,0 ,64 ,0 ,0 ,88 ,105 ,22 ,64 ,191,44741 , 0 
63241.214,18,121 ,19 ,512 ,0 ,0 ,1 ,0 ,0 ,0 ,0 ,1 ,0 ,1 ,0 ,1,36094 , 0 
63241.236,4,121 ,19 ,512 ,0 ,0 ,2 ,0 ,0 ,0 ,0 ,2 ,0 ,1 ,0 ,1,32156 , 0 
63241.27,6,121 ,2 ,519 ,0 ,120 ,1 ,16 ,0 ,0 ,0 ,137 ,0 ,83 ,0 ,83,56564 , 1 
63241.29,7,121 ,16 ,803 ,0 ,0 ,2 ,18 ,0 ,0 ,0 ,20 ,0 ,45 ,0 ,45,47474 , 0 
63241.338,14,121 ,1 ,256 ,0 ,0 ,2 ,0 ,0 ,0 ,0 ,2 ,0 ,35 ,0 ,35,30322 , 0 
63241.35,15,121 ,11 ,1434 ,0 ,0 ,1 ,0 ,0 ,0 ,0 ,1 ,0 ,2 ,0 ,2,38708 , 0 
63241.36,20,121 ,11 ,1434 ,0 ,0 ,1 ,0 ,0 ,0 ,0 ,1 ,0 ,1 ,0 ,1,35098 , 0 
63241.361,16,121 ,2 ,525 ,0 ,0 ,26 ,13 ,35 ,0 ,0 ,74 ,102 ,36 ,35 ,173,62468 , 0 
63241.445,10,121 ,14 ,518 ,0 ,0 ,25 ,0 ,0 ,0 ,0 ,25 ,105 ,0 ,0 ,105,33140 , 0 
63241.482,12,121 ,5 ,819 ,0 ,0 ,1 ,1 ,0 ,0 ,0 ,2 ,0 ,2 ,0 ,2,38566 , 0 
63241.596,9,121 ,16 ,803 ,0 ,0 ,3 ,17 ,1 ,0 ,0 ,21 ,0 ,22 ,1 ,23,57523 , 0 
63241.603,5,121 ,19 ,512 ,0 ,0 ,1 ,0 ,1 ,0 ,0 ,2 ,0 ,18 ,1 ,19,58694 , 0 
63241.607,19,121 ,1 ,256 ,0 ,0 ,1 ,0 ,1 ,0 ,0 ,2 ,0 ,20 ,1 ,21,37279 , 0 
63241.697,17,121 ,6 ,794 ,0 ,0 ,26 ,0 ,0 ,0 ,0 ,26 ,107 ,24 ,0 ,131,42704 , 0 
63241.771,13,121 ,1 ,256 ,0 ,0 ,1 ,0 ,0 ,0 ,0 ,1 ,0 ,21 ,0 ,21,33071 , 0 
63241.787,3,121 ,1 ,256 ,0 ,0 ,0 ,0 ,0 ,0 ,0 ,0 ,0 ,0 ,0 ,0,23225 , 0 
63360.96,8,121 ,1 ,256 ,0 ,0 ,0 ,0 ,0 ,0 ,0 ,0 ,0 ,0 ,0 ,0,26191 , 0 
63361.078,11,121 ,9 ,1162 ,0 ,0 ,1 ,0 ,0 ,1 ,2 ,4 ,0 ,5 ,2 ,7,40669 , 0 
63361.133,2,121 ,1 ,256 ,0 ,0 ,25 ,0 ,71 ,0 ,0 ,96 ,106 ,20 ,73 ,199,47586 , 0 
63361.15,6,121 ,2 ,547 ,0 ,120 ,0 ,17 ,0 ,0 ,0 ,137 ,0 ,77 ,0 ,77,66649 , 1 
63361.214,18,121 ,19 ,512 ,0 ,0 ,1 ,0 ,0 ,0 ,0 ,1 ,0 ,2 ,0 ,2,33021 , 0 
63361.236,4,121 ,19 ,512 ,0 ,0 ,1 ,0 ,0 ,0 ,0 ,1 ,0 ,0 ,0 ,0,30186 , 0 
63361.29,7,121 ,16 ,803 ,0 ,0 ,1 ,19 ,1 ,0 ,0 ,21 ,0 ,44 ,1 ,45,47880 , 0 
63361.338,14,121 ,1 ,256 ,0 ,0 ,1 ,0 ,0 ,0 ,0 ,1 ,0 ,36 ,0 ,36,29842 , 0 
63361.35,15,121 ,7 ,1159 ,0 ,0 ,3 ,1 ,0 ,1 ,0 ,5 ,0 ,2 ,0 ,2,36284 , 0 
63361.36,20,121 ,12 ,1231 ,0 ,0 ,5 ,1 ,0 ,1 ,0 ,7 ,0 ,2 ,0 ,2,31721 , 0 
63361.366,16,121 ,2 ,547 ,0 ,0 ,25 ,16 ,39 ,1 ,1 ,82 ,105 ,35 ,42 ,182,68616 , 0 
63361.445,10,121 ,14 ,518 ,0 ,0 ,25 ,0 ,0 ,0 ,0 ,25 ,112 ,0 ,0 ,112,33865 , 0 
63361.482,12,121 ,5 ,819 ,0 ,0 ,1 ,0 ,1 ,0 ,0 ,2 ,0 ,2 ,1 ,3,34648 , 0 
63361.596,9,121 ,16 ,768 ,0 ,0 ,1 ,19 ,0 ,1 ,2 ,23 ,0 ,26 ,2 ,28,59404 , 0 
63361.603,5,121 ,19 ,512 ,0 ,0 ,2 ,0 ,1 ,0 ,0 ,3 ,0 ,25 ,1 ,26,55795 , 0 
63361.607,19,121 ,1 ,256 ,0 ,0 ,1 ,0 ,1 ,0 ,0 ,2 ,0 ,19 ,1 ,20,35850 , 0 
63361.697,17,121 ,6 ,794 ,0 ,0 ,25 ,0 ,0 ,0 ,0 ,25 ,109 ,23 ,0 ,132,44201 , 0 
63361.771,13,121 ,1 ,256 ,0 ,0 ,1 ,0 ,0 ,0 ,0 ,1 ,0 ,21 ,0 ,21,32241 , 0 
63361.787,3,121 ,1 ,256 ,0 ,0 ,1 ,0 ,0 ,0 ,0 ,1 ,0 ,0 ,0 ,0,22720 , 0 
63480.96,8,121 ,1 ,256 ,0 ,0 ,0 ,0 ,0 ,0 ,0 ,0 ,0 ,3 ,0 ,3,26887 , 0 
63481.078,11,121 ,9 ,1162 ,0 ,0 ,1 ,0 ,0 ,1 ,0 ,2 ,0 ,5 ,0 ,5,44215 , 0 
63481.124,2,121 ,1 ,256 ,0 ,0 ,6 ,0 ,18 ,0 ,0 ,24 ,1 ,4 ,18 ,23,44883 , 0 
63481.138,6,121 ,2 ,514 ,0 ,0 ,2 ,5 ,0 ,0 ,0 ,7 ,0 ,15 ,0 ,15,56686 , 0 
63481.214,18,121 ,19 ,512 ,0 ,0 ,0 ,0 ,0 ,0 ,0 ,0 ,0 ,0 ,0 ,0,36154 , 0 
63481.236,4,121 ,19 ,512 ,0 ,0 ,2 ,0 ,0 ,0 ,0 ,2 ,0 ,0 ,0 ,0,32222 , 0 
63481.289,7,121 ,16 ,770 ,0 ,0 ,1 ,5 ,0 ,0 ,0 ,6 ,0 ,10 ,0 ,10,47597 , 0 
63481.338,14,121 ,1 ,256 ,0 ,0 ,1 ,0 ,0 ,0 ,0 ,1 ,0 ,12 ,0 ,12,30412 , 0 
63481.35,15,121 ,7 ,1159 ,0 ,0 ,3 ,0 ,0 ,0 ,0 ,3 ,0 ,1 ,0 ,1,38793 , 0 
63481.36,20,121 ,12 ,1231 ,0 ,0 ,1 ,0 ,0 ,0 ,0 ,1 ,0 ,0 ,0 ,0,35154 , 0 
63481.361,16,121 ,2 ,514 ,0 ,0 ,5 ,5 ,8 ,0 ,0 ,18 ,0 ,8 ,9 ,17,62699 , 0 
63481.444,10,121 ,14 ,518 ,0 ,0 ,6 ,0 ,0 ,0 ,0 ,6 ,0 ,1 ,0 ,1,33233 , 0 
63481.482,12,121 ,5 ,819 ,0 ,0 ,1 ,0 ,0 ,0 ,0 ,1 ,0 ,1 ,0 ,1,38642 , 0 
63481.596,9,121 ,16 ,770 ,0 ,0 ,1 ,3 ,0 ,1 ,0 ,5 ,0 ,7 ,2 ,9,57669 , 0 
63481.603,5,121 ,19 ,512 ,0 ,0 ,1 ,0 ,0 ,0 ,0 ,1 ,0 ,7 ,0 ,7,58812 , 0 
63481.606,19,121 ,1 ,256 ,0 ,0 ,1 ,0 ,0 ,0 ,0 ,1 ,0 ,6 ,0 ,6,37367 , 0 
63481.696,17,121 ,6 ,794 ,0 ,0 ,6 ,0 ,0 ,0 ,0 ,6 ,0 ,4 ,0 ,4,42821 , 0 
63481.771,13,121 ,1 ,256 ,0 ,0 ,2 ,0 ,0 ,0 ,0 ,2 ,0 ,4 ,0 ,4,33151 , 0 
63481.787,3,121 ,1 ,256 ,0 ,0 ,2 ,0 ,0 ,0 ,0 ,2 ,0 ,1 ,0 ,1,23297 , 0 
63600.96,8,121 ,1 ,256 ,0 ,0 ,0 ,0 ,0 ,0 ,0 ,0 ,0 ,0 ,0 ,0,26249 , 0 
63601.078,11,121 ,9 ,1068 ,0 ,0 ,2 ,1 ,0 ,0 ,0 ,3 ,0 ,6 ,0 ,6,40762 , 0 
63601.123,2,121 ,1 ,256 ,0 ,0 ,2 ,0 ,5 ,0 ,0 ,7 ,0 ,3 ,5 ,8,47691 , 0 
63601.138,6,121 ,2 ,512 ,0 ,0 ,1 ,1 ,0 ,0 ,0 ,2 ,0 ,5 ,0 ,5,66724 , 0 
63601.214,18,121 ,19 ,512 ,0 ,0 ,1 ,0 ,0 ,0 ,0 ,1 ,0 ,1 ,0 ,1,33082 , 0 
63601.236,4,121 ,19 ,512 ,0 ,0 ,0 ,0 ,0 ,0 ,0 ,0 ,0 ,1 ,0 ,1,30238 , 0 
63601.289,7,121 ,16 ,770 ,0 ,0 ,2 ,1 ,0 ,0 ,0 ,3 ,0 ,7 ,0 ,7,47969 , 0 
63601.337,14,121 ,1 ,256 ,0 ,0 ,1 ,0 ,0 ,0 ,0 ,1 ,0 ,0 ,0 ,0,29915 , 0 
63601.35,15,121 ,7 ,1159 ,0 ,0 ,3 ,0 ,0 ,0 ,0 ,3 ,0 ,2 ,0 ,2,36396 , 0 
63601.36,20,121 ,12 ,1209 ,0 ,0 ,2 ,0 ,0 ,0 ,0 ,2 ,0 ,3 ,0 ,3,31800 , 0 
63601.36,16,121 ,2 ,512 ,0 ,0 ,2 ,1 ,3 ,0 ,0 ,6 ,0 ,4 ,3 ,7,68727 , 0 
63601.444,10,121 ,14 ,518 ,0 ,0 ,1 ,0 ,0 ,0 ,0 ,1 ,0 ,0 ,0 ,0,33932 , 0 
63601.482,12,121 ,5 ,819 ,0 ,0 ,2 ,0 ,0 ,0 ,0 ,2 ,0 ,3 ,0 ,3,34725 , 0 
63601.596,9,121 ,16 ,770 ,0 ,0 ,3 ,1 ,1 ,0 ,0 ,5 ,0 ,6 ,1 ,7,59521 , 0 
63601.603,5,121 ,19 ,512 ,0 ,0 ,1 ,0 ,0 ,0 ,0 ,1 ,0 ,5 ,0 ,5,55874 , 0 
63601.606,19,121 ,1 ,256 ,0 ,0 ,1 ,0 ,0 ,0 ,0 ,1 ,0 ,2 ,0 ,2,35937 , 0 
63601.696,17,121 ,6 ,823 ,0 ,0 ,3 ,0 ,0 ,0 ,0 ,3 ,0 ,3 ,0 ,3,44279 , 0 
63601.771,13,121 ,1 ,256 ,0 ,0 ,1 ,0 ,0 ,0 ,0 ,1 ,0 ,1 ,0 ,1,32337 , 0 
63601.787,3,121 ,1 ,256 ,0 ,0 ,0 ,0 ,0 ,0 ,0 ,0 ,0 ,0 ,0 ,0,22770 , 0 
63720.96,8,121 ,1 ,256 ,0 ,0 ,0 ,0 ,0 ,0 ,0 ,0 ,0 ,1 ,0 ,1,26942 , 0 
63721.078,11,121 ,9 ,1068 ,0 ,0 ,2 ,0 ,0 ,0 ,0 ,2 ,0 ,1 ,0 ,1,44301 , 0 
63721.123,2,121 ,1 ,256 ,0 ,0 ,1 ,0 ,0 ,0 ,0 ,1 ,0 ,0 ,0 ,0,44950 , 0 
63721.138,6,121 ,2 ,512 ,0 ,0 ,1 ,0 ,0 ,0 ,0 ,1 ,0 ,2 ,0 ,2,56753 , 0 
63721.214,18,121 ,19 ,512 ,0 ,0 ,2 ,0 ,0 ,0 ,0 ,2 ,0 ,2 ,0 ,2,36227 , 0 
63721.236,4,121 ,19 ,512 ,0 ,0 ,1 ,1 ,0 ,0 ,0 ,2 ,0 ,1 ,0 ,1,32283 , 0 
63721.289,7,121 ,16 ,770 ,0 ,0 ,0 ,0 ,0 ,0 ,0 ,0 ,0 ,1 ,0 ,1,47654 , 0 
63721.337,14,121 ,1 ,256 ,0 ,0 ,0 ,0 ,0 ,0 ,0 ,0 ,0 ,2 ,0 ,2,30467 , 0 
63721.35,15,121 ,7 ,1159 ,0 ,0 ,2 ,0 ,0 ,0 ,0 ,2 ,0 ,1 ,0 ,1,38850 , 0 
63721.36,20,121 ,12 ,1209 ,0 ,0 ,1 ,0 ,0 ,0 ,0 ,1 ,0 ,1 ,0 ,1,35242 , 0 
63721.36,16,121 ,2 ,512 ,0 ,0 ,1 ,0 ,0 ,0 ,0 ,1 ,0 ,1 ,0 ,1,62774 , 0 
63721.444,10,121 ,14 ,518 ,0 ,0 ,1 ,0 ,0 ,0 ,0 ,1 ,0 ,1 ,0 ,1,33288 , 0 
63721.482,12,121 ,5 ,819 ,0 ,0 ,2 ,0 ,0 ,0 ,0 ,2 ,0 ,2 ,0 ,2,38717 , 0 
63721.596,9,121 ,16 ,770 ,0 ,0 ,0 ,0 ,0 ,0 ,0 ,0 ,0 ,1 ,0 ,1,57743 , 0 
63721.603,5,121 ,19 ,512 ,0 ,0 ,1 ,0 ,0 ,0 ,0 ,1 ,0 ,4 ,0 ,4,58927 , 0 
63721.606,19,121 ,1 ,256 ,0 ,0 ,1 ,0 ,1 ,0 ,0 ,2 ,0 ,0 ,1 ,1,37451 , 0 
63721.696,17,121 ,6 ,823 ,0 ,0 ,2 ,0 ,0 ,0 ,0 ,2 ,0 ,0 ,0 ,0,42897 , 0 
63721.771,13,121 ,1 ,256 ,0 ,0 ,1 ,0 ,0 ,0 ,0 ,1 ,0 ,1 ,0 ,1,33235 , 0 
63721.787,3,121 ,1 ,256 ,0 ,0 ,2 ,0 ,0 ,0 ,0 ,2 ,0 ,0 ,0 ,0,23354 , 0 
63840.96,8,121 ,1 ,256 ,0 ,0 ,0 ,0 ,0 ,0 ,0 ,0 ,0 ,4 ,0 ,4,26345 , 0 
63841.078,11,121 ,12 ,1244 ,0 ,0 ,4 ,3 ,0 ,1 ,0 ,8 ,0 ,19 ,0 ,19,40900 , 0 
63841.124,2,121 ,1 ,256 ,0 ,0 ,6 ,0 ,9 ,0 ,2 ,17 ,0 ,8 ,11 ,19,47823 , 0 
63841.214,18,121 ,19 ,512 ,0 ,0 ,1 ,0 ,0 ,0 ,0 ,1 ,0 ,5 ,0 ,5,33161 , 0 
63841.236,4,121 ,19 ,512 ,0 ,0 ,2 ,0 ,0 ,0 ,0 ,2 ,0 ,1 ,0 ,1,30325 , 0 
63841.246,6,121 ,2 ,525 ,0 ,0 ,5 ,2 ,8 ,0 ,0 ,15 ,0 ,13 ,8 ,21,66913 , 0 
63841.29,7,121 ,17 ,1129 ,0 ,0 ,6 ,4 ,2 ,1 ,0 ,13 ,0 ,19 ,2 ,21,48170 , 0 
63841.337,14,121 ,1 ,256 ,0 ,0 ,1 ,0 ,0 ,0 ,0 ,1 ,0 ,9 ,0 ,9,29989 , 0 
63841.35,15,121 ,7 ,1512 ,0 ,0 ,6 ,2 ,0 ,0 ,0 ,8 ,0 ,11 ,0 ,11,36518 , 0 
63841.36,20,121 ,12 ,1244 ,0 ,0 ,4 ,2 ,0 ,0 ,0 ,6 ,0 ,7 ,0 ,7,31912 , 0 
63841.361,16,121 ,2 ,512 ,0 ,0 ,6 ,0 ,1 ,0 ,2 ,9 ,0 ,15 ,3 ,18,68882 , 1 
63841.444,10,121 ,14 ,518 ,0 ,0 ,3 ,0 ,0 ,0 ,0 ,3 ,0 ,3 ,0 ,3,34010 , 0 
63841.482,12,121 ,5 ,855 ,0 ,0 ,4 ,2 ,5 ,0 ,0 ,11 ,0 ,7 ,5 ,12,34896 , 0 
63841.596,9,121 ,5 ,855 ,0 ,0 ,7 ,3 ,0 ,1 ,0 ,11 ,0 ,13 ,1 ,14,59698 , 0 
63841.603,5,121 ,19 ,512 ,0 ,0 ,5 ,0 ,10 ,0 ,0 ,15 ,0 ,14 ,10 ,24,56133 , 0 
63841.607,19,121 ,1 ,256 ,0 ,0 ,1 ,0 ,10 ,0 ,0 ,11 ,0 ,7 ,10 ,17,36049 , 0 
63841.697,17,121 ,6 ,809 ,0 ,0 ,9 ,3 ,5 ,0 ,0 ,17 ,0 ,8 ,5 ,13,44445 , 0 
63841.771,13,121 ,1 ,256 ,0 ,0 ,1 ,0 ,0 ,0 ,0 ,1 ,0 ,4 ,0 ,4,32413 , 0 
63841.787,3,121 ,1 ,256 ,0 ,0 ,2 ,0 ,0 ,0 ,0 ,2 ,0 ,0 ,0 ,0,22839 , 0 
63960.96,8,121 ,1 ,256 ,0 ,0 ,1 ,0 ,0 ,0 ,0 ,1 ,0 ,1 ,0 ,1,27003 , 0 
63961.078,11,121 ,12 ,1144 ,0 ,0 ,3 ,2 ,0 ,0 ,0 ,5 ,0 ,14 ,0 ,14,44438 , 0 
63961.124,2,121 ,1 ,256 ,0 ,0 ,9 ,0 ,38 ,1 ,0 ,48 ,0 ,13 ,40 ,53,45166 , 0 
63961.139,6,121 ,2 ,512 ,0 ,0 ,11 ,8 ,21 ,0 ,0 ,40 ,0 ,18 ,21 ,39,57095 , 0 
63961.214,18,121 ,19 ,512 ,0 ,0 ,1 ,0 ,0 ,0 ,0 ,1 ,0 ,5 ,0 ,5,36321 , 0 
63961.236,4,121 ,19 ,512 ,0 ,0 ,2 ,0 ,0 ,0 ,0 ,2 ,0 ,0 ,0 ,0,32362 , 0 
63961.29,7,121 ,17 ,1053 ,0 ,0 ,10 ,6 ,6 ,0 ,0 ,22 ,0 ,18 ,6 ,24,47851 , 0 
63961.337,14,121 ,1 ,256 ,0 ,0 ,1 ,0 ,0 ,0 ,0 ,1 ,0 ,9 ,0 ,9,30545 , 0 
63961.35,15,121 ,7 ,1353 ,0 ,0 ,3 ,6 ,0 ,0 ,0 ,9 ,0 ,17 ,0 ,17,38971 , 0 
63961.36,20,121 ,12 ,1154 ,0 ,0 ,4 ,3 ,0 ,0 ,0 ,7 ,0 ,7 ,0 ,7,35368 , 0 
63961.361,16,121 ,2 ,512 ,0 ,0 ,3 ,7 ,0 ,2 ,0 ,12 ,0 ,35 ,0 ,35,62955 , 1 
63961.444,10,121 ,14 ,518 ,0 ,0 ,1 ,0 ,0 ,0 ,0 ,1 ,0 ,9 ,0 ,9,33358 , 0 
63961.482,12,121 ,5 ,824 ,0 ,0 ,3 ,1 ,5 ,0 ,0 ,9 ,0 ,5 ,5 ,10,38854 , 0 
63961.596,9,121 ,5 ,800 ,0 ,0 ,9 ,1 ,0 ,0 ,0 ,10 ,0 ,14 ,0 ,14,57920 , 0 
63961.603,5,121 ,19 ,512 ,0 ,0 ,3 ,0 ,7 ,0 ,0 ,10 ,0 ,21 ,7 ,28,59083 , 0 
63961.607,19,121 ,1 ,256 ,0 ,0 ,2 ,0 ,7 ,0 ,0 ,9 ,0 ,11 ,7 ,18,37547 , 0 
63961.697,17,121 ,6 ,793 ,0 ,0 ,10 ,9 ,12 ,0 ,0 ,31 ,0 ,17 ,12 ,29,43133 , 0 
63961.771,13,121 ,1 ,256 ,0 ,0 ,1 ,0 ,0 ,0 ,0 ,1 ,0 ,10 ,0 ,10,33305 , 0 
63961.787,3,121 ,1 ,256 ,0 ,0 ,0 ,0 ,0 ,0 ,0 ,0 ,0 ,2 ,0 ,2,23424 , 0 
64080.96,8,121 ,1 ,256 ,0 ,0 ,0 ,0 ,0 ,0 ,0 ,0 ,0 ,0 ,0 ,0,26402 , 0 
64081.078,11,121 ,12 ,1144 ,0 ,0 ,2 ,0 ,0 ,0 ,0 ,2 ,0 ,9 ,0 ,9,40981 , 0 
64081.124,2,121 ,1 ,256 ,0 ,0 ,6 ,0 ,18 ,0 ,0 ,24 ,0 ,6 ,18 ,24,47957 , 0 
64081.139,6,121 ,2 ,512 ,0 ,0 ,6 ,4 ,11 ,0 ,0 ,21 ,0 ,11 ,11 ,22,67126 , 0 
64081.214,18,121 ,19 ,512 ,0 ,0 ,1 ,0 ,0 ,0 ,0 ,1 ,0 ,2 ,0 ,2,33225 , 0 
64081.236,4,121 ,19 ,512 ,0 ,0 ,1 ,0 ,0 ,0 ,0 ,1 ,0 ,0 ,0 ,0,30389 , 0 
64081.29,7,121 ,17 ,1026 ,0 ,0 ,5 ,3 ,4 ,0 ,0 ,12 ,0 ,12 ,4 ,16,48286 , 0 
64081.337,14,121 ,1 ,256 ,0 ,0 ,1 ,0 ,0 ,0 ,0 ,1 ,0 ,4 ,0 ,4,30074 , 0 
64081.35,15,121 ,7 ,1300 ,0 ,0 ,2 ,4 ,0 ,0 ,0 ,6 ,0 ,12 ,0 ,12,36611 , 0 
64081.36,20,121 ,12 ,1102 ,0 ,0 ,2 ,1 ,0 ,0 ,0 ,3 ,0 ,4 ,0 ,4,32021 , 0 
64081.36,16,121 ,2 ,512 ,0 ,0 ,2 ,3 ,0 ,0 ,0 ,5 ,0 ,24 ,0 ,24,69001 , 1 
64081.444,10,121 ,14 ,518 ,0 ,0 ,1 ,0 ,0 ,0 ,0 ,1 ,0 ,5 ,0 ,5,34083 , 0 
64081.482,12,121 ,5 ,787 ,0 ,0 ,2 ,1 ,1 ,0 ,0 ,4 ,0 ,3 ,1 ,4,34993 , 0 
64081.596,9,121 ,5 ,787 ,0 ,0 ,7 ,1 ,0 ,0 ,0 ,8 ,0 ,11 ,0 ,11,59823 , 0 
64081.603,5,121 ,19 ,512 ,0 ,0 ,3 ,0 ,3 ,0 ,0 ,6 ,0 ,15 ,3 ,18,56297 , 0 
64081.607,19,121 ,1 ,256 ,0 ,0 ,0 ,0 ,3 ,0 ,0 ,3 ,0 ,7 ,3 ,10,36146 , 0 
64081.697,17,121 ,6 ,768 ,0 ,0 ,6 ,4 ,7 ,0 ,0 ,17 ,0 ,10 ,7 ,17,44623 , 0 
64081.771,13,121 ,1 ,256 ,0 ,0 ,1 ,0 ,0 ,0 ,0 ,1 ,0 ,8 ,0 ,8,32563 , 0 
64081.787,3,121 ,1 ,256 ,0 ,0 ,1 ,0 ,0 ,0 ,0 ,1 ,0 ,0 ,0 ,0,22892 , 0 
64200.96,8,121 ,1 ,256 ,0 ,0 ,0 ,0 ,0 ,0 ,0 ,0 ,0 ,1 ,0 ,1,27057 , 0 
64201.078,11,121 ,12 ,1106 ,0 ,0 ,1 ,1 ,0 ,0 ,0 ,2 ,0 ,6 ,0 ,6,44500 , 0 
64201.124,2,121 ,1 ,256 ,0 ,0 ,3 ,0 ,11 ,0 ,1 ,15 ,0 ,1 ,12 ,13,45277 , 0 
64201.138,6,121 ,2 ,512 ,0 ,0 ,3 ,1 ,5 ,0 ,1 ,10 ,0 ,3 ,6 ,9,57212 , 0 
64201.217,18,121 ,19 ,512 ,0 ,0 ,1 ,1 ,0 ,0 ,0 ,2 ,0 ,2 ,0 ,2,36385 , 0 
64201.236,4,121 ,19 ,512 ,0 ,0 ,1 ,0 ,0 ,0 ,0 ,1 ,0 ,1 ,0 ,1,32417 , 0 
64201.289,7,121 ,16 ,775 ,0 ,0 ,6 ,2 ,3 ,1 ,0 ,12 ,0 ,4 ,3 ,7,47981 , 0 
64201.337,14,121 ,1 ,256 ,0 ,0 ,1 ,0 ,0 ,0 ,0 ,1 ,0 ,4 ,0 ,4,30609 , 0 
64201.35,15,121 ,7 ,1085 ,0 ,0 ,1 ,3 ,0 ,0 ,0 ,4 ,0 ,6 ,0 ,6,39073 , 0 
64201.36,20,121 ,12 ,1102 ,0 ,0 ,2 ,0 ,0 ,0 ,0 ,2 ,0 ,0 ,0 ,0,35428 , 0 
64201.361,16,121 ,2 ,512 ,0 ,0 ,1 ,2 ,3 ,0 ,0 ,6 ,0 ,11 ,3 ,14,63093 , 0 
64201.444,10,121 ,14 ,518 ,0 ,0 ,3 ,0 ,0 ,0 ,0 ,3 ,0 ,2 ,0 ,2,33431 , 0 
64201.482,12,121 ,5 ,787 ,0 ,0 ,1 ,0 ,1 ,0 ,0 ,2 ,0 ,1 ,1 ,2,38931 , 0 
64201.596,9,121 ,5 ,787 ,0 ,0 ,2 ,0 ,0 ,0 ,0 ,2 ,0 ,5 ,0 ,5,58012 , 0 
64201.603,5,121 ,19 ,512 ,0 ,0 ,0 ,0 ,1 ,0 ,0 ,1 ,0 ,5 ,1 ,6,59175 , 0 
64201.606,19,121 ,1 ,256 ,0 ,0 ,1 ,0 ,2 ,0 ,0 ,3 ,0 ,1 ,2 ,3,37623 , 0 
64201.696,17,121 ,6 ,768 ,0 ,0 ,2 ,3 ,2 ,0 ,1 ,8 ,0 ,5 ,3 ,8,43236 , 0 
64201.771,13,121 ,1 ,256 ,0 ,0 ,1 ,0 ,0 ,0 ,0 ,1 ,0 ,1 ,0 ,1,33364 , 0 
64201.787,3,121 ,1 ,256 ,0 ,0 ,2 ,0 ,0 ,0 ,0 ,2 ,0 ,1 ,0 ,1,23488 , 0 
64320.96,8,121 ,1 ,256 ,0 ,0 ,0 ,0 ,0 ,0 ,0 ,0 ,0 ,1 ,0 ,1,26463 , 0 
64321.078,11,121 ,12 ,1099 ,0 ,0 ,2 ,0 ,0 ,0 ,0 ,2 ,0 ,5 ,0 ,5,41067 , 0 
64321.123,2,121 ,1 ,256 ,0 ,0 ,1 ,0 ,5 ,0 ,0 ,6 ,0 ,2 ,6 ,8,48037 , 0 
64321.138,6,121 ,2 ,512 ,0 ,0 ,2 ,1 ,1 ,1 ,0 ,5 ,0 ,3 ,2 ,5,67238 , 0 
64321.214,18,121 ,19 ,512 ,0 ,0 ,1 ,0 ,0 ,0 ,0 ,1 ,0 ,3 ,0 ,3,33299 , 0 
64321.236,4,121 ,19 ,512 ,0 ,0 ,0 ,0 ,0 ,0 ,0 ,0 ,0 ,0 ,0 ,0,30449 , 0 
64321.289,7,121 ,16 ,775 ,0 ,0 ,3 ,0 ,3 ,0 ,0 ,6 ,0 ,5 ,3 ,8,48374 , 0 
64321.337,14,121 ,1 ,256 ,0 ,0 ,1 ,0 ,0 ,0 ,0 ,1 ,0 ,2 ,0 ,2,30129 , 0 
64321.35,15,121 ,7 ,1069 ,0 ,0 ,2 ,3 ,0 ,0 ,0 ,5 ,0 ,6 ,0 ,6,36728 , 0 
64321.36,20,121 ,12 ,1099 ,0 ,0 ,1 ,1 ,0 ,0 ,0 ,2 ,0 ,3 ,0 ,3,32099 , 0 
64321.36,16,121 ,2 ,512 ,0 ,0 ,1 ,0 ,3 ,0 ,0 ,4 ,0 ,7 ,3 ,10,69106 , 0 
64321.444,10,121 ,14 ,518 ,0 ,0 ,1 ,0 ,0 ,0 ,0 ,1 ,0 ,1 ,0 ,1,34139 , 0 
64321.482,12,121 ,5 ,787 ,0 ,0 ,1 ,0 ,1 ,0 ,0 ,2 ,0 ,3 ,1 ,4,35109 , 0 
64321.596,9,121 ,5 ,800 ,0 ,0 ,2 ,1 ,0 ,0 ,0 ,3 ,0 ,6 ,0 ,6,59911 , 0 
64321.603,5,121 ,19 ,512 ,0 ,0 ,3 ,0 ,2 ,0 ,0 ,5 ,0 ,4 ,2 ,6,56417 , 0 
64321.606,19,121 ,1 ,256 ,0 ,0 ,1 ,0 ,2 ,0 ,0 ,3 ,0 ,2 ,2 ,4,36248 , 0 
64321.696,17,121 ,6 ,768 ,0 ,0 ,2 ,1 ,0 ,1 ,0 ,4 ,0 ,4 ,0 ,4,44709 , 0 
64321.771,13,121 ,1 ,256 ,0 ,0 ,1 ,0 ,0 ,0 ,0 ,1 ,0 ,2 ,0 ,2,32624 , 0 
64321.787,3,121 ,1 ,256 ,0 ,0 ,0 ,0 ,0 ,0 ,0 ,0 ,0 ,0 ,0 ,0,22942 , 0 
64440.96,8,121 ,1 ,256 ,0 ,0 ,0 ,0 ,0 ,0 ,0 ,0 ,0 ,1 ,0 ,1,27120 , 0 
64441.078,11,121 ,12 ,1093 ,0 ,0 ,1 ,1 ,0 ,0 ,0 ,2 ,0 ,2 ,0 ,2,44600 , 0 
64441.123,2,121 ,1 ,256 ,0 ,0 ,1 ,0 ,1 ,0 ,0 ,2 ,0 ,1 ,1 ,2,45383 , 0 
64441.138,6,121 ,2 ,512 ,0 ,0 ,2 ,0 ,0 ,0 ,0 ,2 ,0 ,0 ,0 ,0,57299 , 0 
64441.214,18,121 ,19 ,512 ,0 ,0 ,1 ,0 ,0 ,0 ,0 ,1 ,0 ,1 ,0 ,1,36452 , 0 
64441.236,4,121 ,19 ,512 ,0 ,0 ,2 ,0 ,0 ,0 ,0 ,2 ,0 ,0 ,0 ,0,32505 , 0 
64441.289,7,121 ,16 ,775 ,0 ,0 ,2 ,0 ,1 ,0 ,0 ,3 ,0 ,1 ,1 ,2,48076 , 0 
64441.337,14,121 ,1 ,256 ,0 ,0 ,1 ,0 ,0 ,0 ,0 ,1 ,0 ,1 ,0 ,1,30688 , 0 
64441.35,15,121 ,7 ,1069 ,0 ,0 ,1 ,1 ,0 ,0 ,0 ,2 ,0 ,1 ,0 ,1,39152 , 0 
64441.36,20,121 ,12 ,1099 ,0 ,0 ,1 ,0 ,0 ,0 ,0 ,1 ,0 ,1 ,0 ,1,35504 , 0 
64441.36,16,121 ,2 ,512 ,0 ,0 ,1 ,0 ,1 ,0 ,0 ,2 ,0 ,2 ,1 ,3,63192 , 0 
64441.444,10,121 ,14 ,518 ,0 ,0 ,1 ,0 ,0 ,0 ,0 ,1 ,0 ,1 ,0 ,1,33502 , 0 
64441.482,12,121 ,5 ,787 ,0 ,0 ,1 ,0 ,1 ,0 ,0 ,2 ,0 ,0 ,1 ,1,39000 , 0 
64441.596,9,121 ,5 ,800 ,0 ,0 ,1 ,0 ,0 ,0 ,0 ,1 ,0 ,4 ,0 ,4,58119 , 0 
64441.602,5,121 ,19 ,512 ,0 ,0 ,0 ,0 ,1 ,0 ,0 ,1 ,0 ,2 ,1 ,3,59264 , 0 
64441.606,19,121 ,1 ,256 ,0 ,0 ,1 ,0 ,1 ,0 ,0 ,2 ,0 ,2 ,1 ,3,37741 , 0 
64441.696,17,121 ,6 ,768 ,0 ,0 ,1 ,0 ,0 ,0 ,0 ,1 ,0 ,1 ,0 ,1,43310 , 0 
64441.771,13,121 ,1 ,256 ,0 ,0 ,1 ,0 ,0 ,0 ,0 ,1 ,0 ,1 ,0 ,1,33444 , 0 
64441.787,3,121 ,1 ,256 ,0 ,0 ,1 ,0 ,0 ,0 ,0 ,1 ,0 ,0 ,0 ,0,23538 , 0 
64560.96,8,121 ,1 ,256 ,0 ,0 ,0 ,0 ,0 ,0 ,0 ,0 ,0 ,2 ,0 ,2,26529 , 0 
64561.078,11,121 ,12 ,1093 ,0 ,0 ,1 ,0 ,0 ,0 ,0 ,1 ,0 ,2 ,0 ,2,41137 , 0 
64561.124,2,121 ,1 ,256 ,0 ,0 ,2 ,0 ,9 ,0 ,1 ,12 ,0 ,2 ,11 ,13,48167 , 0 
64561.138,6,121 ,2 ,512 ,0 ,0 ,2 ,1 ,7 ,0 ,0 ,10 ,0 ,3 ,7 ,10,67369 , 0 
64561.214,18,121 ,19 ,512 ,0 ,0 ,0 ,0 ,0 ,0 ,0 ,0 ,0 ,1 ,0 ,1,33356 , 0 
64561.236,4,121 ,19 ,512 ,0 ,0 ,0 ,0 ,0 ,0 ,0 ,0 ,0 ,0 ,0 ,0,30500 , 0 
64561.289,7,121 ,17 ,1024 ,0 ,0 ,4 ,2 ,3 ,1 ,0 ,10 ,0 ,3 ,3 ,6,48473 , 0 
64561.337,14,121 ,1 ,256 ,0 ,0 ,1 ,0 ,0 ,0 ,0 ,1 ,0 ,2 ,0 ,2,30209 , 0 
64561.35,15,121 ,7 ,1281 ,0 ,0 ,2 ,3 ,0 ,0 ,0 ,5 ,0 ,6 ,0 ,6,36813 , 0 
64561.36,20,121 ,12 ,1099 ,0 ,0 ,1 ,0 ,0 ,0 ,0 ,1 ,0 ,1 ,0 ,1,32169 , 0 
64561.36,16,121 ,2 ,512 ,0 ,0 ,1 ,1 ,0 ,1 ,1 ,4 ,0 ,8 ,1 ,9,69218 , 1 
64561.444,10,121 ,14 ,518 ,0 ,0 ,1 ,0 ,0 ,0 ,0 ,1 ,0 ,1 ,0 ,1,34200 , 0 
64561.482,12,121 ,5 ,787 ,0 ,0 ,1 ,0 ,0 ,0 ,0 ,1 ,0 ,1 ,0 ,1,35189 , 0 
64561.596,9,121 ,5 ,800 ,0 ,0 ,2 ,0 ,0 ,0 ,0 ,2 ,0 ,4 ,0 ,4,60000 , 0 
64561.603,5,121 ,19 ,512 ,0 ,0 ,2 ,0 ,0 ,0 ,0 ,2 ,0 ,2 ,0 ,2,56533 , 0 
64561.606,19,121 ,1 ,256 ,0 ,0 ,1 ,0 ,0 ,0 ,0 ,1 ,0 ,1 ,0 ,1,36316 , 0 
64561.696,17,121 ,6 ,768 ,0 ,0 ,2 ,2 ,5 ,0 ,0 ,9 ,0 ,5 ,5 ,10,44804 , 0 
64561.771,13,121 ,1 ,256 ,0 ,0 ,1 ,0 ,0 ,0 ,0 ,1 ,0 ,2 ,0 ,2,32713 , 0 
64561.787,3,121 ,1 ,256 ,0 ,0 ,2 ,0 ,0 ,0 ,0 ,2 ,0 ,1 ,0 ,1,23018 , 0 
64680.96,8,121 ,1 ,256 ,0 ,0 ,0 ,0 ,0 ,0 ,0 ,0 ,0 ,2 ,0 ,2,27174 , 0 
64681.078,11,121 ,12 ,1093 ,0 ,0 ,1 ,0 ,0 ,0 ,0 ,1 ,0 ,3 ,0 ,3,44666 , 0 
64681.123,2,121 ,1 ,256 ,0 ,0 ,1 ,0 ,2 ,0 ,0 ,3 ,0 ,5 ,2 ,7,45446 , 0 
64681.138,6,121 ,2 ,512 ,0 ,0 ,1 ,0 ,2 ,0 ,0 ,3 ,0 ,1 ,2 ,3,57377 , 0 
64681.214,18,121 ,19 ,523 ,0 ,0 ,2 ,0 ,0 ,0 ,0 ,2 ,0 ,2 ,0 ,2,36540 , 0 
64681.236,4,121 ,19 ,523 ,0 ,0 ,1 ,0 ,0 ,0 ,0 ,1 ,0 ,2 ,0 ,2,32574 , 0 
64681.289,7,121 ,17 ,1024 ,0 ,0 ,2 ,1 ,1 ,0 ,0 ,4 ,0 ,2 ,1 ,3,48147 , 0 
64681.337,14,121 ,1 ,256 ,0 ,0 ,2 ,0 ,1 ,0 ,0 ,3 ,0 ,3 ,1 ,4,30756 , 0 
64681.35,15,121 ,7 ,1280 ,0 ,0 ,0 ,1 ,0 ,0 ,0 ,1 ,0 ,1 ,0 ,1,39205 , 0 
64681.36,20,121 ,12 ,1099 ,0 ,0 ,1 ,0 ,0 ,0 ,0 ,1 ,0 ,1 ,0 ,1,35578 , 0 
64681.36,16,121 ,2 ,512 ,0 ,0 ,2 ,0 ,0 ,0 ,0 ,2 ,0 ,1 ,0 ,1,63257 , 1 
64681.444,10,121 ,14 ,512 ,0 ,0 ,1 ,1 ,0 ,0 ,0 ,2 ,0 ,2 ,0 ,2,33557 , 0 
64681.482,12,121 ,5 ,781 ,0 ,0 ,1 ,1 ,0 ,0 ,0 ,2 ,0 ,1 ,0 ,1,39076 , 0 
64681.596,9,121 ,5 ,781 ,0 ,0 ,1 ,1 ,0 ,0 ,0 ,2 ,0 ,4 ,0 ,4,58186 , 0 
64681.603,5,121 ,19 ,523 ,0 ,0 ,1 ,1 ,2 ,0 ,0 ,4 ,0 ,6 ,2 ,8,59387 , 0 
64681.606,19,121 ,1 ,256 ,0 ,0 ,1 ,0 ,3 ,0 ,0 ,4 ,0 ,3 ,3 ,6,37823 , 0 
64681.696,17,121 ,6 ,768 ,0 ,0 ,1 ,0 ,2 ,0 ,0 ,3 ,0 ,3 ,2 ,5,43387 , 0 
64681.771,13,121 ,1 ,256 ,0 ,0 ,3 ,0 ,0 ,0 ,0 ,3 ,0 ,3 ,0 ,3,33514 , 0 
64681.787,3,121 ,1 ,256 ,0 ,0 ,0 ,0 ,0 ,0 ,0 ,0 ,0 ,1 ,0 ,1,23588 , 0 
64800.96,8,121 ,1 ,256 ,0 ,0 ,0 ,0 ,0 ,0 ,0 ,0 ,0 ,2 ,0 ,2,26595 , 0 
64801.078,11,121 ,12 ,1093 ,0 ,0 ,2 ,0 ,0 ,0 ,0 ,2 ,0 ,3 ,0 ,3,41216 , 0 
64801.123,2,121 ,1 ,256 ,0 ,0 ,2 ,0 ,1 ,0 ,0 ,3 ,0 ,3 ,1 ,4,48287 , 0 
64801.138,6,121 ,2 ,512 ,0 ,0 ,1 ,0 ,1 ,0 ,0 ,2 ,0 ,2 ,1 ,3,67471 , 0 
64801.214,18,121 ,19 ,523 ,0 ,0 ,0 ,0 ,0 ,0 ,0 ,0 ,0 ,2 ,0 ,2,33427 , 0 
64801.236,4,121 ,19 ,523 ,0 ,0 ,2 ,0 ,0 ,0 ,0 ,2 ,0 ,0 ,0 ,0,30597 , 0 
64801.289,7,121 ,17 ,1024 ,0 ,0 ,2 ,0 ,1 ,0 ,0 ,3 ,0 ,2 ,1 ,3,48572 , 0 
64801.337,14,121 ,1 ,256 ,0 ,0 ,1 ,0 ,0 ,0 ,0 ,1 ,0 ,2 ,0 ,2,30280 , 0 
64801.35,15,121 ,7 ,1280 ,0 ,0 ,3 ,1 ,0 ,0 ,0 ,4 ,0 ,3 ,0 ,3,36920 , 0 
64801.36,20,121 ,12 ,1099 ,0 ,0 ,2 ,0 ,0 ,0 ,0 ,2 ,0 ,1 ,0 ,1,32229 , 0 
64801.36,16,121 ,2 ,512 ,0 ,0 ,2 ,0 ,0 ,0 ,0 ,2 ,0 ,2 ,0 ,2,69311 , 1 
64801.444,10,121 ,14 ,512 ,0 ,0 ,1 ,0 ,0 ,0 ,0 ,1 ,0 ,1 ,0 ,1,34265 , 0 
64801.482,12,121 ,5 ,781 ,0 ,0 ,1 ,0 ,0 ,0 ,0 ,1 ,0 ,2 ,0 ,2,35273 , 0 
64801.596,9,121 ,5 ,781 ,0 ,0 ,1 ,0 ,0 ,0 ,0 ,1 ,0 ,5 ,0 ,5,60134 , 0 
64801.603,5,121 ,19 ,523 ,0 ,0 ,1 ,0 ,0 ,0 ,0 ,1 ,0 ,3 ,0 ,3,56633 , 0 
64801.606,19,121 ,1 ,256 ,0 ,0 ,2 ,0 ,0 ,0 ,0 ,2 ,0 ,2 ,0 ,2,36436 , 0 
64801.696,17,121 ,6 ,768 ,0 ,0 ,0 ,0 ,1 ,0 ,0 ,1 ,0 ,1 ,1 ,2,44876 , 0 
64801.771,13,121 ,1 ,256 ,0 ,0 ,1 ,0 ,0 ,0 ,0 ,1 ,0 ,1 ,0 ,1,32794 , 0 
64801.787,3,121 ,1 ,256 ,0 ,0 ,2 ,0 ,0 ,0 ,0 ,2 ,0 ,0 ,0 ,0,23082 , 0 
64920.96,8,121 ,1 ,256 ,0 ,0 ,1 ,0 ,0 ,0 ,0 ,1 ,0 ,4 ,0 ,4,27247 , 0 
64921.078,11,121 ,12 ,1082 ,0 ,0 ,1 ,1 ,0 ,0 ,0 ,2 ,0 ,3 ,0 ,3,44751 , 0 
64921.123,2,121 ,1 ,256 ,0 ,0 ,2 ,0 ,4 ,0 ,0 ,6 ,0 ,0 ,4 ,4,45524 , 0 
64921.138,6,121 ,2 ,512 ,0 ,0 ,1 ,1 ,2 ,0 ,0 ,4 ,0 ,2 ,2 ,4,57454 , 0 
64921.214,18,121 ,19 ,523 ,0 ,0 ,2 ,0 ,0 ,0 ,0 ,2 ,0 ,2 ,0 ,2,36608 , 0 
64921.236,4,121 ,19 ,523 ,0 ,0 ,2 ,0 ,0 ,0 ,0 ,2 ,0 ,3 ,0 ,3,32651 , 0 
64921.289,7,121 ,17 ,1024 ,0 ,0 ,2 ,0 ,1 ,0 ,0 ,3 ,0 ,0 ,1 ,1,48224 , 0 
64921.337,14,121 ,1 ,256 ,0 ,0 ,2 ,0 ,0 ,0 ,0 ,2 ,0 ,2 ,0 ,2,30814 , 0 
64921.35,15,121 ,7 ,1280 ,0 ,0 ,1 ,1 ,0 ,0 ,0 ,2 ,0 ,1 ,0 ,1,39269 , 0 
64921.36,20,121 ,12 ,1073 ,0 ,0 ,1 ,2 ,0 ,0 ,0 ,3 ,0 ,3 ,0 ,3,35658 , 0 
64921.36,16,121 ,2 ,512 ,0 ,0 ,1 ,1 ,0 ,0 ,0 ,2 ,0 ,4 ,0 ,4,63347 , 0 
64921.444,10,121 ,14 ,512 ,0 ,0 ,1 ,0 ,0 ,0 ,0 ,1 ,0 ,0 ,0 ,0,33608 , 0 
64921.482,12,121 ,5 ,781 ,0 ,0 ,2 ,0 ,3 ,0 ,0 ,5 ,0 ,1 ,3 ,4,39180 , 0 
64921.596,9,121 ,5 ,781 ,0 ,0 ,1 ,0 ,0 ,0 ,0 ,1 ,0 ,2 ,0 ,2,58263 , 0 
64921.603,5,121 ,19 ,517 ,0 ,0 ,2 ,1 ,3 ,0 ,0 ,6 ,0 ,7 ,3 ,10,59503 , 0 
64921.606,19,121 ,1 ,256 ,0 ,0 ,1 ,0 ,4 ,0 ,0 ,5 ,0 ,4 ,4 ,8,37895 , 0 
64921.696,17,121 ,6 ,777 ,0 ,0 ,1 ,1 ,1 ,0 ,0 ,3 ,0 ,2 ,1 ,3,43471 , 0 
64921.771,13,121 ,1 ,256 ,0 ,0 ,1 ,0 ,0 ,0 ,0 ,1 ,0 ,2 ,0 ,2,33589 , 0 
64921.787,3,121 ,1 ,256 ,0 ,0 ,2 ,0 ,0 ,0 ,0 ,2 ,0 ,2 ,0 ,2,23661 , 0 
65040.96,8,121 ,1 ,256 ,0 ,0 ,0 ,0 ,0 ,0 ,0 ,0 ,0 ,0 ,0 ,0,26651 , 0 
65041.078,11,121 ,5 ,774 ,0 ,0 ,4 ,1 ,0 ,1 ,0 ,6 ,0 ,7 ,0 ,7,41318 , 0 
65041.123,2,121 ,1 ,256 ,0 ,0 ,1 ,0 ,1 ,1 ,1 ,4 ,0 ,1 ,3 ,4,48364 , 0 
65041.138,6,121 ,2 ,512 ,0 ,0 ,2 ,0 ,1 ,1 ,1 ,5 ,0 ,2 ,3 ,5,67578 , 0 
65041.214,18,121 ,19 ,523 ,0 ,0 ,1 ,0 ,0 ,0 ,0 ,1 ,0 ,1 ,0 ,1,33488 , 0 
65041.236,4,121 ,19 ,523 ,0 ,0 ,1 ,0 ,0 ,0 ,0 ,1 ,0 ,0 ,0 ,0,30648 , 0 
65041.289,7,121 ,17 ,1033 ,0 ,0 ,1 ,1 ,0 ,1 ,1 ,4 ,0 ,6 ,1 ,7,48638 , 0 
65041.337,14,121 ,1 ,256 ,0 ,0 ,1 ,0 ,1 ,0 ,0 ,2 ,0 ,1 ,1 ,2,30348 , 0 
65041.35,15,121 ,9 ,1084 ,0 ,0 ,6 ,1 ,0 ,1 ,0 ,8 ,0 ,5 ,0 ,5,37016 , 0 
65041.36,20,121 ,12 ,1073 ,0 ,0 ,1 ,0 ,0 ,0 ,0 ,1 ,0 ,3 ,0 ,3,32316 , 0 
65041.36,16,121 ,2 ,512 ,0 ,0 ,1 ,0 ,0 ,0 ,0 ,1 ,0 ,3 ,0 ,3,69371 , 0 
65041.444,10,121 ,14 ,512 ,0 ,0 ,1 ,1 ,0 ,0 ,0 ,2 ,0 ,2 ,0 ,2,34331 , 0 
65041.482,12,121 ,5 ,781 ,0 ,0 ,1 ,0 ,0 ,0 ,1 ,2 ,0 ,3 ,1 ,4,35355 , 0 
65041.596,9,121 ,5 ,781 ,0 ,0 ,1 ,0 ,1 ,0 ,0 ,2 ,0 ,9 ,1 ,10,60205 , 0 
65041.603,5,121 ,19 ,517 ,0 ,0 ,1 ,0 ,2 ,0 ,1 ,4 ,0 ,4 ,3 ,7,56765 , 0 
65041.606,19,121 ,1 ,256 ,0 ,0 ,1 ,0 ,2 ,0 ,1 ,4 ,0 ,2 ,3 ,5,36519 , 0 
65041.696,17,121 ,6 ,774 ,0 ,0 ,2 ,0 ,1 ,1 ,1 ,5 ,0 ,1 ,3 ,4,44972 , 0 
65041.771,13,121 ,1 ,256 ,0 ,0 ,1 ,0 ,0 ,0 ,0 ,1 ,0 ,1 ,0 ,1,32867 , 0 
65041.787,3,121 ,1 ,256 ,0 ,0 ,1 ,0 ,0 ,0 ,0 ,1 ,0 ,0 ,0 ,0,23134 , 0 
65160.96,8,121 ,1 ,256 ,0 ,0 ,0 ,0 ,0 ,0 ,0 ,0 ,0 ,0 ,0 ,0,27304 , 0 
65161.078,11,121 ,5 ,774 ,0 ,0 ,2 ,0 ,0 ,0 ,0 ,2 ,0 ,3 ,0 ,3,44831 , 0 
65161.123,2,121 ,1 ,256 ,0 ,0 ,1 ,0 ,1 ,0 ,1 ,3 ,0 ,3 ,2 ,5,45640 , 0 
65161.138,6,121 ,2 ,512 ,0 ,0 ,1 ,0 ,0 ,0 ,1 ,2 ,0 ,2 ,1 ,3,57528 , 0 
65161.214,18,121 ,19 ,523 ,0 ,0 ,1 ,0 ,0 ,0 ,0 ,1 ,0 ,2 ,0 ,2,36700 , 0 
65161.236,4,121 ,19 ,523 ,0 ,0 ,1 ,0 ,0 ,0 ,0 ,1 ,0 ,0 ,0 ,0,32738 , 0 
65161.289,7,121 ,16 ,771 ,0 ,0 ,4 ,1 ,0 ,1 ,0 ,6 ,0 ,3 ,0 ,3,48330 , 0 
65161.337,14,121 ,1 ,256 ,0 ,0 ,1 ,0 ,0 ,0 ,0 ,1 ,0 ,2 ,0 ,2,30900 , 0 
65161.35,15,121 ,9 ,1084 ,0 ,0 ,1 ,0 ,0 ,0 ,0 ,1 ,0 ,5 ,0 ,5,39364 , 0 
65161.36,20,121 ,12 ,1073 ,0 ,0 ,1 ,0 ,0 ,0 ,0 ,1 ,0 ,2 ,0 ,2,35716 , 0 
65161.36,16,121 ,2 ,512 ,0 ,0 ,1 ,0 ,1 ,0 ,0 ,2 ,0 ,5 ,1 ,6,63427 , 0 
65161.444,10,121 ,14 ,512 ,0 ,0 ,2 ,0 ,0 ,0 ,0 ,2 ,0 ,1 ,0 ,1,33670 , 0 
65161.482,12,121 ,5 ,781 ,0 ,0 ,1 ,0 ,0 ,1 ,0 ,2 ,0 ,3 ,0 ,3,39299 , 0 
65161.596,9,121 ,5 ,781 ,0 ,0 ,1 ,0 ,0 ,0 ,0 ,1 ,0 ,6 ,0 ,6,58388 , 0 
65161.603,5,121 ,19 ,517 ,0 ,0 ,2 ,0 ,0 ,0 ,0 ,2 ,0 ,2 ,1 ,3,59625 , 0 
65161.606,19,121 ,1 ,256 ,0 ,0 ,1 ,0 ,0 ,0 ,0 ,1 ,0 ,1 ,0 ,1,38009 , 0 
65161.696,17,121 ,6 ,774 ,0 ,0 ,1 ,0 ,0 ,0 ,1 ,2 ,0 ,3 ,1 ,4,43548 , 0 
65161.771,13,121 ,1 ,256 ,0 ,0 ,1 ,0 ,0 ,0 ,0 ,1 ,0 ,1 ,0 ,1,33703 , 0 
65161.787,3,121 ,1 ,256 ,0 ,0 ,1 ,0 ,0 ,0 ,0 ,1 ,0 ,0 ,0 ,0,23725 , 0 
65280.961,8,156 ,1 ,256 ,0 ,0 ,17 ,11 ,3 ,14 ,3 ,48 ,0 ,37 ,10 ,47,27107 , 0 
65281.078,11,155 ,9 ,1553 ,0 ,0 ,18 ,1 ,0 ,2 ,0 ,21 ,0 ,54 ,0 ,54,41650 , 0 
65281.124,2,157 ,1 ,256 ,0 ,0 ,15 ,4 ,1 ,10 ,4 ,34 ,0 ,47 ,8 ,55,48673 , 0 
65281.138,6,157 ,2 ,512 ,0 ,0 ,18 ,3 ,2 ,5 ,1 ,29 ,0 ,40 ,4 ,44,68010 , 0 
65281.214,18,152 ,19 ,512 ,0 ,0 ,16 ,4 ,1 ,4 ,0 ,25 ,0 ,32 ,4 ,36,33875 , 0 
65281.236,4,156 ,19 ,512 ,0 ,0 ,15 ,7 ,1 ,12 ,1 ,36 ,0 ,26 ,2 ,28,31219 , 0 
65281.29,7,160 ,16 ,65535 ,0 ,0 ,20 ,0 ,2 ,1 ,0 ,23 ,0 ,41 ,10 ,51,48976 , 1 
65281.338,14,156 ,1 ,256 ,0 ,0 ,16 ,7 ,4 ,15 ,4 ,46 ,0 ,41 ,14 ,55,30739 , 0 
65281.35,15,157 ,7 ,1041 ,0 ,0 ,16 ,1 ,0 ,2 ,0 ,19 ,0 ,34 ,0 ,34,37259 , 0 
65281.36,20,155 ,5 ,1882 ,0 ,0 ,17 ,0 ,0 ,2 ,0 ,19 ,0 ,34 ,0 ,34,32569 , 0 
65281.361,16,157 ,2 ,512 ,0 ,0 ,18 ,1 ,0 ,5 ,0 ,24 ,0 ,41 ,3 ,44,69797 , 0 
65281.444,10,155 ,14 ,531 ,0 ,0 ,13 ,5 ,0 ,8 ,0 ,26 ,0 ,20 ,1 ,21,34677 , 0 
65281.482,12,155 ,18 ,824 ,0 ,0 ,18 ,1 ,0 ,4 ,1 ,24 ,0 ,37 ,1 ,38,35640 , 0 
65281.596,9,155 ,7 ,1041 ,0 ,0 ,18 ,0 ,0 ,2 ,1 ,21 ,0 ,45 ,10 ,55,60526 , 0 
65281.603,5,156 ,19 ,512 ,0 ,0 ,17 ,2 ,3 ,10 ,3 ,35 ,0 ,61 ,16 ,77,57300 , 0 
65281.607,19,156 ,1 ,256 ,0 ,0 ,17 ,6 ,8 ,15 ,8 ,54 ,0 ,55 ,32 ,87,37037 , 0 
65281.697,17,157 ,7 ,1041 ,0 ,0 ,16 ,1 ,2 ,3 ,0 ,22 ,0 ,31 ,7 ,38,45296 , 0 
65281.772,13,156 ,1 ,256 ,0 ,0 ,17 ,6 ,0 ,10 ,0 ,33 ,0 ,38 ,3 ,41,33270 , 0 
65281.787,3,156 ,1 ,256 ,0 ,0 ,12 ,6 ,0 ,8 ,0 ,26 ,0 ,24 ,3 ,27,23426 , 0 
65400.961,8,190 ,1 ,256 ,0 ,0 ,14 ,7 ,1 ,8 ,0 ,30 ,0 ,39 ,3 ,42,27589 , 0 
65401.078,11,193 ,5 ,806 ,0 ,0 ,22 ,4 ,0 ,4 ,0 ,30 ,0 ,68 ,3 ,71,45307 , 0 
65401.124,2,190 ,1 ,256 ,0 ,0 ,18 ,8 ,8 ,11 ,4 ,49 ,0 ,58 ,14 ,72,46108 , 0 
65401.139,6,193 ,16 ,1452 ,0 ,0 ,19 ,3 ,1 ,4 ,1 ,28 ,0 ,49 ,3 ,52,57952 , 0 
65401.222,18,189 ,0 ,0 ,0 ,0 ,19 ,5 ,2 ,9 ,1 ,36 ,0 ,50 ,3 ,53,37189 , 0 
65401.29,7,196 ,16 ,65535 ,0 ,0 ,18 ,0 ,0 ,0 ,0 ,18 ,0 ,38 ,0 ,38,48537 , 1 
65401.302,4,190 ,8 ,512 ,0 ,0 ,15 ,6 ,1 ,8 ,1 ,31 ,0 ,31 ,4 ,35,33165 , 0 
65401.338,14,190 ,1 ,256 ,0 ,0 ,16 ,8 ,3 ,8 ,1 ,36 ,0 ,46 ,6 ,52,31215 , 0 
65401.35,15,193 ,7 ,1041 ,0 ,0 ,18 ,0 ,0 ,0 ,0 ,18 ,0 ,41 ,0 ,41,39566 , 0 
65401.36,20,189 ,5 ,806 ,0 ,0 ,21 ,4 ,0 ,7 ,0 ,32 ,0 ,50 ,1 ,51,36215 , 0 
65401.361,16,193 ,2 ,706 ,0 ,0 ,19 ,1 ,2 ,2 ,1 ,25 ,0 ,48 ,6 ,54,63829 , 0 
65401.444,10,189 ,14 ,512 ,0 ,0 ,19 ,4 ,0 ,6 ,0 ,29 ,0 ,29 ,0 ,29,34074 , 0 
65401.482,12,189 ,5 ,806 ,0 ,0 ,19 ,4 ,1 ,6 ,0 ,30 ,0 ,59 ,5 ,64,39758 , 0 
65401.596,9,193 ,5 ,1253 ,0 ,0 ,21 ,2 ,0 ,3 ,0 ,26 ,0 ,60 ,0 ,60,58755 , 0 
65401.603,5,189 ,13 ,512 ,0 ,0 ,22 ,2 ,7 ,7 ,3 ,41 ,0 ,88 ,21 ,109,60226 , 0 
65401.608,19,190 ,1 ,256 ,0 ,0 ,17 ,5 ,9 ,9 ,6 ,46 ,0 ,66 ,27 ,93,38388 , 0 
65401.697,17,193 ,6 ,1964 ,0 ,0 ,17 ,1 ,0 ,3 ,0 ,21 ,0 ,36 ,0 ,36,43885 , 0 
65401.772,13,190 ,1 ,256 ,0 ,0 ,15 ,7 ,3 ,8 ,1 ,34 ,0 ,47 ,8 ,55,34010 , 0 
65401.787,3,190 ,1 ,256 ,0 ,0 ,15 ,9 ,0 ,7 ,0 ,31 ,0 ,31 ,1 ,32,23973 , 0 
65520.961,8,232 ,1 ,256 ,0 ,0 ,16 ,11 ,7 ,8 ,5 ,47 ,0 ,46 ,14 ,60,27451 , 0 
65521.078,11,233 ,5 ,768 ,0 ,0 ,19 ,1 ,0 ,1 ,0 ,21 ,0 ,64 ,3 ,67,41934 , 0 
65521.124,2,235 ,1 ,256 ,0 ,0 ,19 ,5 ,8 ,7 ,2 ,41 ,0 ,79 ,20 ,99,49083 , 0 
65521.138,6,235 ,2 ,529 ,0 ,0 ,19 ,2 ,2 ,6 ,1 ,30 ,0 ,61 ,7 ,68,68395 , 0 
65521.214,18,230 ,4 ,768 ,0 ,0 ,17 ,5 ,2 ,11 ,1 ,36 ,0 ,47 ,4 ,51,34423 , 0 
65521.236,4,232 ,8 ,512 ,0 ,0 ,17 ,9 ,2 ,9 ,2 ,39 ,0 ,37 ,6 ,43,31715 , 0 
65521.29,7,240 ,16 ,65535 ,0 ,0 ,22 ,0 ,0 ,0 ,0 ,22 ,0 ,44 ,0 ,44,49204 , 1 
65521.338,14,233 ,1 ,256 ,0 ,0 ,17 ,6 ,5 ,8 ,2 ,38 ,0 ,57 ,12 ,69,31097 , 0 
65521.351,15,237 ,11 ,1280 ,0 ,0 ,19 ,1 ,0 ,2 ,0 ,22 ,0 ,44 ,0 ,44,37537 , 0 
65521.36,20,233 ,5 ,768 ,0 ,0 ,19 ,2 ,0 ,3 ,0 ,24 ,0 ,36 ,0 ,36,32875 , 0 
65521.361,16,237 ,2 ,529 ,0 ,0 ,19 ,1 ,0 ,3 ,0 ,23 ,0 ,52 ,3 ,55,70108 , 0 
65521.444,10,233 ,14 ,512 ,0 ,0 ,17 ,6 ,0 ,7 ,0 ,30 ,0 ,30 ,1 ,31,35062 , 0 
65521.486,12,233 ,18 ,836 ,0 ,0 ,18 ,3 ,0 ,5 ,0 ,26 ,0 ,49 ,0 ,49,36046 , 0 
65521.597,9,237 ,11 ,1280 ,0 ,0 ,20 ,1 ,1 ,4 ,1 ,27 ,0 ,60 ,2 ,62,60881 , 0 
65521.603,5,237 ,19 ,512 ,0 ,0 ,21 ,2 ,3 ,11 ,0 ,37 ,0 ,83 ,11 ,94,57881 , 0 
65521.607,19,232 ,1 ,256 ,0 ,0 ,18 ,10 ,9 ,11 ,8 ,56 ,0 ,77 ,34 ,111,37420 , 0 
65521.697,17,237 ,16 ,1258 ,0 ,0 ,20 ,1 ,0 ,3 ,0 ,24 ,0 ,44 ,0 ,44,45558 , 0 
65521.771,13,235 ,0 ,0 ,0 ,0 ,20 ,6 ,0 ,8 ,0 ,34 ,0 ,55 ,3 ,58,33681 , 0 
65521.787,3,233 ,0 ,0 ,0 ,0 ,14 ,8 ,0 ,12 ,0 ,34 ,0 ,34 ,1 ,35,23740 , 0 
65640.96,8,242 ,1 ,256 ,0 ,0 ,9 ,4 ,4 ,5 ,2 ,24 ,0 ,22 ,6 ,28,27772 , 0 
65641.078,11,242 ,20 ,1345 ,0 ,0 ,11 ,5 ,0 ,2 ,0 ,18 ,0 ,30 ,0 ,30,45551 , 0 
65641.124,2,242 ,1 ,256 ,0 ,0 ,10 ,4 ,17 ,4 ,2 ,37 ,0 ,40 ,21 ,61,46376 , 0 
65641.138,6,242 ,2 ,512 ,0 ,0 ,12 ,3 ,7 ,0 ,0 ,22 ,0 ,27 ,7 ,34,58211 , 0 
65641.214,18,242 ,19 ,516 ,0 ,0 ,12 ,4 ,0 ,6 ,0 ,22 ,0 ,17 ,1 ,18,37470 , 0 
65641.236,4,242 ,8 ,512 ,0 ,0 ,8 ,3 ,2 ,2 ,1 ,16 ,0 ,20 ,3 ,23,33397 , 0 
65641.29,7,242 ,16 ,1067 ,0 ,0 ,14 ,7 ,1 ,3 ,0 ,25 ,0 ,28 ,4 ,32,48959 , 0 
65641.338,14,242 ,1 ,256 ,0 ,0 ,9 ,4 ,2 ,4 ,0 ,19 ,0 ,21 ,3 ,24,31403 , 0 
65641.35,15,242 ,9 ,1459 ,0 ,0 ,12 ,3 ,0 ,2 ,0 ,17 ,0 ,17 ,2 ,19,39865 , 0 
65641.36,20,242 ,5 ,881 ,0 ,0 ,9 ,2 ,3 ,1 ,0 ,15 ,0 ,14 ,3 ,17,36465 , 0 
65641.361,16,242 ,6 ,811 ,0 ,0 ,15 ,4 ,11 ,5 ,0 ,35 ,0 ,21 ,12 ,33,64326 , 0 
65641.444,10,242 ,14 ,512 ,0 ,0 ,9 ,3 ,0 ,1 ,0 ,13 ,0 ,13 ,0 ,13,34261 , 0 
65641.482,12,242 ,5 ,881 ,0 ,0 ,9 ,2 ,0 ,1 ,0 ,12 ,0 ,22 ,0 ,22,39932 , 0 
65641.596,9,242 ,5 ,881 ,0 ,0 ,9 ,2 ,3 ,1 ,1 ,16 ,0 ,33 ,7 ,40,59107 , 0 
65641.603,5,242 ,19 ,516 ,0 ,0 ,9 ,3 ,12 ,1 ,1 ,26 ,0 ,35 ,18 ,53,60669 , 0 
65641.607,19,242 ,1 ,256 ,0 ,0 ,9 ,4 ,18 ,6 ,1 ,38 ,0 ,33 ,22 ,55,38658 , 0 
65641.697,17,242 ,16 ,1067 ,0 ,0 ,10 ,6 ,0 ,0 ,0 ,16 ,0 ,24 ,0 ,24,44171 , 0 
65641.771,13,242 ,1 ,256 ,0 ,0 ,9 ,5 ,0 ,3 ,0 ,17 ,0 ,27 ,0 ,27,34210 , 0 
65641.787,3,242 ,1 ,256 ,0 ,0 ,7 ,6 ,0 ,3 ,0 ,16 ,0 ,17 ,0 ,17,24119 , 0 
65760.96,8,242 ,1 ,256 ,0 ,0 ,2 ,1 ,0 ,2 ,1 ,6 ,0 ,9 ,2 ,11,27578 , 0 
65761.078,11,242 ,12 ,1024 ,0 ,0 ,5 ,6 ,0 ,1 ,0 ,12 ,0 ,10 ,0 ,10,42092 , 0 
65761.124,2,242 ,1 ,256 ,0 ,0 ,2 ,0 ,5 ,0 ,2 ,9 ,0 ,6 ,7 ,13,49203 , 0 
65761.138,6,242 ,2 ,512 ,0 ,0 ,1 ,1 ,4 ,0 ,2 ,8 ,0 ,9 ,8 ,17,68571 , 0 
65761.214,18,242 ,19 ,512 ,0 ,0 ,2 ,2 ,7 ,0 ,0 ,11 ,0 ,14 ,7 ,21,34610 , 0 
65761.236,4,242 ,19 ,512 ,0 ,0 ,6 ,3 ,0 ,2 ,0 ,11 ,0 ,4 ,0 ,4,31849 , 0 
65761.29,7,242 ,17 ,1042 ,0 ,0 ,5 ,3 ,0 ,1 ,0 ,9 ,0 ,10 ,0 ,10,49313 , 0 
65761.337,14,242 ,1 ,256 ,0 ,0 ,2 ,1 ,2 ,0 ,0 ,5 ,0 ,4 ,2 ,6,31177 , 0 
65761.35,15,242 ,9 ,1397 ,0 ,0 ,2 ,1 ,0 ,0 ,0 ,3 ,0 ,10 ,0 ,10,37614 , 0 
65761.36,20,242 ,5 ,812 ,0 ,0 ,3 ,1 ,1 ,1 ,1 ,7 ,0 ,10 ,2 ,12,32986 , 0 
65761.361,16,242 ,6 ,786 ,0 ,0 ,3 ,0 ,0 ,2 ,2 ,7 ,0 ,11 ,2 ,13,70207 , 0 
65761.444,10,242 ,14 ,512 ,0 ,0 ,2 ,2 ,0 ,0 ,0 ,4 ,0 ,3 ,0 ,3,35141 , 0 
65761.482,12,242 ,18 ,768 ,0 ,0 ,6 ,2 ,5 ,1 ,0 ,14 ,0 ,8 ,5 ,13,36208 , 0 
65761.596,9,242 ,5 ,812 ,0 ,0 ,2 ,1 ,1 ,0 ,0 ,4 ,0 ,13 ,1 ,14,60977 , 0 
65761.603,5,242 ,19 ,512 ,0 ,0 ,2 ,2 ,4 ,2 ,2 ,12 ,0 ,15 ,7 ,22,58052 , 0 
65761.607,19,242 ,1 ,256 ,0 ,0 ,3 ,0 ,18 ,0 ,2 ,23 ,0 ,11 ,22 ,33,37560 , 0 
65761.706,17,242 ,6 ,786 ,0 ,0 ,6 ,1 ,3 ,1 ,0 ,11 ,0 ,7 ,3 ,10,45683 , 0 
65761.771,13,242 ,1 ,256 ,0 ,0 ,2 ,0 ,0 ,0 ,0 ,2 ,0 ,4 ,0 ,4,33753 , 0 
65761.787,3,242 ,1 ,256 ,0 ,0 ,2 ,1 ,0 ,0 ,0 ,3 ,0 ,2 ,0 ,2,23814 , 0 
65880.96,8,242 ,1 ,256 ,0 ,0 ,2 ,1 ,0 ,0 ,0 ,3 ,0 ,2 ,0 ,2,27837 , 0 
65881.078,11,242 ,12 ,1024 ,0 ,0 ,4 ,1 ,0 ,0 ,0 ,5 ,0 ,6 ,0 ,6,45651 , 0 
65881.124,2,242 ,1 ,256 ,0 ,0 ,2 ,1 ,4 ,0 ,0 ,7 ,0 ,7 ,4 ,11,46471 , 0 
65881.138,6,242 ,2 ,512 ,0 ,0 ,2 ,1 ,3 ,0 ,0 ,6 ,0 ,6 ,3 ,9,58299 , 0 
65881.214,18,242 ,19 ,512 ,0 ,0 ,2 ,0 ,2 ,0 ,0 ,4 ,0 ,3 ,2 ,5,37568 , 0 
65881.236,4,242 ,19 ,512 ,0 ,0 ,1 ,0 ,0 ,0 ,0 ,1 ,0 ,2 ,0 ,2,33465 , 0 
65881.289,7,242 ,17 ,1042 ,0 ,0 ,2 ,1 ,0 ,0 ,0 ,3 ,0 ,5 ,0 ,5,49026 , 0 
65881.337,14,242 ,1 ,256 ,0 ,0 ,2 ,1 ,0 ,0 ,0 ,3 ,0 ,8 ,0 ,8,31506 , 0 
65881.35,15,242 ,9 ,1304 ,0 ,0 ,2 ,1 ,0 ,0 ,0 ,3 ,0 ,5 ,0 ,5,39955 , 0 
65881.36,20,242 ,5 ,784 ,0 ,0 ,1 ,1 ,0 ,0 ,0 ,2 ,0 ,5 ,0 ,5,36540 , 0 
65881.36,16,242 ,6 ,826 ,0 ,0 ,2 ,1 ,0 ,0 ,0 ,3 ,0 ,7 ,0 ,7,64403 , 0 
65881.444,10,242 ,14 ,512 ,0 ,0 ,2 ,0 ,0 ,0 ,0 ,2 ,0 ,3 ,0 ,3,34326 , 0 
65881.482,12,242 ,18 ,768 ,0 ,0 ,2 ,1 ,1 ,0 ,0 ,4 ,0 ,4 ,1 ,5,40028 , 0 
65881.596,9,242 ,5 ,784 ,0 ,0 ,2 ,1 ,1 ,0 ,0 ,4 ,0 ,7 ,1 ,8,59250 , 0 
65881.603,5,242 ,19 ,512 ,0 ,0 ,2 ,1 ,3 ,0 ,0 ,6 ,0 ,10 ,3 ,13,60818 , 0 
65881.607,19,242 ,1 ,256 ,0 ,0 ,1 ,1 ,6 ,0 ,0 ,8 ,0 ,7 ,6 ,13,38733 , 0 
65881.696,17,242 ,6 ,826 ,0 ,0 ,2 ,1 ,1 ,0 ,0 ,4 ,0 ,4 ,1 ,5,44247 , 0 
65881.771,13,242 ,1 ,256 ,0 ,0 ,3 ,1 ,0 ,0 ,0 ,4 ,0 ,6 ,0 ,6,34353 , 0 
65881.787,3,242 ,1 ,256 ,0 ,0 ,2 ,1 ,0 ,0 ,0 ,3 ,0 ,3 ,0 ,3,24195 , 0 
66000.96,8,242 ,1 ,256 ,0 ,0 ,1 ,0 ,0 ,0 ,0 ,1 ,0 ,5 ,0 ,5,27662 , 0 
66001.079,11,242 ,9 ,300 ,0 ,0 ,10 ,8 ,11 ,10 ,2 ,41 ,0 ,20 ,22 ,42,42610 , 0 
66001.124,2,242 ,1 ,256 ,0 ,0 ,2 ,0 ,11 ,0 ,3 ,16 ,0 ,9 ,15 ,24,49440 , 0 
66001.138,6,242 ,2 ,512 ,0 ,0 ,1 ,1 ,2 ,1 ,3 ,8 ,0 ,11 ,6 ,17,68795 , 0 
66001.214,18,242 ,19 ,512 ,0 ,0 ,6 ,2 ,0 ,4 ,2 ,14 ,0 ,12 ,2 ,14,34925 , 0 
66001.236,4,242 ,19 ,521 ,0 ,0 ,2 ,1 ,0 ,0 ,0 ,3 ,0 ,5 ,0 ,5,31962 , 0 
66001.289,7,242 ,9 ,300 ,0 ,0 ,8 ,7 ,0 ,4 ,1 ,20 ,0 ,15 ,5 ,20,49763 , 0 
66001.337,14,242 ,1 ,256 ,0 ,0 ,1 ,0 ,1 ,0 ,0 ,2 ,0 ,2 ,1 ,3,31260 , 0 
66001.35,15,242 ,9 ,300 ,0 ,0 ,7 ,5 ,1 ,3 ,0 ,16 ,0 ,19 ,3 ,22,37964 , 0 
66001.36,20,242 ,11 ,632 ,0 ,0 ,8 ,9 ,0 ,4 ,0 ,21 ,0 ,17 ,3 ,20,33384 , 0 
66001.361,16,242 ,6 ,826 ,0 ,0 ,9 ,4 ,0 ,3 ,0 ,16 ,0 ,19 ,2 ,21,70578 , 0 
66001.444,10,242 ,14 ,512 ,0 ,0 ,3 ,1 ,0 ,0 ,0 ,4 ,0 ,1 ,0 ,1,35233 , 0 
66001.482,12,242 ,11 ,632 ,0 ,0 ,9 ,8 ,0 ,3 ,1 ,21 ,0 ,24 ,3 ,27,36557 , 0 
66001.597,9,242 ,5 ,695 ,0 ,0 ,12 ,6 ,12 ,10 ,0 ,40 ,0 ,25 ,39 ,64,61498 , 1 
66001.603,5,242 ,2 ,512 ,0 ,0 ,9 ,3 ,12 ,3 ,4 ,31 ,0 ,26 ,24 ,50,58569 , 0 
66001.607,19,242 ,1 ,256 ,0 ,0 ,2 ,0 ,2 ,3 ,5 ,12 ,0 ,14 ,8 ,22,37723 , 0 
66001.697,17,242 ,6 ,872 ,0 ,0 ,6 ,2 ,0 ,3 ,1 ,12 ,0 ,12 ,2 ,14,45943 , 0 
66001.771,13,242 ,1 ,256 ,0 ,0 ,1 ,0 ,4 ,0 ,3 ,8 ,0 ,6 ,8 ,14,33874 , 0 
66001.787,3,242 ,1 ,256 ,0 ,0 ,2 ,0 ,0 ,0 ,0 ,2 ,0 ,0 ,0 ,0,23895 , 0 
66120.96,8,242 ,1 ,256 ,0 ,0 ,1 ,1 ,0 ,0 ,0 ,2 ,0 ,3 ,0 ,3,27907 , 0 
66121.078,11,242 ,9 ,300 ,0 ,0 ,3 ,2 ,2 ,0 ,0 ,7 ,0 ,8 ,2 ,10,45779 , 0 
66121.124,2,242 ,1 ,256 ,0 ,0 ,1 ,1 ,7 ,0 ,1 ,10 ,0 ,9 ,10 ,19,46583 , 0 
66121.138,6,242 ,2 ,512 ,0 ,0 ,2 ,0 ,2 ,1 ,1 ,6 ,0 ,6 ,3 ,9,58404 , 0 
66121.214,18,242 ,19 ,512 ,0 ,0 ,3 ,0 ,0 ,0 ,0 ,3 ,0 ,5 ,0 ,5,37647 , 0 
66121.236,4,242 ,19 ,521 ,0 ,0 ,2 ,0 ,0 ,0 ,0 ,2 ,0 ,2 ,0 ,2,33541 , 0 
66121.289,7,242 ,9 ,300 ,0 ,0 ,3 ,2 ,0 ,0 ,0 ,5 ,0 ,10 ,0 ,10,49156 , 0 
66121.337,14,242 ,1 ,256 ,0 ,0 ,1 ,1 ,1 ,0 ,0 ,3 ,0 ,3 ,1 ,4,31594 , 0 
66121.35,15,242 ,9 ,300 ,0 ,0 ,2 ,2 ,0 ,0 ,0 ,4 ,0 ,5 ,0 ,5,40039 , 0 
66121.36,20,242 ,11 ,633 ,0 ,0 ,3 ,1 ,0 ,0 ,0 ,4 ,0 ,4 ,0 ,4,36670 , 0 
66121.36,16,242 ,9 ,300 ,0 ,0 ,5 ,3 ,0 ,1 ,0 ,9 ,0 ,7 ,0 ,7,64517 , 0 
66121.444,10,242 ,14 ,537 ,0 ,0 ,1 ,1 ,0 ,0 ,0 ,2 ,0 ,2 ,0 ,2,34391 , 0 
66121.482,12,242 ,11 ,633 ,0 ,0 ,2 ,1 ,0 ,0 ,0 ,3 ,0 ,7 ,0 ,7,40112 , 0 
66121.596,9,242 ,5 ,765 ,0 ,0 ,3 ,2 ,5 ,0 ,0 ,10 ,0 ,8 ,11 ,19,59440 , 1 
66121.607,19,242 ,1 ,256 ,0 ,0 ,1 ,1 ,0 ,1 ,0 ,3 ,0 ,6 ,0 ,6,38833 , 0 
66121.607,5,242 ,2 ,512 ,0 ,0 ,2 ,0 ,5 ,1 ,0 ,8 ,0 ,10 ,7 ,17,61006 , 0 
66121.696,17,242 ,6 ,839 ,0 ,0 ,2 ,2 ,0 ,0 ,0 ,4 ,0 ,7 ,0 ,7,44353 , 0 
66121.771,13,242 ,1 ,256 ,0 ,0 ,2 ,1 ,0 ,2 ,0 ,5 ,0 ,3 ,0 ,3,34435 , 0 
66121.787,3,242 ,1 ,256 ,0 ,0 ,1 ,1 ,0 ,0 ,0 ,2 ,0 ,3 ,0 ,3,24264 , 0 
66240.96,8,242 ,1 ,256 ,0 ,0 ,1 ,0 ,0 ,0 ,0 ,1 ,0 ,2 ,0 ,2,27727 , 0 
66241.078,11,242 ,9 ,65535 ,0 ,0 ,8 ,4 ,0 ,6 ,0 ,18 ,0 ,21 ,13 ,34,42844 , 0 
66241.124,2,242 ,1 ,256 ,0 ,0 ,1 ,0 ,6 ,0 ,2 ,9 ,0 ,6 ,8 ,14,49517 , 0 
66241.138,6,242 ,2 ,512 ,0 ,0 ,1 ,0 ,0 ,0 ,0 ,1 ,0 ,2 ,0 ,2,68882 , 0 
66241.214,18,242 ,19 ,512 ,0 ,0 ,1 ,0 ,1 ,0 ,0 ,2 ,0 ,7 ,1 ,8,35036 , 0 
66241.236,4,242 ,19 ,521 ,0 ,0 ,1 ,0 ,0 ,0 ,0 ,1 ,0 ,1 ,0 ,1,32024 , 0 
66241.291,7,242 ,9 ,300 ,0 ,0 ,2 ,4 ,0 ,0 ,0 ,6 ,0 ,12 ,0 ,12,49887 , 0 
66241.337,14,242 ,1 ,256 ,0 ,0 ,1 ,0 ,0 ,0 ,0 ,1 ,0 ,2 ,0 ,2,31330 , 0 
66241.35,15,242 ,9 ,300 ,0 ,0 ,5 ,4 ,2 ,0 ,2 ,13 ,0 ,12 ,4 ,16,38153 , 0 
66241.36,16,242 ,9 ,300 ,0 ,0 ,2 ,4 ,0 ,0 ,0 ,6 ,0 ,8 ,0 ,8,70719 , 0 
66241.36,20,242 ,11 ,65535 ,0 ,0 ,7 ,4 ,0 ,3 ,0 ,14 ,0 ,13 ,0 ,13,33536 , 0 
66241.444,10,242 ,14 ,537 ,0 ,0 ,1 ,0 ,0 ,0 ,0 ,1 ,0 ,0 ,0 ,0,35282 , 0 
66241.482,12,242 ,18 ,954 ,0 ,0 ,5 ,2 ,0 ,1 ,0 ,8 ,0 ,16 ,0 ,16,36728 , 0 
66241.597,9,242 ,11 ,65535 ,0 ,0 ,7 ,5 ,7 ,6 ,0 ,25 ,0 ,15 ,22 ,37,61816 , 1 
66241.606,19,242 ,1 ,256 ,0 ,0 ,1 ,0 ,1 ,0 ,0 ,2 ,0 ,6 ,1 ,7,37823 , 0 
66241.696,17,242 ,6 ,839 ,0 ,0 ,2 ,0 ,0 ,0 ,0 ,2 ,0 ,2 ,0 ,2,46007 , 0 
66241.739,5,242 ,2 ,512 ,0 ,0 ,6 ,0 ,6 ,0 ,2 ,14 ,0 ,21 ,13 ,34,58808 , 0 
66241.771,13,242 ,1 ,256 ,0 ,0 ,0 ,0 ,0 ,0 ,0 ,0 ,0 ,4 ,0 ,4,33939 , 0 
66241.787,3,242 ,1 ,256 ,0 ,0 ,1 ,0 ,0 ,0 ,0 ,1 ,0 ,1 ,0 ,1,23954 , 0 
66360.96,8,242 ,1 ,256 ,0 ,0 ,1 ,0 ,0 ,0 ,0 ,1 ,0 ,1 ,0 ,1,27972 , 0 
66361.078,11,242 ,9 ,1055 ,0 ,0 ,8 ,6 ,0 ,3 ,0 ,17 ,0 ,25 ,1 ,26,45988 , 0 
66361.124,2,242 ,1 ,256 ,0 ,0 ,1 ,0 ,20 ,0 ,2 ,23 ,0 ,11 ,23 ,34,46720 , 0 
66361.138,6,242 ,2 ,512 ,0 ,0 ,1 ,0 ,2 ,0 ,0 ,3 ,0 ,6 ,2 ,8,58510 , 0 
66361.214,18,242 ,19 ,512 ,0 ,0 ,3 ,0 ,1 ,0 ,0 ,4 ,0 ,9 ,1 ,10,37761 , 0 
66361.236,4,242 ,19 ,521 ,0 ,0 ,1 ,0 ,0 ,0 ,0 ,1 ,0 ,3 ,0 ,3,33631 , 0 
66361.29,7,242 ,17 ,1159 ,0 ,0 ,6 ,3 ,0 ,1 ,0 ,10 ,0 ,19 ,0 ,19,49342 , 0 
66361.337,14,242 ,1 ,256 ,0 ,0 ,1 ,0 ,0 ,0 ,0 ,1 ,0 ,3 ,0 ,3,31668 , 0 
66361.35,15,242 ,9 ,1055 ,0 ,0 ,10 ,5 ,1 ,3 ,0 ,19 ,0 ,16 ,2 ,18,40267 , 0 
66361.36,20,242 ,5 ,783 ,0 ,0 ,7 ,4 ,0 ,0 ,0 ,11 ,0 ,14 ,0 ,14,36823 , 0 
66361.361,16,242 ,6 ,856 ,0 ,0 ,7 ,2 ,0 ,1 ,0 ,10 ,0 ,10 ,0 ,10,64696 , 0 
66361.444,10,242 ,14 ,537 ,0 ,0 ,2 ,0 ,0 ,0 ,0 ,2 ,0 ,1 ,0 ,1,34465 , 0 
66361.482,12,242 ,18 ,935 ,0 ,0 ,7 ,1 ,0 ,0 ,0 ,8 ,0 ,12 ,0 ,12,40276 , 0 
66361.596,9,242 ,5 ,783 ,0 ,0 ,7 ,4 ,9 ,3 ,2 ,25 ,0 ,22 ,19 ,41,59752 , 0 
66361.603,5,242 ,2 ,512 ,0 ,0 ,6 ,1 ,17 ,0 ,3 ,27 ,0 ,22 ,22 ,44,61367 , 0 
66361.606,19,242 ,1 ,256 ,0 ,0 ,1 ,0 ,1 ,0 ,0 ,2 ,0 ,7 ,1 ,8,38912 , 0 
66361.696,17,242 ,6 ,839 ,0 ,0 ,1 ,0 ,1 ,0 ,0 ,2 ,0 ,7 ,2 ,9,44445 , 0 
66361.771,13,242 ,1 ,256 ,0 ,0 ,3 ,0 ,0 ,0 ,0 ,3 ,0 ,4 ,0 ,4,34545 , 0 
66361.787,3,242 ,1 ,256 ,0 ,0 ,1 ,0 ,0 ,0 ,0 ,1 ,0 ,0 ,0 ,0,24324 , 0 
66480.96,8,242 ,1 ,256 ,0 ,0 ,2 ,0 ,0 ,0 ,0 ,2 ,0 ,1 ,0 ,1,27808 , 0 
66481.078,11,242 ,9 ,1059 ,0 ,0 ,2 ,1 ,0 ,0 ,0 ,3 ,0 ,5 ,0 ,5,42927 , 0 
66481.124,2,242 ,1 ,256 ,0 ,0 ,0 ,0 ,4 ,0 ,0 ,4 ,0 ,5 ,6 ,11,49625 , 0 
66481.138,6,242 ,2 ,512 ,0 ,0 ,1 ,0 ,0 ,0 ,0 ,1 ,0 ,4 ,0 ,4,68960 , 0 
66481.214,18,242 ,19 ,512 ,0 ,0 ,1 ,0 ,1 ,0 ,0 ,2 ,0 ,2 ,1 ,3,35119 , 0 
66481.236,4,242 ,19 ,521 ,0 ,0 ,1 ,0 ,0 ,0 ,0 ,1 ,0 ,1 ,0 ,1,32096 , 0 
66481.289,7,242 ,17 ,1152 ,0 ,0 ,3 ,0 ,0 ,0 ,0 ,3 ,0 ,5 ,0 ,5,49972 , 0 
66481.337,14,242 ,1 ,256 ,0 ,0 ,2 ,0 ,1 ,0 ,0 ,3 ,0 ,1 ,1 ,2,31422 , 0 
66481.35,15,242 ,9 ,1059 ,0 ,0 ,2 ,1 ,0 ,0 ,0 ,3 ,0 ,4 ,0 ,4,38235 , 0 
66481.36,20,242 ,5 ,794 ,0 ,0 ,1 ,1 ,0 ,0 ,0 ,2 ,0 ,3 ,0 ,3,33618 , 0 
66481.36,16,242 ,6 ,856 ,0 ,0 ,4 ,0 ,0 ,0 ,0 ,4 ,0 ,5 ,0 ,5,70810 , 0 
66481.444,10,242 ,14 ,529 ,0 ,0 ,1 ,1 ,0 ,0 ,0 ,2 ,0 ,1 ,0 ,1,35365 , 0 
66481.482,12,242 ,18 ,889 ,0 ,0 ,2 ,1 ,0 ,0 ,0 ,3 ,0 ,4 ,0 ,4,36811 , 0 
66481.596,9,242 ,5 ,794 ,0 ,0 ,2 ,1 ,2 ,0 ,0 ,5 ,0 ,9 ,2 ,11,61937 , 0 
66481.602,5,242 ,2 ,512 ,0 ,0 ,2 ,0 ,4 ,2 ,0 ,8 ,0 ,4 ,4 ,8,58982 , 0 
66481.606,19,242 ,1 ,256 ,0 ,0 ,2 ,0 ,1 ,0 ,0 ,3 ,0 ,3 ,1 ,4,37923 , 0 
66481.696,17,242 ,6 ,816 ,0 ,0 ,1 ,0 ,0 ,0 ,0 ,1 ,0 ,5 ,0 ,5,46080 , 0 
66481.771,13,242 ,1 ,256 ,0 ,0 ,1 ,0 ,0 ,0 ,0 ,1 ,0 ,3 ,0 ,3,34036 , 0 
66481.787,3,242 ,1 ,256 ,0 ,0 ,1 ,0 ,0 ,0 ,0 ,1 ,0 ,4 ,0 ,4,24013 , 0 
66600.96,8,242 ,1 ,256 ,0 ,0 ,1 ,1 ,0 ,0 ,0 ,2 ,0 ,2 ,0 ,2,28042 , 0 
66601.078,11,242 ,9 ,1057 ,0 ,0 ,2 ,1 ,0 ,0 ,0 ,3 ,0 ,7 ,0 ,7,46077 , 0 
66601.124,2,242 ,1 ,256 ,0 ,0 ,2 ,1 ,5 ,0 ,0 ,8 ,0 ,5 ,5 ,10,46797 , 0 
66601.138,6,242 ,2 ,512 ,0 ,0 ,2 ,0 ,2 ,0 ,0 ,4 ,0 ,1 ,2 ,3,58590 , 0 
66601.214,18,242 ,19 ,512 ,0 ,0 ,1 ,0 ,0 ,0 ,0 ,1 ,0 ,3 ,0 ,3,37824 , 0 
66601.236,4,242 ,19 ,542 ,0 ,0 ,2 ,1 ,0 ,0 ,0 ,3 ,0 ,1 ,0 ,1,33693 , 0 
66601.289,7,242 ,17 ,1152 ,0 ,0 ,1 ,0 ,0 ,0 ,0 ,1 ,0 ,3 ,0 ,3,49417 , 0 
66601.337,14,242 ,1 ,256 ,0 ,0 ,1 ,1 ,0 ,0 ,0 ,2 ,0 ,4 ,0 ,4,31726 , 0 
66601.35,15,242 ,9 ,1059 ,0 ,0 ,2 ,0 ,0 ,0 ,0 ,2 ,0 ,3 ,0 ,3,40344 , 0 
66601.36,20,242 ,5 ,802 ,0 ,0 ,2 ,1 ,0 ,0 ,0 ,3 ,0 ,3 ,0 ,3,36900 , 0 
66601.36,16,242 ,6 ,811 ,0 ,0 ,0 ,2 ,0 ,0 ,0 ,2 ,0 ,3 ,0 ,3,64774 , 0 
66601.444,10,242 ,14 ,529 ,0 ,0 ,2 ,0 ,0 ,0 ,0 ,2 ,0 ,1 ,0 ,1,34528 , 0 
66601.482,12,242 ,18 ,889 ,0 ,0 ,2 ,0 ,0 ,0 ,0 ,2 ,0 ,3 ,0 ,3,40345 , 0 
66601.596,9,242 ,5 ,802 ,0 ,0 ,2 ,1 ,1 ,0 ,0 ,4 ,0 ,3 ,1 ,4,59851 , 0 
66601.602,5,242 ,2 ,512 ,0 ,0 ,2 ,0 ,3 ,0 ,0 ,5 ,0 ,4 ,3 ,7,61486 , 0 
66601.606,19,242 ,1 ,256 ,0 ,0 ,1 ,1 ,1 ,0 ,0 ,3 ,0 ,4 ,1 ,5,39000 , 0 
66601.696,17,242 ,6 ,816 ,0 ,0 ,1 ,0 ,0 ,0 ,0 ,1 ,0 ,1 ,0 ,1,44522 , 0 
66601.771,13,242 ,1 ,256 ,0 ,0 ,1 ,1 ,0 ,0 ,0 ,2 ,0 ,3 ,0 ,3,34614 , 0 
66601.787,3,242 ,1 ,256 ,0 ,0 ,2 ,1 ,0 ,0 ,0 ,3 ,0 ,1 ,0 ,1,24388 , 0 
66720.96,8,242 ,1 ,256 ,0 ,0 ,1 ,0 ,0 ,0 ,0 ,1 ,0 ,2 ,0 ,2,27875 , 0 
66721.078,11,242 ,9 ,1057 ,0 ,0 ,2 ,0 ,0 ,0 ,0 ,2 ,0 ,6 ,0 ,6,43008 , 0 
66721.124,2,242 ,1 ,256 ,0 ,0 ,25 ,0 ,36 ,1 ,1 ,63 ,110 ,21 ,37 ,168,49963 , 0 
66721.214,18,242 ,19 ,533 ,0 ,0 ,2 ,1 ,1 ,0 ,0 ,4 ,0 ,8 ,1 ,9,35235 , 0 
66721.236,4,242 ,19 ,542 ,0 ,0 ,2 ,0 ,0 ,0 ,0 ,2 ,0 ,3 ,0 ,3,32214 , 0 
66721.276,6,242 ,2 ,513 ,0 ,120 ,1 ,15 ,17 ,0 ,0 ,153 ,0 ,88 ,17 ,105,70049 , 1 
66721.325,7,242 ,17 ,1094 ,0 ,0 ,1 ,18 ,0 ,0 ,0 ,19 ,0 ,47 ,0 ,47,50231 , 0 
66721.338,14,242 ,1 ,256 ,0 ,0 ,1 ,0 ,0 ,0 ,0 ,1 ,0 ,43 ,0 ,43,31527 , 0 
66721.35,15,242 ,9 ,1059 ,0 ,0 ,1 ,0 ,0 ,0 ,0 ,1 ,0 ,0 ,0 ,0,38300 , 0 
66721.36,20,242 ,5 ,829 ,0 ,0 ,1 ,3 ,0 ,0 ,0 ,4 ,0 ,5 ,0 ,5,33796 , 0 
66721.361,16,242 ,6 ,811 ,0 ,0 ,27 ,0 ,0 ,0 ,0 ,27 ,110 ,35 ,0 ,145,71148 , 0 
66721.445,10,242 ,14 ,529 ,0 ,0 ,25 ,0 ,0 ,0 ,0 ,25 ,110 ,1 ,0 ,111,35625 , 0 
66721.482,12,242 ,18 ,886 ,0 ,0 ,2 ,1 ,0 ,0 ,0 ,3 ,0 ,6 ,0 ,6,36932 , 0 
66721.596,9,242 ,5 ,829 ,0 ,0 ,1 ,2 ,0 ,0 ,0 ,3 ,0 ,26 ,0 ,26,62090 , 0 
66721.603,5,242 ,19 ,546 ,0 ,0 ,6 ,6 ,3 ,1 ,0 ,16 ,0 ,20 ,3 ,23,59284 , 0 
66721.607,19,242 ,1 ,256 ,0 ,0 ,1 ,0 ,6 ,0 ,0 ,7 ,0 ,23 ,6 ,29,38040 , 0 
66721.761,17,242 ,6 ,816 ,0 ,0 ,26 ,0 ,18 ,0 ,0 ,44 ,115 ,25 ,18 ,158,46485 , 0 
66721.771,13,242 ,1 ,256 ,0 ,0 ,1 ,0 ,0 ,0 ,0 ,1 ,0 ,22 ,0 ,22,34122 , 0 
66721.787,3,242 ,1 ,256 ,0 ,0 ,1 ,0 ,0 ,0 ,0 ,1 ,0 ,0 ,0 ,0,24115 , 0 
66840.96,8,242 ,1 ,256 ,0 ,0 ,1 ,0 ,0 ,0 ,0 ,1 ,0 ,2 ,0 ,2,28129 , 0 
66841.078,11,242 ,9 ,1057 ,0 ,0 ,1 ,0 ,0 ,0 ,0 ,1 ,0 ,3 ,0 ,3,46164 , 0 
66841.124,2,242 ,1 ,256 ,0 ,0 ,26 ,0 ,32 ,0 ,0 ,58 ,111 ,25 ,32 ,168,47142 , 0 
66841.214,18,242 ,19 ,533 ,0 ,0 ,1 ,0 ,1 ,0 ,0 ,2 ,0 ,2 ,1 ,3,37925 , 0 
66841.236,4,242 ,19 ,542 ,0 ,0 ,2 ,0 ,0 ,0 ,0 ,2 ,0 ,0 ,0 ,0,33777 , 0 
66841.274,6,242 ,2 ,512 ,0 ,120 ,1 ,17 ,15 ,0 ,0 ,153 ,0 ,85 ,15 ,100,59624 , 1 
66841.29,7,242 ,17 ,1157 ,0 ,0 ,1 ,14 ,0 ,0 ,0 ,15 ,0 ,41 ,0 ,41,49608 , 0 
66841.338,14,242 ,1 ,256 ,0 ,0 ,1 ,0 ,0 ,0 ,0 ,1 ,0 ,41 ,0 ,41,31817 , 0 
66841.35,15,242 ,9 ,1059 ,0 ,0 ,2 ,0 ,0 ,0 ,0 ,2 ,0 ,1 ,0 ,1,40444 , 0 
66841.36,20,242 ,5 ,829 ,0 ,0 ,2 ,0 ,0 ,0 ,0 ,2 ,0 ,0 ,0 ,0,36966 , 0 
66841.361,16,242 ,6 ,811 ,0 ,0 ,26 ,0 ,0 ,0 ,0 ,26 ,111 ,36 ,0 ,147,65090 , 0 
66841.445,10,242 ,14 ,529 ,0 ,0 ,26 ,0 ,0 ,0 ,0 ,26 ,108 ,0 ,0 ,108,34788 , 0 
66841.482,12,242 ,18 ,905 ,0 ,0 ,1 ,1 ,0 ,0 ,0 ,2 ,0 ,3 ,0 ,3,40440 , 0 
66841.596,9,242 ,5 ,829 ,0 ,0 ,0 ,0 ,0 ,0 ,0 ,0 ,0 ,21 ,0 ,21,59957 , 0 
66841.603,5,242 ,19 ,546 ,0 ,0 ,1 ,0 ,0 ,0 ,0 ,1 ,0 ,22 ,0 ,22,61617 , 0 
66841.607,19,242 ,1 ,256 ,0 ,0 ,1 ,0 ,1 ,0 ,0 ,2 ,0 ,23 ,1 ,24,39133 , 0 
66841.697,17,242 ,6 ,869 ,0 ,0 ,27 ,0 ,14 ,0 ,0 ,41 ,113 ,24 ,14 ,151,44894 , 0 
66841.771,13,242 ,1 ,256 ,0 ,0 ,1 ,0 ,0 ,0 ,0 ,1 ,0 ,17 ,0 ,17,34696 , 0 
66841.787,3,242 ,1 ,256 ,0 ,0 ,1 ,0 ,0 ,0 ,0 ,1 ,0 ,1 ,0 ,1,24461 , 0 
66960.96,8,242 ,1 ,256 ,0 ,0 ,1 ,0 ,0 ,0 ,0 ,1 ,0 ,0 ,0 ,0,27962 , 0 
66961.078,11,242 ,9 ,1301 ,0 ,0 ,1 ,1 ,0 ,0 ,0 ,2 ,0 ,4 ,0 ,4,43114 , 0 
66961.124,2,242 ,1 ,256 ,0 ,0 ,26 ,0 ,32 ,0 ,0 ,58 ,116 ,23 ,32 ,171,50280 , 0 
66961.214,18,242 ,19 ,533 ,0 ,0 ,1 ,0 ,0 ,0 ,0 ,1 ,0 ,0 ,0 ,0,35295 , 0 
66961.236,4,242 ,19 ,542 ,0 ,0 ,1 ,0 ,0 ,0 ,0 ,1 ,0 ,1 ,0 ,1,32273 , 0 
66961.276,6,242 ,2 ,512 ,0 ,120 ,1 ,14 ,18 ,0 ,0 ,153 ,0 ,87 ,18 ,105,71016 , 1 
66961.29,7,242 ,17 ,1125 ,0 ,0 ,1 ,18 ,0 ,0 ,0 ,19 ,0 ,48 ,0 ,48,50481 , 0 
66961.338,14,242 ,1 ,256 ,0 ,0 ,1 ,0 ,0 ,0 ,0 ,1 ,0 ,38 ,0 ,38,31607 , 0 
66961.35,15,242 ,9 ,1059 ,0 ,0 ,1 ,0 ,0 ,0 ,0 ,1 ,0 ,0 ,0 ,0,38387 , 0 
66961.36,20,242 ,5 ,829 ,0 ,0 ,1 ,0 ,0 ,0 ,0 ,1 ,0 ,2 ,0 ,2,33856 , 0 
66961.361,16,242 ,6 ,768 ,0 ,0 ,25 ,0 ,0 ,0 ,0 ,25 ,114 ,40 ,0 ,154,71461 , 0 
66961.445,10,242 ,14 ,529 ,0 ,0 ,25 ,0 ,0 ,0 ,0 ,25 ,114 ,0 ,0 ,114,35884 , 0 
66961.482,12,242 ,18 ,905 ,0 ,0 ,1 ,0 ,0 ,0 ,0 ,1 ,0 ,0 ,0 ,0,36990 , 0 
66961.596,9,242 ,5 ,829 ,0 ,0 ,2 ,0 ,1 ,0 ,0 ,3 ,0 ,25 ,1 ,26,62204 , 0 
66961.603,5,242 ,19 ,546 ,0 ,0 ,1 ,0 ,1 ,0 ,0 ,2 ,0 ,19 ,1 ,20,59384 , 0 
66961.607,19,242 ,1 ,256 ,0 ,0 ,1 ,0 ,1 ,0 ,0 ,2 ,0 ,22 ,1 ,23,38137 , 0 
66961.697,17,242 ,6 ,869 ,0 ,0 ,25 ,0 ,18 ,0 ,0 ,43 ,114 ,24 ,18 ,156,46848 , 0 
66961.771,13,242 ,1 ,256 ,0 ,0 ,0 ,0 ,0 ,0 ,0 ,0 ,0 ,20 ,0 ,20,34210 , 0 
66961.787,3,242 ,1 ,256 ,0 ,0 ,1 ,0 ,0 ,0 ,0 ,1 ,0 ,1 ,0 ,1,24172 , 0 
67080.96,8,242 ,1 ,256 ,0 ,0 ,1 ,0 ,0 ,0 ,0 ,1 ,0 ,2 ,0 ,2,28191 , 0 
67081.078,11,242 ,9 ,1301 ,0 ,0 ,1 ,0 ,0 ,0 ,0 ,1 ,0 ,1 ,0 ,1,46233 , 0 
67081.124,2,242 ,1 ,256 ,0 ,0 ,5 ,0 ,10 ,0 ,0 ,15 ,1 ,5 ,10 ,16,47261 , 0 
67081.138,6,242 ,2 ,512 ,0 ,0 ,1 ,4 ,6 ,0 ,0 ,11 ,0 ,16 ,6 ,22,59795 , 0 
67081.214,18,242 ,19 ,533 ,0 ,0 ,1 ,0 ,0 ,0 ,0 ,1 ,0 ,0 ,0 ,0,38005 , 0 
67081.236,4,242 ,19 ,519 ,0 ,0 ,1 ,0 ,0 ,0 ,0 ,1 ,0 ,2 ,0 ,2,33856 , 0 
67081.29,7,242 ,17 ,1024 ,0 ,0 ,0 ,6 ,0 ,0 ,0 ,6 ,0 ,11 ,0 ,11,49692 , 0 
67081.337,14,242 ,1 ,256 ,0 ,0 ,1 ,0 ,0 ,0 ,0 ,1 ,0 ,6 ,0 ,6,31899 , 0 
67081.35,15,242 ,9 ,1279 ,0 ,0 ,1 ,1 ,0 ,0 ,0 ,2 ,0 ,1 ,0 ,1,40509 , 0 
67081.36,20,242 ,5 ,829 ,0 ,0 ,1 ,0 ,0 ,0 ,0 ,1 ,0 ,0 ,0 ,0,37044 , 0 
67081.36,16,242 ,6 ,768 ,0 ,0 ,4 ,0 ,0 ,0 ,0 ,4 ,0 ,9 ,0 ,9,65187 , 0 
67081.444,10,242 ,14 ,529 ,0 ,0 ,5 ,0 ,0 ,0 ,0 ,5 ,0 ,0 ,0 ,0,34891 , 0 
67081.482,12,242 ,18 ,905 ,0 ,0 ,1 ,0 ,0 ,0 ,0 ,1 ,0 ,2 ,0 ,2,40512 , 0 
67081.596,9,242 ,5 ,829 ,0 ,0 ,2 ,0 ,1 ,0 ,0 ,3 ,0 ,4 ,1 ,5,60031 , 0 
67081.603,5,242 ,19 ,546 ,0 ,0 ,2 ,0 ,1 ,0 ,0 ,3 ,0 ,5 ,1 ,6,61741 , 0 
67081.606,19,242 ,1 ,256 ,0 ,0 ,1 ,0 ,1 ,0 ,0 ,2 ,0 ,3 ,1 ,4,39231 , 0 
67081.697,17,242 ,6 ,768 ,0 ,0 ,6 ,0 ,6 ,0 ,0 ,12 ,0 ,5 ,6 ,11,45020 , 0 
67081.771,13,242 ,1 ,256 ,0 ,0 ,1 ,0 ,0 ,0 ,0 ,1 ,0 ,6 ,0 ,6,34783 , 0 
67081.787,3,242 ,1 ,256 ,0 ,0 ,1 ,0 ,0 ,0 ,0 ,1 ,0 ,0 ,0 ,0,24513 , 0 
67200.96,8,242 ,1 ,256 ,0 ,0 ,1 ,0 ,0 ,0 ,0 ,1 ,0 ,0 ,0 ,0,28030 , 0 
67201.078,11,242 ,9 ,1225 ,0 ,0 ,2 ,0 ,0 ,0 ,0 ,2 ,0 ,4 ,0 ,4,43181 , 0 
67201.123,2,242 ,1 ,256 ,0 ,0 ,2 ,0 ,2 ,0 ,0 ,4 ,0 ,4 ,2 ,6,50367 , 0 
67201.138,6,242 ,2 ,512 ,0 ,0 ,1 ,1 ,1 ,0 ,0 ,3 ,0 ,5 ,1 ,6,71085 , 0 
67201.214,18,242 ,19 ,533 ,0 ,0 ,1 ,0 ,0 ,0 ,0 ,1 ,0 ,2 ,0 ,2,35360 , 0 
67201.236,4,242 ,19 ,519 ,0 ,0 ,1 ,0 ,0 ,0 ,0 ,1 ,0 ,0 ,0 ,0,32343 , 0 
67201.289,7,242 ,17 ,1024 ,0 ,0 ,1 ,0 ,0 ,0 ,0 ,1 ,0 ,3 ,0 ,3,50559 , 0 
67201.337,14,242 ,1 ,256 ,0 ,0 ,1 ,0 ,0 ,0 ,0 ,1 ,0 ,4 ,0 ,4,31681 , 0 
67201.35,15,242 ,9 ,1279 ,0 ,0 ,1 ,0 ,0 ,0 ,0 ,1 ,0 ,2 ,0 ,2,38467 , 0 
67201.36,20,242 ,5 ,829 ,0 ,0 ,2 ,0 ,0 ,0 ,0 ,2 ,0 ,2 ,0 ,2,33927 , 0 
67201.36,16,242 ,6 ,768 ,0 ,0 ,4 ,1 ,0 ,0 ,0 ,5 ,0 ,3 ,0 ,3,71576 , 0 
67201.444,10,242 ,14 ,529 ,0 ,0 ,2 ,0 ,0 ,0 ,0 ,2 ,0 ,0 ,0 ,0,35946 , 0 
67201.482,12,242 ,18 ,894 ,0 ,0 ,1 ,0 ,0 ,0 ,0 ,1 ,0 ,3 ,0 ,3,37071 , 0 
67201.596,9,242 ,5 ,829 ,0 ,0 ,1 ,0 ,0 ,0 ,0 ,1 ,0 ,5 ,0 ,5,62299 , 0 
67201.602,5,242 ,19 ,516 ,0 ,0 ,0 ,1 ,0 ,0 ,0 ,1 ,0 ,4 ,0 ,4,59482 , 0 
67201.606,19,242 ,1 ,256 ,0 ,0 ,2 ,0 ,1 ,0 ,0 ,3 ,0 ,1 ,1 ,2,38217 , 0 
67201.696,17,242 ,6 ,768 ,0 ,0 ,0 ,0 ,0 ,0 ,0 ,0 ,0 ,2 ,0 ,2,46916 , 0 
67201.771,13,242 ,1 ,256 ,0 ,0 ,1 ,0 ,0 ,0 ,0 ,1 ,0 ,1 ,0 ,1,34268 , 0 
67201.787,3,242 ,1 ,256 ,0 ,0 ,1 ,0 ,0 ,0 ,0 ,1 ,0 ,1 ,0 ,1,24238 , 0 
67320.96,8,242 ,1 ,256 ,0 ,0 ,1 ,0 ,0 ,0 ,0 ,1 ,0 ,0 ,0 ,0,28252 , 0 
67321.078,11,242 ,9 ,1225 ,0 ,0 ,2 ,0 ,0 ,0 ,0 ,2 ,0 ,2 ,0 ,2,46317 , 0 
67321.123,2,242 ,1 ,256 ,0 ,0 ,1 ,0 ,0 ,0 ,0 ,1 ,0 ,0 ,0 ,0,47357 , 0 
67321.138,6,242 ,2 ,512 ,0 ,0 ,1 ,0 ,0 ,0 ,0 ,1 ,0 ,0 ,0 ,0,59869 , 0 
67321.214,18,242 ,19 ,533 ,0 ,0 ,1 ,0 ,0 ,0 ,0 ,1 ,0 ,0 ,0 ,0,38067 , 0 
67321.236,4,242 ,19 ,519 ,0 ,0 ,1 ,0 ,0 ,0 ,0 ,1 ,0 ,1 ,0 ,1,33916 , 0 
67321.289,7,242 ,17 ,1024 ,0 ,0 ,2 ,0 ,0 ,0 ,0 ,2 ,0 ,2 ,0 ,2,49774 , 0 
67321.337,14,242 ,1 ,256 ,0 ,0 ,1 ,0 ,1 ,0 ,0 ,2 ,0 ,1 ,1 ,2,31968 , 0 
67321.35,15,242 ,9 ,1279 ,0 ,0 ,1 ,0 ,0 ,0 ,0 ,1 ,0 ,1 ,0 ,1,40579 , 0 
67321.36,20,242 ,5 ,829 ,0 ,0 ,1 ,0 ,0 ,0 ,0 ,1 ,0 ,0 ,0 ,0,37095 , 0 
67321.36,16,242 ,6 ,768 ,0 ,0 ,1 ,0 ,0 ,0 ,0 ,1 ,0 ,1 ,0 ,1,65268 , 0 
67321.444,10,242 ,14 ,517 ,0 ,0 ,1 ,1 ,0 ,0 ,0 ,2 ,0 ,2 ,0 ,2,34948 , 0 
67321.482,12,242 ,18 ,894 ,0 ,0 ,2 ,0 ,0 ,0 ,0 ,2 ,0 ,1 ,0 ,1,40587 , 0 
67321.596,9,242 ,5 ,829 ,0 ,0 ,1 ,0 ,0 ,0 ,0 ,1 ,0 ,1 ,0 ,1,60113 , 0 
67321.602,5,242 ,19 ,516 ,0 ,0 ,2 ,0 ,0 ,0 ,0 ,2 ,0 ,3 ,0 ,3,61835 , 0 
67321.606,19,242 ,1 ,256 ,0 ,0 ,1 ,0 ,0 ,0 ,0 ,1 ,0 ,4 ,0 ,4,39316 , 0 
67321.696,17,242 ,6 ,768 ,0 ,0 ,2 ,0 ,0 ,0 ,0 ,2 ,0 ,1 ,0 ,1,45090 , 0 
67321.771,13,242 ,1 ,256 ,0 ,0 ,1 ,0 ,0 ,0 ,0 ,1 ,0 ,3 ,0 ,3,34867 , 0 
67321.787,3,242 ,1 ,256 ,0 ,0 ,1 ,0 ,0 ,0 ,0 ,1 ,0 ,1 ,0 ,1,24564 , 0 
67440.96,8,242 ,1 ,256 ,0 ,0 ,2 ,0 ,0 ,0 ,0 ,2 ,0 ,3 ,0 ,3,28120 , 0 
67441.078,11,242 ,9 ,1186 ,0 ,0 ,1 ,2 ,0 ,0 ,0 ,3 ,0 ,3 ,0 ,3,43261 , 0 
67441.124,2,242 ,1 ,256 ,0 ,0 ,4 ,0 ,6 ,0 ,0 ,10 ,0 ,5 ,6 ,11,50482 , 0 
67441.138,6,242 ,2 ,512 ,0 ,0 ,3 ,1 ,5 ,0 ,0 ,9 ,0 ,8 ,5 ,13,71224 , 0 
67441.214,18,242 ,19 ,533 ,0 ,0 ,1 ,0 ,0 ,0 ,0 ,1 ,0 ,2 ,0 ,2,35441 , 0 
67441.236,4,242 ,19 ,519 ,0 ,0 ,2 ,0 ,0 ,0 ,0 ,2 ,0 ,1 ,0 ,1,32464 , 0 
67441.289,7,242 ,17 ,1024 ,0 ,0 ,3 ,2 ,0 ,0 ,0 ,5 ,0 ,9 ,0 ,9,50657 , 0 
67441.337,14,242 ,1 ,256 ,0 ,0 ,1 ,0 ,0 ,0 ,0 ,1 ,0 ,7 ,0 ,7,31758 , 0 
67441.35,15,242 ,9 ,1173 ,0 ,0 ,2 ,3 ,0 ,0 ,0 ,5 ,0 ,7 ,0 ,7,38597 , 0 
67441.36,20,242 ,5 ,829 ,0 ,0 ,1 ,0 ,0 ,0 ,0 ,1 ,0 ,2 ,0 ,2,34021 , 0 
67441.361,16,242 ,6 ,768 ,0 ,0 ,2 ,2 ,0 ,0 ,0 ,4 ,0 ,11 ,0 ,11,71671 , 1 
67441.444,10,242 ,14 ,517 ,0 ,0 ,3 ,0 ,0 ,0 ,0 ,3 ,0 ,2 ,0 ,2,36045 , 0 
67441.482,12,242 ,18 ,894 ,0 ,0 ,1 ,0 ,0 ,0 ,0 ,1 ,0 ,1 ,0 ,1,37137 , 0 
67441.596,9,242 ,5 ,829 ,0 ,0 ,6 ,0 ,5 ,0 ,0 ,11 ,0 ,5 ,5 ,10,62483 , 0 
67441.603,5,242 ,19 ,512 ,0 ,0 ,1 ,0 ,5 ,0 ,0 ,6 ,0 ,10 ,5 ,15,59649 , 0 
67441.606,19,242 ,1 ,256 ,0 ,0 ,1 ,0 ,5 ,0 ,0 ,6 ,0 ,3 ,5 ,8,38340 , 0 
67441.696,17,242 ,6 ,768 ,0 ,0 ,4 ,2 ,2 ,0 ,0 ,8 ,0 ,5 ,2 ,7,47026 , 0 
67441.771,13,242 ,1 ,256 ,0 ,0 ,2 ,0 ,0 ,0 ,0 ,2 ,0 ,3 ,0 ,3,34386 , 0 
67441.787,3,242 ,1 ,256 ,0 ,0 ,3 ,0 ,0 ,0 ,0 ,3 ,0 ,0 ,0 ,0,24304 , 0 
67560.96,8,242 ,1 ,256 ,0 ,0 ,1 ,0 ,0 ,0 ,0 ,1 ,0 ,0 ,0 ,0,28324 , 0 
67561.078,11,242 ,9 ,1226 ,0 ,0 ,1 ,8 ,0 ,0 ,0 ,9 ,0 ,9 ,0 ,9,46452 , 0 
67561.124,2,242 ,1 ,256 ,0 ,0 ,10 ,0 ,36 ,0 ,1 ,47 ,0 ,13 ,38 ,51,47547 , 0 
67561.139,6,242 ,2 ,519 ,0 ,0 ,12 ,10 ,19 ,1 ,1 ,43 ,0 ,23 ,20 ,43,60259 , 0 
67561.214,18,242 ,19 ,533 ,0 ,0 ,1 ,0 ,0 ,0 ,0 ,1 ,0 ,1 ,0 ,1,38143 , 0 
67561.236,4,242 ,19 ,519 ,0 ,0 ,1 ,0 ,0 ,0 ,0 ,1 ,0 ,1 ,0 ,1,33989 , 0 
67561.29,7,242 ,17 ,1149 ,0 ,0 ,11 ,7 ,0 ,0 ,0 ,18 ,0 ,18 ,0 ,18,49953 , 0 
67561.338,14,242 ,1 ,256 ,0 ,0 ,1 ,0 ,0 ,0 ,0 ,1 ,0 ,10 ,0 ,10,32058 , 0 
67561.35,15,242 ,9 ,1226 ,0 ,0 ,0 ,7 ,0 ,0 ,0 ,7 ,0 ,17 ,0 ,17,40704 , 0 
67561.36,20,242 ,5 ,829 ,0 ,0 ,1 ,0 ,0 ,0 ,0 ,1 ,0 ,0 ,0 ,0,37155 , 0 
67561.361,16,242 ,2 ,527 ,0 ,0 ,5 ,8 ,0 ,1 ,0 ,14 ,0 ,43 ,0 ,43,65471 , 1 
67561.444,10,242 ,14 ,517 ,0 ,0 ,1 ,0 ,0 ,0 ,0 ,1 ,0 ,11 ,0 ,11,35017 , 0 
67561.486,12,242 ,18 ,894 ,0 ,0 ,1 ,0 ,0 ,0 ,0 ,1 ,0 ,1 ,0 ,1,40664 , 0 
67561.596,9,242 ,5 ,829 ,0 ,0 ,11 ,0 ,15 ,0 ,0 ,26 ,0 ,13 ,15 ,28,60425 , 0 
67561.603,5,242 ,19 ,512 ,0 ,0 ,1 ,0 ,15 ,0 ,0 ,16 ,0 ,18 ,15 ,33,62065 , 0 
67561.607,19,242 ,1 ,256 ,0 ,0 ,1 ,0 ,15 ,0 ,0 ,16 ,0 ,11 ,15 ,26,39425 , 0 
67561.697,17,242 ,6 ,815 ,0 ,0 ,11 ,10 ,7 ,0 ,0 ,28 ,0 ,25 ,7 ,32,45328 , 0 
67561.771,13,242 ,1 ,256 ,0 ,0 ,0 ,0 ,0 ,0 ,0 ,0 ,0 ,10 ,0 ,10,34946 , 0 
67561.787,3,242 ,1 ,256 ,0 ,0 ,0 ,0 ,0 ,0 ,0 ,0 ,0 ,2 ,0 ,2,24628 , 0 
67680.96,8,242 ,1 ,256 ,0 ,0 ,1 ,0 ,0 ,0 ,0 ,1 ,0 ,1 ,0 ,1,28190 , 0 
67681.078,11,242 ,9 ,1149 ,0 ,0 ,1 ,4 ,0 ,0 ,0 ,5 ,0 ,6 ,0 ,6,43354 , 0 
67681.124,2,242 ,1 ,256 ,0 ,0 ,6 ,0 ,13 ,0 ,0 ,19 ,0 ,6 ,13 ,19,50614 , 0 
67681.138,6,242 ,2 ,512 ,0 ,0 ,5 ,3 ,7 ,0 ,0 ,15 ,0 ,9 ,7 ,16,71385 , 0 
67681.214,18,242 ,19 ,533 ,0 ,0 ,1 ,0 ,0 ,0 ,0 ,1 ,0 ,1 ,0 ,1,35506 , 0 
67681.236,4,242 ,19 ,512 ,0 ,0 ,1 ,0 ,0 ,0 ,0 ,1 ,0 ,1 ,0 ,1,32525 , 0 
67681.29,7,242 ,17 ,1068 ,0 ,0 ,5 ,4 ,0 ,0 ,0 ,9 ,0 ,10 ,0 ,10,50781 , 0 
67681.337,14,242 ,1 ,256 ,0 ,0 ,2 ,0 ,0 ,0 ,0 ,2 ,0 ,6 ,0 ,6,31860 , 0 
67681.35,15,242 ,9 ,1149 ,0 ,0 ,1 ,3 ,0 ,0 ,0 ,4 ,0 ,7 ,0 ,7,38678 , 0 
67681.36,20,242 ,5 ,776 ,0 ,0 ,1 ,0 ,0 ,0 ,0 ,1 ,0 ,1 ,0 ,1,34083 , 0 
67681.361,16,242 ,2 ,512 ,0 ,0 ,2 ,3 ,0 ,0 ,0 ,5 ,0 ,20 ,0 ,20,71769 , 1 
67681.444,10,242 ,14 ,517 ,0 ,0 ,1 ,0 ,0 ,0 ,0 ,1 ,0 ,4 ,0 ,4,36108 , 0 
67681.482,12,242 ,18 ,894 ,0 ,0 ,1 ,0 ,0 ,0 ,0 ,1 ,0 ,0 ,0 ,0,37209 , 0 
67681.596,9,242 ,5 ,829 ,0 ,0 ,6 ,0 ,7 ,0 ,0 ,13 ,0 ,5 ,7 ,12,62649 , 0 
67681.603,5,242 ,19 ,512 ,0 ,0 ,1 ,0 ,7 ,0 ,0 ,8 ,0 ,9 ,7 ,16,59807 , 0 
67681.607,19,242 ,1 ,256 ,0 ,0 ,2 ,0 ,7 ,0 ,0 ,9 ,0 ,8 ,7 ,15,38430 , 0 
67681.697,17,242 ,6 ,797 ,0 ,0 ,7 ,3 ,4 ,0 ,0 ,14 ,0 ,9 ,4 ,13,47168 , 0 
67681.771,13,242 ,1 ,256 ,0 ,0 ,1 ,0 ,0 ,0 ,0 ,1 ,0 ,5 ,0 ,5,34467 , 0 
67681.787,3,242 ,1 ,256 ,0 ,0 ,2 ,0 ,0 ,0 ,0 ,2 ,0 ,0 ,0 ,0,24361 , 0 
67800.96,8,242 ,1 ,256 ,0 ,0 ,0 ,0 ,0 ,0 ,0 ,0 ,0 ,3 ,0 ,3,28382 , 0 
67801.078,11,242 ,9 ,1117 ,0 ,0 ,2 ,2 ,0 ,0 ,0 ,4 ,0 ,3 ,0 ,3,46561 , 0 
67801.123,2,242 ,1 ,256 ,0 ,0 ,2 ,0 ,5 ,0 ,0 ,7 ,0 ,2 ,5 ,7,47635 , 0 
67801.138,6,242 ,2 ,512 ,0 ,0 ,2 ,1 ,3 ,0 ,0 ,6 ,0 ,5 ,3 ,8,60385 , 0 
67801.214,18,242 ,19 ,533 ,0 ,0 ,2 ,0 ,0 ,0 ,0 ,2 ,0 ,1 ,0 ,1,38213 , 0 
67801.237,4,242 ,19 ,512 ,0 ,0 ,2 ,0 ,0 ,0 ,0 ,2 ,0 ,2 ,0 ,2,34046 , 0 
67801.289,7,242 ,17 ,1046 ,0 ,0 ,1 ,2 ,0 ,0 ,0 ,3 ,0 ,6 ,0 ,6,50058 , 0 
67801.337,14,242 ,1 ,256 ,0 ,0 ,1 ,0 ,0 ,0 ,0 ,1 ,0 ,3 ,0 ,3,32128 , 0 
67801.35,15,242 ,9 ,1117 ,0 ,0 ,1 ,2 ,0 ,0 ,0 ,3 ,0 ,4 ,0 ,4,40792 , 0 
67801.36,20,242 ,5 ,776 ,0 ,0 ,1 ,1 ,0 ,0 ,0 ,2 ,0 ,1 ,0 ,1,37240 , 0 
67801.36,16,242 ,2 ,512 ,0 ,0 ,2 ,1 ,0 ,0 ,0 ,3 ,0 ,8 ,0 ,8,65572 , 0 
67801.444,10,242 ,14 ,517 ,0 ,0 ,1 ,0 ,0 ,0 ,0 ,1 ,0 ,2 ,0 ,2,35084 , 0 
67801.482,12,242 ,18 ,894 ,0 ,0 ,1 ,0 ,0 ,0 ,0 ,1 ,0 ,1 ,0 ,1,40734 , 0 
67801.596,9,242 ,5 ,829 ,0 ,0 ,2 ,0 ,4 ,0 ,0 ,6 ,0 ,2 ,4 ,6,60554 , 0 
67801.603,5,242 ,19 ,512 ,0 ,0 ,0 ,0 ,5 ,0 ,0 ,5 ,0 ,4 ,5 ,9,62211 , 0 
67801.606,19,242 ,1 ,256 ,0 ,0 ,1 ,0 ,5 ,0 ,0 ,6 ,0 ,2 ,5 ,7,39539 , 0 
67801.696,17,242 ,6 ,781 ,0 ,0 ,3 ,1 ,2 ,0 ,0 ,6 ,0 ,2 ,2 ,4,45421 , 0 
67801.771,13,242 ,1 ,256 ,0 ,0 ,2 ,0 ,0 ,0 ,0 ,2 ,0 ,2 ,0 ,2,35061 , 0 
67801.787,3,242 ,1 ,256 ,0 ,0 ,1 ,0 ,0 ,0 ,0 ,1 ,0 ,1 ,0 ,1,24685 , 0 
67920.96,8,242 ,1 ,256 ,0 ,0 ,2 ,0 ,0 ,0 ,0 ,2 ,0 ,0 ,0 ,0,28268 , 0 
67921.078,11,242 ,9 ,1117 ,0 ,0 ,1 ,0 ,0 ,0 ,0 ,1 ,0 ,1 ,0 ,1,43425 , 0 
67921.123,2,242 ,1 ,256 ,0 ,0 ,2 ,0 ,4 ,0 ,0 ,6 ,0 ,3 ,4 ,7,50718 , 0 
67921.138,6,242 ,2 ,512 ,0 ,0 ,2 ,1 ,3 ,0 ,0 ,6 ,0 ,4 ,3 ,7,71481 , 0 
67921.214,18,242 ,19 ,533 ,0 ,0 ,1 ,0 ,0 ,0 ,0 ,1 ,0 ,1 ,0 ,1,35583 , 0 
67921.236,4,242 ,19 ,512 ,0 ,0 ,1 ,0 ,0 ,0 ,0 ,1 ,0 ,0 ,0 ,0,32598 , 0 
67921.289,7,242 ,17 ,1038 ,0 ,0 ,3 ,1 ,0 ,0 ,0 ,4 ,0 ,5 ,0 ,5,50858 , 0 
67921.337,14,242 ,1 ,256 ,0 ,0 ,1 ,0 ,0 ,0 ,0 ,1 ,0 ,2 ,0 ,2,31922 , 0 
67921.35,15,242 ,9 ,1117 ,0 ,0 ,2 ,0 ,0 ,0 ,0 ,2 ,0 ,1 ,0 ,1,38742 , 0 
67921.36,20,242 ,5 ,776 ,0 ,0 ,1 ,0 ,0 ,0 ,0 ,1 ,0 ,0 ,0 ,0,34153 , 0 
67921.36,16,242 ,2 ,512 ,0 ,0 ,2 ,0 ,0 ,0 ,0 ,2 ,0 ,5 ,0 ,5,71866 , 0 
67921.444,10,242 ,14 ,517 ,0 ,0 ,2 ,0 ,0 ,0 ,0 ,2 ,0 ,1 ,0 ,1,36172 , 0 
67921.482,12,242 ,18 ,894 ,0 ,0 ,1 ,0 ,0 ,0 ,0 ,1 ,0 ,0 ,0 ,0,37289 , 0 
67921.596,9,242 ,5 ,829 ,0 ,0 ,2 ,0 ,0 ,0 ,0 ,2 ,0 ,4 ,0 ,4,62731 , 0 
67921.603,5,242 ,19 ,512 ,0 ,0 ,2 ,0 ,0 ,0 ,0 ,2 ,0 ,5 ,0 ,5,59912 , 0 
67921.606,19,242 ,1 ,256 ,0 ,0 ,1 ,0 ,0 ,0 ,0 ,1 ,0 ,4 ,0 ,4,38494 , 0 
67921.696,17,242 ,6 ,772 ,0 ,0 ,2 ,2 ,1 ,0 ,0 ,5 ,0 ,3 ,1 ,4,47253 , 0 
67921.771,13,242 ,1 ,256 ,0 ,0 ,1 ,0 ,0 ,0 ,0 ,1 ,0 ,2 ,0 ,2,34538 , 0 
67921.787,3,242 ,1 ,256 ,0 ,0 ,1 ,0 ,0 ,0 ,0 ,1 ,0 ,1 ,0 ,1,24418 , 0 
68040.96,8,242 ,1 ,256 ,0 ,0 ,1 ,0 ,0 ,0 ,0 ,1 ,0 ,2 ,0 ,2,28441 , 0 
68041.078,11,242 ,9 ,1117 ,0 ,0 ,2 ,0 ,0 ,0 ,0 ,2 ,0 ,4 ,0 ,4,46624 , 0 
68041.123,2,242 ,1 ,256 ,0 ,0 ,2 ,0 ,1 ,0 ,0 ,3 ,0 ,1 ,1 ,2,47709 , 0 
68041.138,6,242 ,2 ,512 ,0 ,0 ,1 ,0 ,1 ,0 ,0 ,2 ,0 ,1 ,1 ,2,60447 , 0 
68041.214,18,242 ,19 ,533 ,0 ,0 ,2 ,0 ,0 ,0 ,0 ,2 ,0 ,1 ,0 ,1,38291 , 0 
68041.236,4,242 ,19 ,512 ,0 ,0 ,2 ,0 ,0 ,0 ,0 ,2 ,0 ,1 ,0 ,1,34132 , 0 
68041.289,7,242 ,17 ,1031 ,0 ,0 ,2 ,1 ,0 ,0 ,0 ,3 ,0 ,2 ,0 ,2,50128 , 0 
68041.337,14,242 ,1 ,256 ,0 ,0 ,1 ,0 ,0 ,0 ,0 ,1 ,0 ,2 ,0 ,2,32214 , 0 
68041.35,15,242 ,9 ,1117 ,0 ,0 ,1 ,0 ,0 ,0 ,0 ,1 ,0 ,4 ,0 ,4,40844 , 0 
68041.36,20,242 ,5 ,776 ,0 ,0 ,2 ,0 ,0 ,0 ,0 ,2 ,0 ,1 ,0 ,1,37316 , 0 
68041.36,16,242 ,2 ,512 ,0 ,0 ,1 ,0 ,0 ,0 ,0 ,1 ,0 ,2 ,0 ,2,65632 , 0 
68041.444,10,242 ,14 ,512 ,0 ,0 ,0 ,0 ,0 ,0 ,0 ,0 ,0 ,1 ,0 ,1,35137 , 0 
68041.482,12,242 ,18 ,837 ,0 ,0 ,1 ,0 ,0 ,0 ,0 ,1 ,0 ,4 ,0 ,4,40804 , 0 
68041.596,9,242 ,5 ,829 ,0 ,0 ,0 ,0 ,0 ,0 ,0 ,0 ,0 ,3 ,0 ,3,60608 , 0 
68041.603,5,242 ,19 ,512 ,0 ,0 ,1 ,0 ,0 ,0 ,0 ,1 ,0 ,4 ,0 ,4,62292 , 0 
68041.625,19,242 ,1 ,256 ,0 ,0 ,1 ,0 ,0 ,0 ,0 ,1 ,0 ,2 ,0 ,2,39618 , 0 
68041.696,17,242 ,6 ,772 ,0 ,0 ,1 ,0 ,1 ,0 ,0 ,2 ,0 ,2 ,1 ,3,45490 , 0 
68041.771,13,242 ,1 ,256 ,0 ,0 ,0 ,0 ,0 ,0 ,0 ,0 ,0 ,1 ,0 ,1,35117 , 0 
68041.787,3,242 ,1 ,256 ,0 ,0 ,2 ,0 ,0 ,0 ,0 ,2 ,0 ,0 ,0 ,0,24759 , 0 
68160.96,8,242 ,1 ,256 ,0 ,0 ,1 ,0 ,0 ,0 ,0 ,1 ,0 ,0 ,0 ,0,28329 , 0 
68161.078,11,242 ,9 ,1107 ,0 ,0 ,0 ,1 ,0 ,0 ,0 ,1 ,0 ,2 ,0 ,2,43493 , 0 
68161.123,2,242 ,1 ,256 ,0 ,0 ,2 ,0 ,3 ,0 ,0 ,5 ,0 ,2 ,3 ,5,50844 , 0 
68161.138,6,242 ,2 ,512 ,0 ,0 ,2 ,1 ,0 ,0 ,0 ,3 ,0 ,4 ,0 ,4,71589 , 0 
68161.214,18,242 ,19 ,533 ,0 ,0 ,1 ,0 ,1 ,0 ,0 ,2 ,0 ,2 ,1 ,3,35666 , 0 
68161.236,4,242 ,19 ,512 ,0 ,0 ,1 ,0 ,0 ,0 ,0 ,1 ,0 ,0 ,0 ,0,32657 , 0 
68161.289,7,242 ,17 ,1030 ,0 ,0 ,1 ,0 ,0 ,0 ,0 ,1 ,0 ,3 ,0 ,3,50941 , 0 
68161.337,14,242 ,1 ,256 ,0 ,0 ,1 ,0 ,0 ,0 ,0 ,1 ,0 ,2 ,0 ,2,31988 , 0 
68161.35,15,242 ,9 ,1107 ,0 ,0 ,2 ,1 ,0 ,0 ,0 ,3 ,0 ,2 ,0 ,2,38875 , 0 
68161.36,20,242 ,5 ,776 ,0 ,0 ,1 ,0 ,0 ,0 ,0 ,1 ,0 ,1 ,0 ,1,34211 , 0 
68161.36,16,242 ,2 ,512 ,0 ,0 ,2 ,2 ,0 ,0 ,0 ,4 ,0 ,6 ,0 ,6,71974 , 1 
68161.444,10,242 ,14 ,512 ,0 ,0 ,2 ,0 ,0 ,0 ,0 ,2 ,0 ,2 ,0 ,2,36243 , 0 
68161.482,12,242 ,18 ,827 ,0 ,0 ,1 ,1 ,0 ,0 ,0 ,2 ,0 ,2 ,0 ,2,37353 , 0 
68161.596,9,242 ,5 ,829 ,0 ,0 ,3 ,0 ,2 ,0 ,0 ,5 ,0 ,1 ,2 ,3,62856 , 0 
68161.603,5,242 ,19 ,512 ,0 ,0 ,1 ,0 ,2 ,0 ,0 ,3 ,0 ,2 ,2 ,4,60040 , 0 
68161.606,19,242 ,1 ,256 ,0 ,0 ,0 ,0 ,3 ,0 ,0 ,3 ,0 ,2 ,3 ,5,38584 , 0 
68161.696,17,242 ,6 ,768 ,0 ,0 ,2 ,0 ,0 ,0 ,0 ,2 ,0 ,2 ,0 ,2,47331 , 0 
68161.771,13,242 ,1 ,256 ,0 ,0 ,1 ,0 ,0 ,0 ,0 ,1 ,0 ,2 ,0 ,2,34614 , 0 
68161.787,3,242 ,1 ,256 ,0 ,0 ,0 ,0 ,0 ,0 ,0 ,0 ,0 ,0 ,0 ,0,24467 , 0 
68280.96,8,242 ,1 ,256 ,0 ,0 ,1 ,0 ,0 ,0 ,0 ,1 ,0 ,1 ,0 ,1,28513 , 0 
68281.078,11,242 ,9 ,1107 ,0 ,0 ,2 ,0 ,0 ,0 ,0 ,2 ,0 ,2 ,0 ,2,46701 , 0 
68281.123,2,242 ,1 ,256 ,0 ,0 ,1 ,0 ,1 ,0 ,0 ,2 ,0 ,0 ,1 ,1,47785 , 0 
68281.138,6,242 ,2 ,512 ,0 ,0 ,1 ,0 ,1 ,0 ,0 ,2 ,0 ,1 ,1 ,2,60518 , 0 
68281.214,18,242 ,19 ,533 ,0 ,0 ,1 ,0 ,0 ,0 ,0 ,1 ,0 ,0 ,0 ,0,38356 , 0 
68281.236,4,242 ,19 ,512 ,0 ,0 ,1 ,0 ,0 ,0 ,0 ,1 ,0 ,2 ,0 ,2,34199 , 0 
68281.289,7,242 ,17 ,1030 ,0 ,0 ,1 ,0 ,0 ,0 ,0 ,1 ,0 ,1 ,0 ,1,50183 , 0 
68281.337,14,242 ,1 ,256 ,0 ,0 ,0 ,0 ,0 ,0 ,0 ,0 ,0 ,1 ,0 ,1,32273 , 0 
68281.35,15,242 ,9 ,1100 ,0 ,0 ,1 ,1 ,0 ,0 ,0 ,2 ,0 ,2 ,0 ,2,40902 , 0 
68281.36,20,242 ,5 ,776 ,0 ,0 ,1 ,0 ,0 ,0 ,0 ,1 ,0 ,0 ,0 ,0,37376 , 0 
68281.36,16,242 ,2 ,512 ,0 ,0 ,0 ,0 ,0 ,0 ,0 ,0 ,0 ,1 ,0 ,1,65686 , 1 
68281.444,10,242 ,14 ,512 ,0 ,0 ,0 ,0 ,0 ,0 ,0 ,0 ,0 ,0 ,0 ,0,35187 , 0 
68281.482,12,242 ,18 ,827 ,0 ,0 ,1 ,0 ,0 ,0 ,0 ,1 ,0 ,1 ,0 ,1,40877 , 0 
68281.596,9,242 ,5 ,829 ,0 ,0 ,1 ,0 ,1 ,0 ,0 ,2 ,0 ,0 ,1 ,1,60686 , 0 
68281.603,5,242 ,19 ,512 ,0 ,0 ,1 ,0 ,1 ,0 ,0 ,2 ,0 ,3 ,1 ,4,62377 , 0 
68281.606,19,242 ,1 ,256 ,0 ,0 ,1 ,0 ,1 ,0 ,0 ,2 ,0 ,2 ,1 ,3,39703 , 0 
68281.696,17,242 ,6 ,768 ,0 ,0 ,1 ,1 ,0 ,0 ,0 ,2 ,0 ,1 ,0 ,1,45565 , 0 
68281.771,13,242 ,1 ,256 ,0 ,0 ,2 ,0 ,0 ,0 ,0 ,2 ,0 ,0 ,0 ,0,35199 , 0 
68281.787,3,242 ,1 ,256 ,0 ,0 ,1 ,0 ,0 ,0 ,0 ,1 ,0 ,0 ,0 ,0,24812 , 0 
68400.96,8,242 ,1 ,256 ,0 ,0 ,1 ,0 ,0 ,0 ,0 ,1 ,0 ,3 ,0 ,3,28402 , 0 
68401.078,11,242 ,9 ,1098 ,0 ,0 ,1 ,1 ,0 ,0 ,0 ,2 ,0 ,4 ,0 ,4,43565 , 0 
68401.123,2,242 ,1 ,256 ,0 ,0 ,1 ,0 ,1 ,0 ,0 ,2 ,0 ,5 ,1 ,6,50926 , 0 
68401.138,6,242 ,2 ,512 ,0 ,0 ,2 ,0 ,1 ,0 ,0 ,3 ,0 ,3 ,1 ,4,71669 , 0 
68401.214,18,242 ,19 ,512 ,0 ,0 ,0 ,1 ,0 ,0 ,0 ,1 ,0 ,3 ,0 ,3,35738 , 0 
68401.236,4,242 ,19 ,512 ,0 ,0 ,2 ,0 ,0 ,0 ,0 ,2 ,0 ,1 ,0 ,1,32749 , 0 
68401.289,7,242 ,17 ,1024 ,0 ,0 ,1 ,1 ,0 ,0 ,0 ,2 ,0 ,3 ,0 ,3,51013 , 0 
68401.337,14,242 ,1 ,256 ,0 ,0 ,1 ,0 ,0 ,0 ,0 ,1 ,0 ,2 ,0 ,2,32073 , 0 
68401.35,15,242 ,9 ,1100 ,0 ,0 ,1 ,0 ,0 ,0 ,0 ,1 ,0 ,1 ,0 ,1,38935 , 0 
68401.36,20,242 ,5 ,776 ,0 ,0 ,2 ,0 ,0 ,0 ,0 ,2 ,0 ,2 ,0 ,2,34301 , 0 
68401.36,16,242 ,2 ,512 ,0 ,0 ,2 ,0 ,0 ,0 ,0 ,2 ,0 ,2 ,0 ,2,72064 , 1 
68401.444,10,242 ,14 ,512 ,0 ,0 ,2 ,0 ,0 ,0 ,0 ,2 ,0 ,1 ,0 ,1,36311 , 0 
68401.482,12,242 ,18 ,827 ,0 ,0 ,3 ,0 ,0 ,0 ,0 ,3 ,0 ,1 ,0 ,1,37444 , 0 
68401.596,9,242 ,5 ,829 ,0 ,0 ,2 ,0 ,1 ,0 ,0 ,3 ,0 ,2 ,1 ,3,62944 , 0 
68401.603,5,242 ,19 ,512 ,0 ,0 ,0 ,0 ,1 ,0 ,0 ,1 ,0 ,5 ,1 ,6,60130 , 0 
68401.606,19,242 ,1 ,256 ,0 ,0 ,2 ,0 ,2 ,0 ,0 ,4 ,0 ,2 ,2 ,4,38669 , 0 
68401.696,17,242 ,6 ,768 ,0 ,0 ,1 ,0 ,1 ,0 ,0 ,2 ,0 ,2 ,1 ,3,47391 , 0 
68401.771,13,242 ,1 ,256 ,0 ,0 ,2 ,0 ,0 ,0 ,0 ,2 ,0 ,0 ,0 ,0,34685 , 0 
68401.787,3,242 ,1 ,256 ,0 ,0 ,2 ,0 ,0 ,0 ,0 ,2 ,0 ,2 ,0 ,2,24542 , 0 
68520.96,8,242 ,1 ,256 ,0 ,0 ,2 ,0 ,0 ,0 ,0 ,2 ,0 ,1 ,0 ,1,28577 , 0 
68521.078,11,242 ,9 ,1098 ,0 ,0 ,1 ,0 ,0 ,0 ,0 ,1 ,0 ,1 ,0 ,1,46774 , 0 
68521.123,2,242 ,1 ,256 ,0 ,0 ,3 ,0 ,0 ,0 ,0 ,3 ,0 ,0 ,0 ,0,47889 , 0 
68521.138,6,242 ,2 ,512 ,0 ,0 ,1 ,0 ,0 ,0 ,0 ,1 ,0 ,1 ,0 ,1,60595 , 0 
68521.214,18,242 ,19 ,512 ,0 ,0 ,1 ,0 ,0 ,0 ,0 ,1 ,0 ,1 ,0 ,1,38426 , 0 
68521.236,4,242 ,19 ,512 ,0 ,0 ,1 ,0 ,0 ,0 ,0 ,1 ,0 ,1 ,0 ,1,34252 , 0 
68521.289,7,242 ,17 ,1024 ,0 ,0 ,0 ,0 ,0 ,0 ,0 ,0 ,0 ,2 ,0 ,2,50259 , 0 
68521.337,14,242 ,1 ,256 ,0 ,0 ,1 ,0 ,0 ,0 ,0 ,1 ,0 ,2 ,0 ,2,32333 , 0 
68521.35,15,242 ,9 ,1100 ,0 ,0 ,1 ,0 ,0 ,0 ,0 ,1 ,0 ,0 ,0 ,0,40974 , 0 
68521.36,20,242 ,5 ,776 ,0 ,0 ,1 ,0 ,0 ,0 ,0 ,1 ,0 ,1 ,0 ,1,37433 , 0 
68521.36,16,242 ,2 ,512 ,0 ,0 ,1 ,0 ,0 ,0 ,0 ,1 ,0 ,2 ,0 ,2,65766 , 0 
68521.444,10,242 ,14 ,512 ,0 ,0 ,0 ,0 ,0 ,0 ,0 ,0 ,0 ,1 ,0 ,1,35249 , 0 
68521.482,12,242 ,18 ,827 ,0 ,0 ,1 ,0 ,0 ,0 ,0 ,1 ,0 ,1 ,0 ,1,40970 , 0 
68521.596,9,242 ,5 ,829 ,0 ,0 ,1 ,0 ,0 ,0 ,0 ,1 ,0 ,0 ,0 ,0,60796 , 0 
68521.603,5,242 ,19 ,512 ,0 ,0 ,1 ,0 ,0 ,0 ,0 ,1 ,0 ,2 ,0 ,2,62493 , 0 
68521.606,19,242 ,1 ,256 ,0 ,0 ,1 ,0 ,0 ,0 ,0 ,1 ,0 ,4 ,0 ,4,39788 , 0 
68521.696,17,242 ,6 ,768 ,0 ,0 ,1 ,0 ,0 ,0 ,0 ,1 ,0 ,0 ,0 ,0,45645 , 0 
68521.771,13,242 ,1 ,256 ,0 ,0 ,0 ,0 ,0 ,0 ,0 ,0 ,0 ,3 ,0 ,3,35276 , 0 
68521.787,3,242 ,1 ,256 ,0 ,0 ,1 ,0 ,0 ,0 ,0 ,1 ,0 ,1 ,0 ,1,24865 , 0 
68640.96,8,242 ,1 ,256 ,0 ,0 ,1 ,0 ,0 ,0 ,0 ,1 ,0 ,1 ,0 ,1,28469 , 0 
68641.078,11,242 ,9 ,1093 ,0 ,0 ,1 ,0 ,0 ,0 ,0 ,1 ,0 ,2 ,0 ,2,43627 , 0 
68641.123,2,242 ,1 ,256 ,0 ,0 ,0 ,0 ,1 ,0 ,0 ,1 ,0 ,1 ,1 ,2,50985 , 0 
68641.138,6,242 ,2 ,512 ,0 ,0 ,1 ,0 ,1 ,0 ,0 ,2 ,0 ,2 ,1 ,3,71736 , 0 
68641.214,18,242 ,19 ,512 ,0 ,0 ,2 ,0 ,0 ,0 ,0 ,2 ,0 ,1 ,0 ,1,35806 , 0 
68641.236,4,242 ,19 ,512 ,0 ,0 ,1 ,0 ,0 ,0 ,0 ,1 ,0 ,2 ,0 ,2,32820 , 0 
68641.289,7,242 ,17 ,1024 ,0 ,0 ,3 ,0 ,0 ,0 ,0 ,3 ,0 ,3 ,0 ,3,51085 , 0 
68641.337,14,242 ,1 ,256 ,0 ,0 ,1 ,0 ,0 ,0 ,0 ,1 ,0 ,2 ,0 ,2,32145 , 0 
68641.35,15,242 ,9 ,1093 ,0 ,0 ,1 ,0 ,0 ,0 ,0 ,1 ,0 ,2 ,0 ,2,38999 , 0 
68641.36,20,242 ,5 ,776 ,0 ,0 ,1 ,0 ,0 ,0 ,0 ,1 ,0 ,1 ,0 ,1,34353 , 0 
68641.36,16,242 ,2 ,512 ,0 ,0 ,1 ,0 ,0 ,0 ,0 ,1 ,0 ,5 ,0 ,5,72125 , 0 
68641.444,10,242 ,14 ,512 ,0 ,0 ,1 ,0 ,0 ,0 ,0 ,1 ,0 ,0 ,0 ,0,36363 , 0 
68641.482,12,242 ,18 ,827 ,0 ,0 ,1 ,0 ,0 ,0 ,0 ,1 ,0 ,0 ,0 ,0,37502 , 0 
68641.596,9,242 ,5 ,829 ,0 ,0 ,2 ,0 ,0 ,0 ,0 ,2 ,0 ,1 ,0 ,1,63008 , 0 
68641.603,5,242 ,19 ,512 ,0 ,0 ,1 ,0 ,0 ,0 ,0 ,1 ,0 ,3 ,0 ,3,60205 , 0 
68641.606,19,242 ,1 ,256 ,0 ,0 ,1 ,0 ,0 ,0 ,0 ,1 ,0 ,2 ,0 ,2,38737 , 0 
68641.696,17,242 ,6 ,768 ,0 ,0 ,2 ,1 ,0 ,0 ,0 ,3 ,0 ,3 ,0 ,3,47471 , 0 
68641.771,13,242 ,1 ,256 ,0 ,0 ,1 ,0 ,0 ,0 ,0 ,1 ,0 ,1 ,0 ,1,34765 , 0 
68641.787,3,242 ,1 ,256 ,0 ,0 ,1 ,0 ,0 ,0 ,0 ,1 ,0 ,0 ,0 ,0,24602 , 0 
68760.96,8,242 ,1 ,256 ,0 ,0 ,0 ,0 ,0 ,0 ,0 ,0 ,0 ,1 ,0 ,1,28631 , 0 
68761.078,11,242 ,5 ,777 ,0 ,0 ,4 ,1 ,0 ,1 ,0 ,6 ,0 ,2 ,0 ,2,46882 , 0 
68761.123,2,242 ,1 ,256 ,0 ,0 ,1 ,0 ,1 ,0 ,0 ,2 ,0 ,1 ,1 ,2,47976 , 0 
68761.138,6,242 ,2 ,512 ,0 ,0 ,1 ,0 ,1 ,0 ,0 ,2 ,0 ,2 ,1 ,3,60678 , 0 
68761.214,18,242 ,19 ,512 ,0 ,0 ,0 ,0 ,0 ,0 ,0 ,0 ,0 ,0 ,0 ,0,38493 , 0 
68761.236,4,242 ,19 ,512 ,0 ,0 ,0 ,0 ,0 ,0 ,0 ,0 ,0 ,0 ,0 ,0,34315 , 0 
68761.289,7,242 ,17 ,1024 ,0 ,0 ,1 ,1 ,0 ,0 ,0 ,2 ,0 ,1 ,0 ,1,50325 , 0 
68761.337,14,242 ,1 ,256 ,0 ,0 ,1 ,0 ,0 ,0 ,0 ,1 ,0 ,2 ,0 ,2,32411 , 0 
68761.35,15,242 ,9 ,1093 ,0 ,0 ,1 ,0 ,0 ,0 ,0 ,1 ,0 ,4 ,0 ,4,41043 , 0 
68761.36,20,242 ,5 ,776 ,0 ,0 ,1 ,0 ,0 ,0 ,0 ,1 ,0 ,3 ,0 ,3,37512 , 0 
68761.36,16,242 ,2 ,512 ,0 ,0 ,1 ,0 ,0 ,0 ,0 ,1 ,0 ,1 ,0 ,1,65830 , 0 
68761.444,10,242 ,14 ,512 ,0 ,0 ,2 ,0 ,0 ,0 ,0 ,2 ,0 ,0 ,0 ,0,35313 , 0 
68761.482,12,242 ,18 ,827 ,0 ,0 ,1 ,0 ,0 ,0 ,0 ,1 ,0 ,3 ,0 ,3,41030 , 0 
68761.596,9,242 ,5 ,829 ,0 ,0 ,1 ,0 ,0 ,0 ,1 ,2 ,0 ,6 ,1 ,7,60895 , 0 
68761.602,5,242 ,19 ,512 ,0 ,0 ,1 ,0 ,1 ,0 ,1 ,3 ,0 ,7 ,2 ,9,62620 , 0 
68761.606,19,242 ,1 ,256 ,0 ,0 ,1 ,0 ,1 ,0 ,1 ,3 ,0 ,0 ,2 ,2,39878 , 0 
68761.696,17,242 ,6 ,768 ,0 ,0 ,1 ,0 ,1 ,0 ,0 ,2 ,0 ,0 ,1 ,1,45716 , 0 
68761.771,13,242 ,1 ,256 ,0 ,0 ,1 ,0 ,0 ,0 ,0 ,1 ,0 ,0 ,0 ,0,35338 , 0 
68761.787,3,242 ,1 ,256 ,0 ,0 ,1 ,0 ,0 ,0 ,0 ,1 ,0 ,2 ,0 ,2,24927 , 0 
68880.96,8,245 ,1 ,256 ,0 ,0 ,4 ,1 ,1 ,2 ,0 ,8 ,0 ,4 ,1 ,5,28613 , 0 
68881.078,11,244 ,15 ,1792 ,0 ,0 ,6 ,1 ,0 ,3 ,0 ,10 ,0 ,6 ,0 ,6,43870 , 0 
68881.124,2,248 ,1 ,256 ,0 ,0 ,6 ,4 ,0 ,5 ,4 ,19 ,0 ,12 ,5 ,17,51364 , 0 
68881.138,6,248 ,16 ,1792 ,0 ,0 ,6 ,2 ,1 ,2 ,2 ,13 ,0 ,8 ,5 ,13,72097 , 0 
68881.227,18,245 ,19 ,512 ,0 ,0 ,5 ,3 ,3 ,3 ,1 ,15 ,0 ,8 ,4 ,12,36047 , 0 
68881.236,4,245 ,19 ,512 ,0 ,0 ,5 ,3 ,0 ,3 ,0 ,11 ,0 ,7 ,0 ,7,33050 , 0 
68881.29,7,253 ,17 ,65535 ,0 ,0 ,6 ,0 ,1 ,1 ,0 ,8 ,0 ,8 ,10 ,18,51353 , 1 
68881.337,14,248 ,1 ,256 ,0 ,0 ,3 ,1 ,0 ,2 ,1 ,7 ,0 ,7 ,2 ,9,32273 , 0 
68881.35,15,248 ,7 ,1280 ,0 ,0 ,4 ,1 ,0 ,2 ,0 ,7 ,0 ,7 ,1 ,8,39168 , 0 
68881.361,16,248 ,7 ,1280 ,0 ,0 ,4 ,1 ,1 ,2 ,1 ,9 ,0 ,9 ,3 ,12,72498 , 0 
68881.444,10,245 ,14 ,512 ,0 ,0 ,3 ,2 ,0 ,4 ,0 ,9 ,0 ,4 ,0 ,4,36531 , 0 
68881.482,12,245 ,18 ,799 ,0 ,0 ,5 ,5 ,0 ,4 ,0 ,14 ,0 ,13 ,0 ,13,37823 , 0 
68881.491,20,245 ,12 ,3359 ,0 ,0 ,4 ,3 ,1 ,3 ,1 ,12 ,0 ,7 ,2 ,9,34678 , 0 
68881.596,9,248 ,7 ,1280 ,0 ,0 ,5 ,1 ,4 ,3 ,1 ,14 ,0 ,12 ,12 ,24,63389 , 0 
68881.603,5,248 ,2 ,65535 ,0 ,0 ,5 ,1 ,5 ,3 ,5 ,19 ,0 ,15 ,17 ,32,60574 , 0 
68881.607,19,245 ,1 ,256 ,0 ,0 ,5 ,3 ,3 ,2 ,3 ,16 ,0 ,12 ,7 ,19,38981 , 0 
68881.696,17,250 ,7 ,1280 ,0 ,0 ,6 ,1 ,0 ,2 ,0 ,9 ,0 ,8 ,1 ,9,47645 , 0 
68881.786,3,245 ,0 ,0 ,0 ,0 ,3 ,2 ,0 ,2 ,0 ,7 ,0 ,5 ,0 ,5,24731 , 0 
68881.943,13,245 ,1 ,256 ,0 ,0 ,4 ,3 ,0 ,4 ,0 ,11 ,0 ,6 ,0 ,6,35099 , 0 
69000.961,8,29 ,1 ,256 ,0 ,0 ,15 ,9 ,10 ,8 ,3 ,45 ,0 ,39 ,16 ,55,29066 , 0 
69001.078,11,27 ,0 ,0 ,0 ,0 ,18 ,6 ,3 ,7 ,2 ,36 ,0 ,47 ,6 ,53,47502 , 0 
69001.129,2,29 ,19 ,512 ,0 ,0 ,20 ,7 ,2 ,10 ,2 ,41 ,0 ,57 ,19 ,76,48601 , 0 
69001.139,6,30 ,10 ,2892 ,0 ,0 ,19 ,3 ,0 ,3 ,0 ,25 ,0 ,44 ,6 ,50,61041 , 0 
69001.215,18,29 ,19 ,512 ,0 ,0 ,21 ,11 ,4 ,12 ,1 ,49 ,0 ,36 ,12 ,48,39460 , 0 
69001.236,4,29 ,19 ,512 ,0 ,0 ,16 ,8 ,2 ,12 ,1 ,39 ,0 ,26 ,4 ,30,35011 , 0 
69001.29,7,39 ,17 ,65535 ,0 ,0 ,21 ,0 ,0 ,0 ,0 ,21 ,0 ,28 ,0 ,28,50648 , 1 
69001.338,14,29 ,1 ,256 ,0 ,0 ,17 ,6 ,6 ,10 ,3 ,42 ,0 ,39 ,12 ,51,32883 , 0 
69001.35,15,27 ,11 ,1597 ,0 ,0 ,19 ,1 ,0 ,3 ,0 ,23 ,0 ,31 ,0 ,31,41397 , 0 
69001.36,20,27 ,5 ,790 ,0 ,0 ,16 ,5 ,1 ,5 ,1 ,28 ,0 ,28 ,3 ,31,38012 , 0 
69001.36,16,29 ,0 ,0 ,0 ,0 ,17 ,3 ,0 ,6 ,0 ,26 ,0 ,33 ,0 ,33,66242 , 0 
69001.482,12,29 ,18 ,1182 ,0 ,0 ,17 ,8 ,1 ,9 ,1 ,36 ,0 ,36 ,6 ,42,41696 , 0 
69001.539,10,30 ,14 ,512 ,0 ,0 ,17 ,5 ,1 ,3 ,1 ,27 ,0 ,28 ,2 ,30,35732 , 0 
69001.596,9,27 ,5 ,790 ,0 ,0 ,19 ,2 ,0 ,3 ,0 ,24 ,0 ,40 ,1 ,41,61337 , 0 
69001.603,5,29 ,19 ,512 ,0 ,0 ,17 ,8 ,15 ,13 ,8 ,61 ,0 ,59 ,28 ,87,63477 , 0 
69001.612,19,29 ,1 ,256 ,0 ,0 ,17 ,10 ,19 ,14 ,9 ,69 ,0 ,56 ,40 ,96,40477 , 0 
69001.697,17,30 ,6 ,3148 ,0 ,0 ,17 ,1 ,0 ,1 ,0 ,19 ,0 ,30 ,0 ,30,45961 , 0 
69001.772,13,29 ,19 ,512 ,0 ,0 ,17 ,6 ,12 ,6 ,7 ,48 ,0 ,35 ,34 ,69,35964 , 0 
69001.787,3,29 ,1 ,256 ,0 ,0 ,15 ,11 ,0 ,7 ,0 ,33 ,0 ,26 ,0 ,26,25195 , 0 
69120.961,8,75 ,1 ,256 ,0 ,0 ,17 ,12 ,2 ,11 ,2 ,44 ,0 ,43 ,9 ,52,29078 , 0 
69121.078,11,78 ,5 ,2655 ,0 ,0 ,21 ,5 ,1 ,9 ,1 ,37 ,0 ,49 ,11 ,60,44582 , 0 
69121.124,2,78 ,14 ,512 ,0 ,0 ,16 ,4 ,5 ,11 ,3 ,39 ,0 ,57 ,13 ,70,51888 , 0 
69121.139,6,78 ,17 ,2899 ,0 ,0 ,18 ,2 ,2 ,2 ,0 ,24 ,0 ,42 ,10 ,52,72515 , 0 
69121.236,4,75 ,8 ,512 ,0 ,0 ,18 ,12 ,1 ,16 ,1 ,48 ,0 ,36 ,2 ,38,33795 , 0 
69121.29,7,81 ,9 ,65535 ,0 ,0 ,21 ,1 ,1 ,1 ,0 ,24 ,0 ,40 ,8 ,48,51671 , 1 
69121.306,18,75 ,19 ,816 ,0 ,0 ,21 ,8 ,4 ,10 ,2 ,45 ,0 ,42 ,10 ,52,36783 , 0 
69121.338,14,75 ,1 ,256 ,0 ,0 ,18 ,10 ,2 ,15 ,1 ,46 ,0 ,50 ,6 ,56,32824 , 0 
69121.35,15,78 ,7 ,2413 ,0 ,0 ,18 ,2 ,2 ,4 ,0 ,26 ,0 ,38 ,4 ,42,39560 , 0 
69121.36,20,74 ,5 ,2655 ,0 ,0 ,16 ,4 ,0 ,6 ,0 ,26 ,0 ,32 ,0 ,32,35192 , 0 
69121.361,16,78 ,7 ,2413 ,0 ,0 ,19 ,2 ,0 ,2 ,0 ,23 ,0 ,37 ,0 ,37,72777 , 0 
69121.444,10,78 ,14 ,512 ,0 ,0 ,17 ,4 ,1 ,3 ,0 ,25 ,0 ,22 ,2 ,24,36917 , 0 
69121.482,12,74 ,18 ,790 ,0 ,0 ,16 ,3 ,1 ,6 ,0 ,26 ,0 ,44 ,1 ,45,38243 , 0 
69121.596,9,78 ,5 ,2655 ,0 ,0 ,18 ,3 ,0 ,6 ,0 ,27 ,0 ,46 ,1 ,47,63781 , 0 
69121.603,5,75 ,19 ,816 ,0 ,0 ,19 ,6 ,7 ,11 ,6 ,49 ,0 ,59 ,27 ,86,61372 , 0 
69121.607,19,75 ,8 ,512 ,0 ,0 ,18 ,7 ,14 ,12 ,8 ,59 ,0 ,56 ,41 ,97,39746 , 0 
69121.697,17,80 ,7 ,2413 ,0 ,0 ,16 ,1 ,2 ,3 ,0 ,22 ,0 ,32 ,4 ,36,48026 , 0 
69121.772,13,75 ,1 ,256 ,0 ,0 ,16 ,6 ,7 ,14 ,5 ,48 ,0 ,45 ,19 ,64,35620 , 0 
69121.787,3,75 ,14 ,512 ,0 ,0 ,17 ,11 ,2 ,8 ,2 ,40 ,0 ,28 ,4 ,32,25125 , 0 
69240.96,8,83 ,1 ,256 ,0 ,0 ,7 ,6 ,4 ,3 ,2 ,22 ,0 ,21 ,7 ,28,29275 , 0 
69241.078,11,83 ,20 ,1536 ,0 ,0 ,12 ,3 ,2 ,3 ,1 ,21 ,0 ,30 ,3 ,33,47795 , 0 
69241.124,2,83 ,1 ,256 ,0 ,0 ,7 ,4 ,19 ,1 ,5 ,36 ,0 ,31 ,25 ,56,48824 , 0 
69241.138,6,83 ,2 ,519 ,0 ,0 ,9 ,4 ,4 ,3 ,3 ,23 ,0 ,25 ,8 ,33,61355 , 0 
69241.214,18,83 ,19 ,512 ,0 ,0 ,8 ,5 ,2 ,4 ,1 ,20 ,0 ,19 ,3 ,22,39758 , 0 
69241.236,4,83 ,8 ,512 ,0 ,0 ,8 ,3 ,0 ,4 ,0 ,15 ,0 ,17 ,0 ,17,35219 , 0 
69241.29,7,83 ,16 ,936 ,0 ,0 ,10 ,4 ,7 ,2 ,1 ,24 ,0 ,29 ,8 ,37,50931 , 0 
69241.338,14,83 ,1 ,256 ,0 ,0 ,7 ,5 ,3 ,3 ,2 ,20 ,0 ,21 ,7 ,28,33086 , 0 
69241.35,15,83 ,7 ,1533 ,0 ,0 ,13 ,4 ,0 ,1 ,0 ,18 ,0 ,26 ,0 ,26,41627 , 0 
69241.36,20,83 ,12 ,1452 ,0 ,0 ,9 ,2 ,1 ,1 ,0 ,13 ,0 ,18 ,2 ,20,38212 , 0 
69241.377,16,83 ,2 ,512 ,0 ,0 ,9 ,2 ,12 ,0 ,1 ,24 ,0 ,26 ,14 ,40,66645 , 0 
69241.444,10,83 ,14 ,531 ,0 ,0 ,7 ,2 ,1 ,1 ,1 ,12 ,0 ,8 ,2 ,10,35908 , 0 
69241.482,12,83 ,5 ,824 ,0 ,0 ,10 ,3 ,3 ,1 ,0 ,17 ,0 ,23 ,3 ,26,41987 , 0 
69241.596,9,83 ,7 ,1375 ,0 ,0 ,12 ,4 ,1 ,1 ,0 ,18 ,0 ,33 ,3 ,36,61641 , 0 
69241.603,5,83 ,19 ,512 ,0 ,0 ,8 ,3 ,7 ,4 ,2 ,24 ,0 ,36 ,9 ,45,63820 , 0 
69241.607,19,83 ,1 ,256 ,0 ,0 ,8 ,7 ,16 ,4 ,5 ,40 ,0 ,28 ,28 ,56,40747 , 0 
69241.697,17,83 ,16 ,936 ,0 ,0 ,13 ,6 ,1 ,4 ,1 ,25 ,0 ,20 ,2 ,22,46295 , 0 
69241.771,13,83 ,1 ,256 ,0 ,0 ,8 ,4 ,1 ,2 ,1 ,16 ,0 ,20 ,2 ,22,36138 , 0 
69241.787,3,83 ,1 ,256 ,0 ,0 ,7 ,5 ,0 ,3 ,0 ,15 ,0 ,17 ,0 ,17,25367 , 0 
69360.96,8,83 ,1 ,256 ,0 ,0 ,2 ,1 ,1 ,0 ,0 ,4 ,0 ,3 ,1 ,4,29161 , 0 
69361.078,11,83 ,9 ,1196 ,0 ,0 ,9 ,5 ,0 ,2 ,0 ,16 ,0 ,12 ,0 ,12,44766 , 0 
69361.124,2,83 ,1 ,256 ,0 ,0 ,3 ,1 ,18 ,0 ,2 ,24 ,0 ,9 ,21 ,30,52024 , 0 
69361.138,6,83 ,2 ,512 ,0 ,0 ,4 ,2 ,0 ,1 ,0 ,7 ,0 ,7 ,0 ,7,72634 , 0 
69361.214,18,83 ,19 ,512 ,0 ,0 ,2 ,0 ,0 ,0 ,0 ,2 ,0 ,4 ,0 ,4,36866 , 0 
69361.236,4,83 ,8 ,512 ,0 ,0 ,1 ,1 ,0 ,0 ,0 ,2 ,0 ,2 ,0 ,2,33881 , 0 
69361.289,7,83 ,16 ,940 ,0 ,0 ,3 ,2 ,2 ,2 ,2 ,11 ,0 ,12 ,4 ,16,51816 , 0 
69361.337,14,83 ,1 ,256 ,0 ,0 ,4 ,1 ,1 ,0 ,0 ,6 ,0 ,7 ,1 ,8,32934 , 0 
69361.35,15,83 ,9 ,1196 ,0 ,0 ,6 ,5 ,0 ,1 ,0 ,12 ,0 ,13 ,0 ,13,39726 , 0 
69361.36,20,83 ,12 ,1366 ,0 ,0 ,2 ,1 ,0 ,1 ,1 ,5 ,0 ,9 ,1 ,10,35295 , 0 
69361.361,16,83 ,2 ,512 ,0 ,0 ,2 ,1 ,14 ,0 ,2 ,19 ,0 ,12 ,18 ,30,73106 , 0 
69361.444,10,83 ,14 ,520 ,0 ,0 ,2 ,1 ,0 ,0 ,0 ,3 ,0 ,4 ,0 ,4,36991 , 0 
69361.482,12,83 ,5 ,795 ,0 ,0 ,2 ,2 ,1 ,1 ,1 ,7 ,0 ,12 ,3 ,15,38400 , 0 
69361.596,9,83 ,16 ,940 ,0 ,0 ,6 ,2 ,8 ,1 ,0 ,17 ,0 ,15 ,8 ,23,63993 , 0 
69361.603,5,83 ,19 ,512 ,0 ,0 ,3 ,1 ,4 ,1 ,2 ,11 ,0 ,20 ,7 ,27,61554 , 0 
69361.606,19,83 ,1 ,256 ,0 ,0 ,0 ,1 ,5 ,1 ,2 ,9 ,0 ,10 ,8 ,18,39836 , 0 
69361.696,17,83 ,16 ,940 ,0 ,0 ,4 ,1 ,0 ,0 ,0 ,5 ,0 ,5 ,0 ,5,48125 , 0 
69361.771,13,83 ,1 ,256 ,0 ,0 ,3 ,1 ,0 ,0 ,0 ,4 ,0 ,7 ,0 ,7,35713 , 0 
69361.787,3,83 ,1 ,256 ,0 ,0 ,2 ,1 ,0 ,0 ,0 ,3 ,0 ,5 ,0 ,5,25191 , 0 
69480.96,8,83 ,1 ,256 ,0 ,0 ,2 ,1 ,0 ,0 ,0 ,3 ,0 ,4 ,0 ,4,29346 , 0 
69481.078,11,83 ,9 ,1218 ,0 ,0 ,1 ,2 ,0 ,0 ,0 ,3 ,0 ,8 ,0 ,8,47877 , 0 
69481.123,2,83 ,1 ,256 ,0 ,0 ,1 ,1 ,4 ,0 ,0 ,6 ,0 ,4 ,4 ,8,48914 , 0 
69481.138,6,83 ,2 ,512 ,0 ,0 ,1 ,0 ,0 ,0 ,0 ,1 ,0 ,4 ,0 ,4,61424 , 0 
69481.214,18,83 ,19 ,529 ,0 ,0 ,1 ,1 ,0 ,0 ,0 ,2 ,0 ,4 ,0 ,4,39830 , 0 
69481.236,4,83 ,8 ,512 ,0 ,0 ,3 ,0 ,0 ,0 ,0 ,3 ,0 ,2 ,0 ,2,35317 , 0 
69481.289,7,83 ,16 ,848 ,0 ,0 ,2 ,1 ,0 ,0 ,0 ,3 ,0 ,4 ,0 ,4,51008 , 0 
69481.337,14,83 ,1 ,256 ,0 ,0 ,1 ,1 ,1 ,0 ,0 ,3 ,0 ,5 ,1 ,6,33163 , 0 
69481.35,15,83 ,9 ,1196 ,0 ,0 ,2 ,1 ,0 ,0 ,0 ,3 ,0 ,4 ,0 ,4,41703 , 0 
69481.36,20,83 ,12 ,1265 ,0 ,0 ,2 ,2 ,0 ,0 ,0 ,4 ,0 ,3 ,0 ,3,38326 , 0 
69481.36,16,83 ,2 ,512 ,0 ,0 ,1 ,0 ,4 ,0 ,0 ,5 ,0 ,3 ,4 ,7,66744 , 0 
69481.444,10,83 ,14 ,520 ,0 ,0 ,2 ,1 ,0 ,0 ,0 ,3 ,0 ,1 ,0 ,1,35973 , 0 
69481.482,12,83 ,5 ,795 ,0 ,0 ,2 ,0 ,2 ,0 ,0 ,4 ,0 ,2 ,2 ,4,42073 , 0 
69481.596,9,83 ,16 ,940 ,0 ,0 ,3 ,0 ,3 ,0 ,0 ,6 ,0 ,3 ,3 ,6,61751 , 0 
69481.602,5,83 ,19 ,529 ,0 ,0 ,1 ,1 ,2 ,0 ,0 ,4 ,0 ,6 ,2 ,8,63925 , 0 
69481.606,19,83 ,1 ,256 ,0 ,0 ,2 ,1 ,4 ,0 ,0 ,7 ,0 ,4 ,4 ,8,40865 , 0 
69481.696,17,83 ,16 ,940 ,0 ,0 ,2 ,0 ,0 ,0 ,0 ,2 ,0 ,1 ,0 ,1,46371 , 0 
69481.771,13,83 ,1 ,256 ,0 ,0 ,1 ,1 ,0 ,0 ,0 ,2 ,0 ,3 ,0 ,3,36226 , 0 
69481.787,3,83 ,1 ,256 ,0 ,0 ,2 ,1 ,0 ,0 ,0 ,3 ,0 ,3 ,0 ,3,25452 , 0 
69600.96,8,83 ,1 ,256 ,0 ,0 ,1 ,1 ,1 ,0 ,0 ,3 ,0 ,5 ,1 ,6,29251 , 0 
69601.078,11,83 ,9 ,300 ,0 ,0 ,13 ,7 ,7 ,7 ,0 ,34 ,0 ,43 ,22 ,65,45274 , 0 
69601.124,2,83 ,1 ,256 ,0 ,0 ,8 ,1 ,22 ,3 ,6 ,40 ,0 ,19 ,29 ,48,52279 , 0 
69601.138,6,83 ,2 ,519 ,0 ,0 ,9 ,6 ,0 ,0 ,0 ,15 ,0 ,31 ,0 ,31,72864 , 0 
69601.214,18,83 ,19 ,529 ,0 ,0 ,6 ,0 ,0 ,0 ,0 ,6 ,0 ,15 ,0 ,15,36988 , 0 
69601.236,4,83 ,8 ,512 ,0 ,0 ,1 ,1 ,0 ,0 ,0 ,2 ,0 ,6 ,0 ,6,33949 , 0 
69601.29,7,83 ,9 ,300 ,0 ,0 ,12 ,16 ,5 ,9 ,2 ,44 ,0 ,43 ,22 ,65,52398 , 0 
69601.337,14,83 ,1 ,256 ,0 ,0 ,1 ,0 ,1 ,0 ,0 ,2 ,0 ,8 ,1 ,9,33031 , 0 
69601.351,15,83 ,9 ,300 ,0 ,0 ,16 ,14 ,3 ,10 ,1 ,44 ,0 ,27 ,20 ,47,40309 , 0 
69601.36,20,83 ,11 ,674 ,0 ,0 ,10 ,6 ,0 ,2 ,0 ,18 ,0 ,19 ,0 ,19,35601 , 0 
69601.374,16,83 ,2 ,519 ,0 ,0 ,17 ,13 ,16 ,14 ,3 ,63 ,0 ,34 ,38 ,72,73874 , 0 
69601.444,10,83 ,14 ,539 ,0 ,0 ,2 ,1 ,0 ,0 ,0 ,3 ,0 ,8 ,0 ,8,37080 , 0 
69601.482,12,83 ,11 ,674 ,0 ,0 ,11 ,6 ,0 ,5 ,0 ,22 ,0 ,18 ,3 ,21,38770 , 0 
69601.597,9,83 ,16 ,876 ,0 ,0 ,20 ,11 ,20 ,27 ,6 ,84 ,0 ,40 ,87 ,127,65016 , 1 
69601.603,5,83 ,19 ,529 ,0 ,0 ,10 ,8 ,3 ,7 ,1 ,29 ,0 ,41 ,16 ,57,62121 , 0 
69601.607,19,83 ,1 ,256 ,0 ,0 ,2 ,0 ,5 ,0 ,3 ,10 ,0 ,18 ,8 ,26,39955 , 0 
69601.697,17,83 ,16 ,876 ,0 ,0 ,11 ,14 ,0 ,4 ,0 ,29 ,0 ,31 ,2 ,33,48584 , 0 
69601.771,13,83 ,1 ,256 ,0 ,0 ,2 ,1 ,0 ,0 ,0 ,3 ,0 ,12 ,0 ,12,35826 , 0 
69601.787,3,83 ,1 ,256 ,0 ,0 ,2 ,1 ,0 ,0 ,0 ,3 ,0 ,2 ,0 ,2,25281 , 0 
69720.96,8,83 ,1 ,256 ,0 ,0 ,2 ,0 ,0 ,0 ,0 ,2 ,0 ,1 ,0 ,1,29455 , 0 
69721.079,11,83 ,9 ,300 ,0 ,0 ,16 ,11 ,9 ,14 ,1 ,51 ,0 ,41 ,34 ,75,48525 , 0 
69721.134,2,83 ,1 ,256 ,0 ,0 ,3 ,0 ,13 ,2 ,8 ,26 ,0 ,17 ,21 ,38,49099 , 0 
69721.138,6,83 ,2 ,512 ,0 ,0 ,3 ,2 ,1 ,0 ,1 ,7 ,0 ,20 ,2 ,22,61574 , 0 
69721.214,18,83 ,19 ,529 ,0 ,0 ,3 ,0 ,0 ,0 ,0 ,3 ,0 ,11 ,0 ,11,39957 , 0 
69721.236,4,83 ,8 ,512 ,0 ,0 ,2 ,0 ,0 ,0 ,0 ,2 ,0 ,3 ,0 ,3,35424 , 0 
69721.299,7,83 ,9 ,300 ,0 ,0 ,12 ,12 ,18 ,8 ,9 ,59 ,0 ,39 ,39 ,78,51597 , 0 
69721.337,14,83 ,1 ,256 ,0 ,0 ,1 ,0 ,0 ,0 ,0 ,1 ,0 ,4 ,0 ,4,33270 , 0 
69721.35,15,83 ,9 ,300 ,0 ,0 ,14 ,14 ,1 ,15 ,1 ,45 ,0 ,33 ,24 ,57,42241 , 0 
69721.36,20,83 ,11 ,933 ,0 ,0 ,7 ,8 ,0 ,2 ,0 ,17 ,0 ,20 ,1 ,21,38535 , 0 
69721.361,16,83 ,9 ,300 ,0 ,0 ,11 ,5 ,15 ,8 ,8 ,47 ,0 ,28 ,37 ,65,67387 , 0 
69721.444,10,83 ,14 ,539 ,0 ,0 ,1 ,0 ,0 ,0 ,0 ,1 ,0 ,2 ,0 ,2,36037 , 0 
69721.482,12,83 ,11 ,933 ,0 ,0 ,9 ,8 ,1 ,5 ,1 ,24 ,0 ,19 ,5 ,24,42410 , 0 
69721.603,5,83 ,19 ,529 ,0 ,0 ,7 ,0 ,5 ,0 ,1 ,13 ,0 ,37 ,11 ,48,64173 , 0 
69721.607,19,83 ,1 ,256 ,0 ,0 ,1 ,0 ,5 ,1 ,1 ,8 ,0 ,14 ,6 ,20,41020 , 0 
69721.736,9,83 ,15 ,65535 ,0 ,0 ,20 ,12 ,28 ,32 ,10 ,102 ,0 ,39 ,88 ,127,62642 , 1 
69721.761,17,83 ,7 ,691 ,0 ,0 ,9 ,7 ,0 ,3 ,0 ,19 ,0 ,19 ,0 ,19,46579 , 0 
69721.771,13,83 ,1 ,256 ,0 ,0 ,2 ,0 ,0 ,0 ,0 ,2 ,0 ,8 ,0 ,8,36350 , 0 
69721.787,3,83 ,1 ,256 ,0 ,0 ,2 ,0 ,0 ,0 ,0 ,2 ,0 ,1 ,0 ,1,25530 , 0 
69840.96,8,83 ,1 ,256 ,0 ,0 ,0 ,0 ,0 ,0 ,0 ,0 ,0 ,0 ,0 ,0,29310 , 0 
69841.079,11,83 ,9 ,300 ,0 ,0 ,7 ,13 ,5 ,1 ,0 ,26 ,0 ,31 ,7 ,38,45689 , 0 
69841.124,2,83 ,1 ,256 ,0 ,0 ,2 ,0 ,2 ,3 ,1 ,8 ,0 ,15 ,4 ,19,52408 , 0 
69841.138,6,83 ,2 ,512 ,0 ,0 ,2 ,1 ,1 ,1 ,1 ,6 ,0 ,27 ,4 ,31,73098 , 0 
69841.214,18,83 ,19 ,529 ,0 ,0 ,2 ,0 ,0 ,0 ,0 ,2 ,0 ,3 ,0 ,3,37116 , 0 
69841.236,4,83 ,8 ,512 ,0 ,0 ,1 ,0 ,0 ,0 ,0 ,1 ,0 ,2 ,0 ,2,34026 , 0 
69841.296,7,83 ,9 ,300 ,0 ,0 ,16 ,14 ,15 ,14 ,7 ,66 ,0 ,47 ,38 ,85,52962 , 0 
69841.337,14,83 ,1 ,256 ,0 ,0 ,1 ,0 ,0 ,0 ,0 ,1 ,0 ,2 ,0 ,2,33101 , 0 
69841.35,15,83 ,9 ,300 ,0 ,0 ,13 ,13 ,2 ,8 ,2 ,38 ,0 ,31 ,15 ,46,40697 , 0 
69841.36,20,83 ,11 ,859 ,0 ,0 ,4 ,4 ,0 ,0 ,0 ,8 ,0 ,7 ,0 ,7,35753 , 0 
69841.361,16,83 ,9 ,300 ,0 ,0 ,19 ,15 ,5 ,16 ,1 ,56 ,0 ,35 ,26 ,61,74363 , 0 
69841.444,10,83 ,14 ,539 ,0 ,0 ,1 ,0 ,0 ,0 ,0 ,1 ,0 ,2 ,0 ,2,37160 , 0 
69841.491,12,83 ,11 ,859 ,0 ,0 ,4 ,2 ,0 ,1 ,0 ,7 ,0 ,10 ,0 ,10,38927 , 0 
69841.597,9,83 ,5 ,853 ,0 ,0 ,18 ,11 ,24 ,22 ,6 ,81 ,0 ,41 ,93 ,134,65793 , 1 
69841.607,19,83 ,1 ,256 ,0 ,0 ,2 ,0 ,13 ,0 ,4 ,19 ,0 ,4 ,17 ,21,40119 , 0 
69841.608,5,83 ,19 ,529 ,0 ,0 ,3 ,0 ,13 ,0 ,4 ,20 ,0 ,23 ,29 ,52,62530 , 0 
69841.697,17,83 ,16 ,637 ,0 ,0 ,14 ,11 ,0 ,5 ,0 ,30 ,0 ,29 ,2 ,31,48918 , 0 
69841.771,13,83 ,1 ,256 ,0 ,0 ,2 ,0 ,0 ,0 ,0 ,2 ,0 ,4 ,0 ,4,35932 , 0 
69841.787,3,83 ,1 ,256 ,0 ,0 ,0 ,0 ,0 ,0 ,0 ,0 ,0 ,1 ,0 ,1,25337 , 0 
69960.96,8,83 ,1 ,256 ,0 ,0 ,2 ,0 ,3 ,0 ,0 ,5 ,0 ,0 ,5 ,5,29559 , 0 
69961.078,11,83 ,5 ,788 ,0 ,0 ,6 ,5 ,1 ,3 ,1 ,16 ,0 ,22 ,3 ,25,48763 , 0 
69961.124,2,83 ,1 ,256 ,0 ,0 ,6 ,0 ,11 ,0 ,1 ,18 ,0 ,17 ,14 ,31,49296 , 0 
69961.138,6,83 ,2 ,523 ,0 ,0 ,5 ,4 ,1 ,1 ,0 ,11 ,0 ,16 ,1 ,17,61727 , 0 
69961.214,18,83 ,4 ,804 ,0 ,0 ,5 ,2 ,1 ,2 ,1 ,11 ,0 ,12 ,2 ,14,40138 , 0 
69961.236,4,83 ,8 ,512 ,0 ,0 ,1 ,1 ,2 ,1 ,1 ,6 ,0 ,4 ,4 ,8,35565 , 0 
69961.289,7,83 ,16 ,974 ,0 ,0 ,8 ,5 ,1 ,4 ,1 ,19 ,0 ,21 ,6 ,27,51834 , 0 
69961.337,14,83 ,1 ,256 ,0 ,0 ,1 ,0 ,0 ,0 ,0 ,1 ,0 ,5 ,0 ,5,33361 , 0 
69961.35,15,83 ,9 ,1162 ,0 ,0 ,8 ,5 ,1 ,6 ,1 ,21 ,0 ,13 ,7 ,20,42553 , 0 
69961.36,20,83 ,12 ,1398 ,0 ,0 ,5 ,6 ,0 ,1 ,0 ,12 ,0 ,14 ,0 ,14,38719 , 0 
69961.361,16,83 ,2 ,531 ,0 ,0 ,9 ,3 ,4 ,3 ,1 ,20 ,0 ,13 ,8 ,21,67703 , 0 
69961.444,10,83 ,14 ,539 ,0 ,0 ,1 ,0 ,0 ,0 ,0 ,1 ,0 ,5 ,0 ,5,36120 , 0 
69961.482,12,83 ,5 ,788 ,0 ,0 ,7 ,5 ,5 ,2 ,0 ,19 ,0 ,13 ,6 ,19,42781 , 0 
69961.596,9,83 ,5 ,788 ,0 ,0 ,7 ,6 ,7 ,4 ,1 ,25 ,0 ,24 ,16 ,40,63070 , 0 
69961.603,5,83 ,19 ,529 ,0 ,0 ,5 ,0 ,22 ,0 ,2 ,29 ,0 ,19 ,27 ,46,64603 , 0 
69961.607,19,83 ,1 ,256 ,0 ,0 ,1 ,0 ,22 ,1 ,3 ,27 ,0 ,10 ,25 ,35,41168 , 0 
69961.697,17,83 ,6 ,890 ,0 ,0 ,8 ,3 ,0 ,2 ,0 ,13 ,0 ,15 ,1 ,16,46774 , 0 
69961.771,13,83 ,1 ,256 ,0 ,0 ,1 ,0 ,0 ,0 ,0 ,1 ,0 ,9 ,0 ,9,36437 , 0 
69961.787,3,83 ,1 ,256 ,0 ,0 ,1 ,0 ,0 ,0 ,0 ,1 ,0 ,1 ,0 ,1,25594 , 0 
70080.96,8,83 ,1 ,256 ,0 ,0 ,2 ,0 ,0 ,0 ,0 ,2 ,0 ,2 ,0 ,2,29384 , 0 
70081.078,11,83 ,5 ,788 ,0 ,0 ,3 ,1 ,0 ,0 ,0 ,4 ,0 ,7 ,0 ,7,45785 , 0 
70081.124,2,83 ,1 ,256 ,0 ,0 ,3 ,0 ,7 ,0 ,0 ,10 ,0 ,3 ,7 ,10,52494 , 0 
70081.138,6,83 ,2 ,513 ,0 ,0 ,3 ,2 ,2 ,0 ,0 ,7 ,0 ,5 ,2 ,7,73211 , 0 
70081.214,18,83 ,4 ,804 ,0 ,0 ,4 ,0 ,0 ,0 ,0 ,4 ,0 ,1 ,0 ,1,37203 , 0 
70081.236,4,83 ,8 ,531 ,0 ,0 ,2 ,0 ,0 ,0 ,0 ,2 ,0 ,2 ,0 ,2,34105 , 0 
70081.289,7,83 ,16 ,877 ,0 ,0 ,2 ,1 ,0 ,0 ,0 ,3 ,0 ,7 ,0 ,7,53035 , 0 
70081.337,14,83 ,1 ,256 ,0 ,0 ,2 ,0 ,1 ,0 ,0 ,3 ,0 ,3 ,1 ,4,33181 , 0 
70081.35,15,83 ,9 ,1116 ,0 ,0 ,3 ,1 ,0 ,0 ,0 ,4 ,0 ,5 ,0 ,5,40770 , 0 
70081.36,20,83 ,12 ,1315 ,0 ,0 ,3 ,1 ,0 ,0 ,0 ,4 ,0 ,4 ,0 ,4,35839 , 0 
70081.36,16,83 ,2 ,513 ,0 ,0 ,2 ,2 ,1 ,0 ,0 ,5 ,0 ,9 ,1 ,10,74480 , 0 
70081.444,10,83 ,14 ,579 ,0 ,0 ,1 ,1 ,0 ,0 ,0 ,2 ,0 ,2 ,0 ,2,37241 , 0 
70081.482,12,83 ,5 ,788 ,0 ,0 ,2 ,1 ,1 ,0 ,0 ,4 ,0 ,5 ,1 ,6,39016 , 0 
70081.596,9,83 ,5 ,788 ,0 ,0 ,2 ,0 ,1 ,0 ,0 ,3 ,0 ,6 ,1 ,7,65883 , 0 
70081.603,5,83 ,19 ,529 ,0 ,0 ,1 ,0 ,4 ,1 ,0 ,6 ,0 ,9 ,4 ,13,62649 , 0 
70081.606,19,83 ,1 ,256 ,0 ,0 ,0 ,0 ,4 ,1 ,0 ,5 ,0 ,8 ,5 ,13,40205 , 0 
70081.696,17,83 ,6 ,846 ,0 ,0 ,3 ,2 ,0 ,0 ,0 ,5 ,0 ,4 ,0 ,4,49021 , 0 
70081.771,13,83 ,1 ,256 ,0 ,0 ,0 ,0 ,0 ,0 ,0 ,0 ,0 ,4 ,0 ,4,36029 , 0 
70081.787,3,83 ,1 ,256 ,0 ,0 ,2 ,0 ,0 ,0 ,0 ,2 ,0 ,3 ,0 ,3,25408 , 0 
70200.96,8,83 ,1 ,256 ,0 ,0 ,1 ,0 ,2 ,0 ,0 ,3 ,0 ,1 ,2 ,3,29662 , 0 
70201.078,11,83 ,5 ,785 ,0 ,0 ,1 ,1 ,0 ,0 ,0 ,2 ,0 ,5 ,0 ,5,48852 , 0 
70201.123,2,83 ,1 ,256 ,0 ,0 ,1 ,0 ,3 ,0 ,0 ,4 ,0 ,5 ,3 ,8,49394 , 0 
70201.138,6,83 ,2 ,513 ,0 ,0 ,2 ,0 ,1 ,0 ,0 ,3 ,0 ,3 ,1 ,4,61823 , 0 
70201.214,18,83 ,4 ,804 ,0 ,0 ,0 ,1 ,0 ,0 ,0 ,1 ,0 ,5 ,0 ,5,40220 , 0 
70201.236,4,83 ,8 ,531 ,0 ,0 ,1 ,1 ,1 ,0 ,0 ,3 ,0 ,1 ,1 ,2,35643 , 0 
70201.289,7,83 ,16 ,877 ,0 ,0 ,2 ,1 ,0 ,0 ,0 ,3 ,0 ,2 ,0 ,2,51923 , 0 
70201.337,14,83 ,1 ,256 ,0 ,0 ,2 ,0 ,0 ,0 ,0 ,2 ,0 ,4 ,0 ,4,33442 , 0 
70201.35,15,83 ,9 ,1092 ,0 ,0 ,1 ,2 ,0 ,0 ,0 ,3 ,0 ,3 ,0 ,3,42666 , 0 
70201.36,20,83 ,12 ,1310 ,0 ,0 ,1 ,1 ,0 ,0 ,0 ,2 ,0 ,2 ,0 ,2,38795 , 0 
70201.36,16,83 ,2 ,512 ,0 ,0 ,2 ,1 ,1 ,0 ,0 ,4 ,0 ,5 ,1 ,6,67799 , 0 
70201.444,10,83 ,14 ,579 ,0 ,0 ,2 ,0 ,0 ,0 ,0 ,2 ,0 ,2 ,0 ,2,36190 , 0 
70201.482,12,83 ,5 ,785 ,0 ,0 ,2 ,1 ,1 ,0 ,0 ,4 ,0 ,1 ,1 ,2,42915 , 0 
70201.596,9,83 ,5 ,785 ,0 ,0 ,2 ,1 ,2 ,0 ,0 ,5 ,0 ,3 ,2 ,5,63192 , 0 
70201.602,5,83 ,19 ,529 ,0 ,0 ,2 ,0 ,6 ,0 ,0 ,8 ,0 ,3 ,6 ,9,64812 , 0 
70201.606,19,83 ,1 ,256 ,0 ,0 ,1 ,0 ,6 ,0 ,0 ,7 ,0 ,2 ,6 ,8,41277 , 0 
70201.696,17,83 ,6 ,814 ,0 ,0 ,2 ,1 ,0 ,0 ,0 ,3 ,0 ,4 ,0 ,4,46863 , 0 
70201.771,13,83 ,1 ,256 ,0 ,0 ,2 ,0 ,0 ,0 ,0 ,2 ,0 ,2 ,0 ,2,36530 , 0 
70201.787,3,83 ,1 ,256 ,0 ,0 ,1 ,0 ,0 ,0 ,0 ,1 ,0 ,0 ,0 ,0,25659 , 0 
70320.96,8,83 ,1 ,256 ,0 ,0 ,2 ,0 ,0 ,0 ,0 ,2 ,0 ,1 ,0 ,1,29482 , 0 
70321.078,11,83 ,5 ,785 ,0 ,0 ,1 ,0 ,0 ,0 ,0 ,1 ,0 ,2 ,0 ,2,45847 , 0 
70321.124,2,83 ,1 ,256 ,0 ,0 ,26 ,0 ,49 ,0 ,0 ,75 ,105 ,21 ,49 ,175,52832 , 0 
70321.147,6,83 ,2 ,512 ,0 ,120 ,1 ,16 ,1 ,0 ,0 ,138 ,0 ,83 ,1 ,84,74087 , 1 
70321.214,18,83 ,4 ,804 ,0 ,0 ,2 ,0 ,0 ,0 ,0 ,2 ,0 ,1 ,0 ,1,37287 , 0 
70321.236,4,83 ,8 ,531 ,0 ,0 ,1 ,0 ,0 ,0 ,0 ,1 ,0 ,0 ,0 ,0,34205 , 0 
70321.29,7,83 ,16 ,789 ,0 ,0 ,0 ,18 ,0 ,0 ,0 ,18 ,0 ,47 ,0 ,47,53249 , 0 
70321.338,14,83 ,1 ,256 ,0 ,0 ,0 ,0 ,0 ,0 ,0 ,0 ,0 ,39 ,0 ,39,33267 , 0 
70321.35,15,83 ,9 ,1092 ,0 ,0 ,1 ,0 ,0 ,0 ,0 ,1 ,0 ,0 ,0 ,0,40848 , 0 
70321.36,20,83 ,12 ,1310 ,0 ,0 ,2 ,0 ,0 ,0 ,0 ,2 ,0 ,1 ,0 ,1,35950 , 0 
70321.361,16,83 ,2 ,512 ,0 ,0 ,26 ,14 ,18 ,0 ,0 ,58 ,107 ,38 ,18 ,163,75010 , 0 
70321.444,10,83 ,14 ,579 ,0 ,0 ,25 ,0 ,0 ,0 ,0 ,25 ,108 ,0 ,0 ,108,37494 , 0 
70321.481,12,83 ,5 ,785 ,0 ,0 ,0 ,0 ,0 ,0 ,0 ,0 ,0 ,2 ,0 ,2,39073 , 0 
70321.596,9,83 ,5 ,785 ,0 ,0 ,2 ,0 ,0 ,0 ,0 ,2 ,0 ,25 ,0 ,25,65997 , 0 
70321.603,5,83 ,19 ,529 ,0 ,0 ,2 ,0 ,0 ,0 ,0 ,2 ,0 ,24 ,0 ,24,62744 , 0 
70321.607,19,83 ,1 ,256 ,0 ,0 ,2 ,0 ,0 ,0 ,0 ,2 ,0 ,24 ,0 ,24,40318 , 0 
70321.697,17,83 ,6 ,779 ,0 ,0 ,25 ,1 ,0 ,0 ,0 ,26 ,109 ,26 ,0 ,135,49348 , 0 
70321.771,13,83 ,1 ,256 ,0 ,0 ,1 ,0 ,0 ,0 ,0 ,1 ,0 ,21 ,0 ,21,36114 , 0 
70321.787,3,83 ,1 ,256 ,0 ,0 ,1 ,0 ,0 ,0 ,0 ,1 ,0 ,1 ,0 ,1,25480 , 0 
70440.96,8,83 ,1 ,256 ,0 ,0 ,1 ,0 ,0 ,0 ,0 ,1 ,0 ,1 ,0 ,1,29765 , 0 
70441.078,11,83 ,5 ,785 ,0 ,0 ,2 ,0 ,0 ,0 ,0 ,2 ,0 ,5 ,0 ,5,48933 , 0 
70441.124,2,83 ,1 ,256 ,0 ,0 ,26 ,0 ,52 ,0 ,0 ,78 ,109 ,24 ,52 ,185,49773 , 0 
70441.214,18,83 ,4 ,804 ,0 ,0 ,2 ,0 ,0 ,0 ,0 ,2 ,0 ,1 ,0 ,1,40297 , 0 
70441.236,4,83 ,8 ,531 ,0 ,0 ,1 ,0 ,0 ,0 ,0 ,1 ,0 ,1 ,0 ,1,35703 , 0 
70441.274,6,83 ,2 ,512 ,0 ,120 ,1 ,19 ,0 ,0 ,0 ,140 ,0 ,87 ,0 ,87,62733 , 1 
70441.29,7,83 ,16 ,773 ,0 ,0 ,1 ,16 ,0 ,0 ,0 ,17 ,0 ,45 ,0 ,45,52149 , 0 
70441.337,14,83 ,1 ,256 ,0 ,0 ,2 ,0 ,0 ,0 ,0 ,2 ,0 ,43 ,0 ,43,33548 , 0 
70441.35,15,83 ,9 ,1077 ,0 ,0 ,3 ,0 ,0 ,0 ,0 ,3 ,0 ,2 ,0 ,2,42749 , 0 
70441.36,20,83 ,12 ,1261 ,0 ,0 ,1 ,2 ,0 ,0 ,0 ,3 ,0 ,4 ,0 ,4,38893 , 0 
70441.361,16,83 ,2 ,512 ,0 ,0 ,25 ,17 ,16 ,0 ,0 ,58 ,108 ,39 ,16 ,163,68338 , 0 
70441.444,10,83 ,14 ,579 ,0 ,0 ,26 ,0 ,0 ,0 ,0 ,26 ,108 ,1 ,0 ,109,36452 , 0 
70441.482,12,83 ,5 ,785 ,0 ,0 ,3 ,0 ,2 ,0 ,0 ,5 ,0 ,3 ,2 ,5,43020 , 0 
70441.596,9,83 ,5 ,785 ,0 ,0 ,1 ,0 ,0 ,0 ,0 ,1 ,0 ,27 ,0 ,27,63347 , 0 
70441.603,5,83 ,19 ,529 ,0 ,0 ,1 ,0 ,2 ,0 ,0 ,3 ,0 ,26 ,2 ,28,64959 , 0 
70441.606,19,83 ,1 ,256 ,0 ,0 ,1 ,0 ,2 ,0 ,0 ,3 ,0 ,25 ,2 ,27,41406 , 0 
70441.697,17,83 ,6 ,779 ,0 ,0 ,25 ,0 ,0 ,0 ,0 ,25 ,110 ,25 ,0 ,135,47155 , 0 
70441.771,13,83 ,1 ,256 ,0 ,0 ,1 ,0 ,0 ,0 ,0 ,1 ,0 ,22 ,0 ,22,36657 , 0 
70441.787,3,83 ,1 ,256 ,0 ,0 ,1 ,0 ,0 ,0 ,0 ,1 ,0 ,2 ,0 ,2,25734 , 0 
70560.96,8,83 ,1 ,256 ,0 ,0 ,1 ,0 ,0 ,0 ,0 ,1 ,0 ,1 ,0 ,1,29558 , 0 
70561.078,11,83 ,5 ,785 ,0 ,0 ,1 ,0 ,0 ,0 ,0 ,1 ,0 ,1 ,0 ,1,45940 , 0 
70561.124,2,83 ,1 ,256 ,0 ,0 ,24 ,0 ,51 ,0 ,0 ,75 ,113 ,20 ,51 ,184,53189 , 0 
70561.214,18,83 ,4 ,796 ,0 ,0 ,1 ,0 ,0 ,0 ,0 ,1 ,0 ,3 ,0 ,3,37379 , 0 
70561.236,4,83 ,8 ,523 ,0 ,0 ,1 ,0 ,0 ,0 ,0 ,1 ,0 ,1 ,0 ,1,34260 , 0 
70561.27,6,83 ,2 ,513 ,0 ,120 ,1 ,18 ,0 ,0 ,0 ,139 ,0 ,83 ,0 ,83,74982 , 1 
70561.29,7,83 ,16 ,779 ,0 ,0 ,1 ,16 ,0 ,0 ,0 ,17 ,0 ,39 ,0 ,39,53467 , 0 
70561.337,14,83 ,1 ,256 ,0 ,0 ,0 ,0 ,0 ,0 ,0 ,0 ,0 ,39 ,0 ,39,33345 , 0 
70561.35,15,83 ,9 ,1077 ,0 ,0 ,0 ,1 ,0 ,0 ,0 ,1 ,0 ,3 ,0 ,3,40977 , 0 
70561.36,20,83 ,12 ,1261 ,0 ,0 ,0 ,0 ,0 ,0 ,0 ,0 ,0 ,0 ,0 ,0,36014 , 0 
70561.361,16,83 ,2 ,513 ,0 ,0 ,25 ,17 ,16 ,0 ,0 ,58 ,110 ,39 ,16 ,165,75580 , 0 
70561.444,10,83 ,14 ,579 ,0 ,0 ,25 ,0 ,0 ,0 ,0 ,25 ,113 ,0 ,0 ,113,37748 , 0 
70561.482,12,83 ,5 ,785 ,0 ,0 ,1 ,0 ,0 ,0 ,0 ,1 ,0 ,0 ,0 ,0,39175 , 0 
70561.596,9,83 ,5 ,785 ,0 ,0 ,2 ,0 ,1 ,0 ,0 ,3 ,0 ,19 ,1 ,20,66139 , 0 
70561.603,5,83 ,19 ,529 ,0 ,0 ,1 ,0 ,1 ,0 ,0 ,2 ,0 ,21 ,1 ,22,62928 , 0 
70561.606,19,83 ,1 ,256 ,0 ,0 ,1 ,0 ,1 ,0 ,0 ,2 ,0 ,21 ,1 ,22,40454 , 0 
70561.697,17,83 ,6 ,772 ,0 ,0 ,24 ,0 ,0 ,0 ,0 ,24 ,114 ,23 ,0 ,137,49622 , 0 
70561.771,13,83 ,1 ,256 ,0 ,0 ,1 ,0 ,0 ,0 ,0 ,1 ,0 ,21 ,0 ,21,36223 , 0 
70561.787,3,83 ,1 ,256 ,0 ,0 ,1 ,0 ,0 ,0 ,0 ,1 ,0 ,0 ,0 ,0,25530 , 0 
70680.96,8,83 ,1 ,256 ,0 ,0 ,1 ,0 ,0 ,0 ,0 ,1 ,0 ,1 ,0 ,1,29828 , 0 
70681.078,11,83 ,5 ,785 ,0 ,0 ,3 ,0 ,0 ,0 ,0 ,3 ,0 ,3 ,0 ,3,49009 , 0 
70681.124,2,83 ,1 ,256 ,0 ,0 ,6 ,0 ,13 ,0 ,0 ,19 ,1 ,5 ,13 ,19,49890 , 0 
70681.138,6,83 ,2 ,512 ,0 ,0 ,0 ,5 ,0 ,0 ,0 ,5 ,0 ,20 ,0 ,20,62843 , 0 
70681.214,18,83 ,4 ,796 ,0 ,0 ,1 ,0 ,0 ,0 ,0 ,1 ,0 ,1 ,0 ,1,40361 , 0 
70681.235,4,83 ,8 ,523 ,0 ,0 ,1 ,0 ,0 ,0 ,0 ,1 ,0 ,0 ,0 ,0,35795 , 0 
70681.289,7,83 ,16 ,770 ,0 ,0 ,1 ,5 ,0 ,0 ,0 ,6 ,0 ,10 ,0 ,10,52261 , 0 
70681.337,14,83 ,1 ,256 ,0 ,0 ,2 ,0 ,1 ,0 ,0 ,3 ,0 ,11 ,1 ,12,33640 , 0 
70681.35,15,83 ,9 ,1077 ,0 ,0 ,1 ,0 ,0 ,0 ,0 ,1 ,0 ,1 ,0 ,1,42820 , 0 
70681.36,20,83 ,12 ,1201 ,0 ,0 ,1 ,0 ,0 ,0 ,0 ,1 ,0 ,3 ,0 ,3,38963 , 0 
70681.36,16,83 ,2 ,512 ,0 ,0 ,4 ,3 ,5 ,0 ,0 ,12 ,0 ,7 ,5 ,12,68476 , 0 
70681.444,10,83 ,14 ,546 ,0 ,0 ,6 ,1 ,0 ,0 ,0 ,7 ,0 ,1 ,0 ,1,36580 , 0 
70681.482,12,83 ,5 ,785 ,0 ,0 ,2 ,0 ,0 ,0 ,0 ,2 ,0 ,2 ,0 ,2,43112 , 0 
70681.596,9,83 ,5 ,785 ,0 ,0 ,0 ,0 ,0 ,0 ,0 ,0 ,0 ,7 ,0 ,7,63416 , 0 
70681.602,5,83 ,19 ,529 ,0 ,0 ,1 ,0 ,0 ,0 ,0 ,1 ,0 ,7 ,0 ,7,65038 , 0 
70681.606,19,83 ,1 ,256 ,0 ,0 ,0 ,0 ,0 ,0 ,0 ,0 ,0 ,7 ,0 ,7,41480 , 0 
70681.696,17,83 ,6 ,772 ,0 ,0 ,7 ,0 ,0 ,0 ,0 ,7 ,0 ,4 ,0 ,4,47266 , 0 
70681.771,13,83 ,1 ,256 ,0 ,0 ,0 ,0 ,0 ,0 ,0 ,0 ,0 ,5 ,0 ,5,36717 , 0 
70681.787,3,83 ,1 ,256 ,0 ,0 ,1 ,0 ,0 ,0 ,0 ,1 ,0 ,0 ,0 ,0,25794 , 0 
70800.96,8,83 ,1 ,256 ,0 ,0 ,2 ,0 ,0 ,0 ,0 ,2 ,0 ,2 ,0 ,2,29635 , 0 
70801.078,11,83 ,5 ,785 ,0 ,0 ,1 ,0 ,0 ,0 ,0 ,1 ,0 ,5 ,0 ,5,46014 , 0 
70801.123,2,83 ,1 ,256 ,0 ,0 ,1 ,0 ,2 ,0 ,0 ,3 ,0 ,2 ,2 ,4,53269 , 0 
70801.138,6,83 ,2 ,512 ,0 ,0 ,1 ,0 ,0 ,0 ,0 ,1 ,0 ,5 ,0 ,5,75047 , 0 
70801.214,18,83 ,4 ,785 ,0 ,0 ,2 ,0 ,0 ,0 ,0 ,2 ,0 ,1 ,0 ,1,37441 , 0 
70801.236,4,83 ,8 ,523 ,0 ,0 ,2 ,0 ,0 ,0 ,0 ,2 ,0 ,1 ,0 ,1,34324 , 0 
70801.289,7,83 ,16 ,768 ,0 ,0 ,2 ,1 ,1 ,0 ,0 ,4 ,0 ,6 ,1 ,7,53559 , 0 
70801.337,14,83 ,1 ,256 ,0 ,0 ,1 ,0 ,0 ,0 ,0 ,1 ,0 ,2 ,0 ,2,33418 , 0 
70801.35,15,83 ,7 ,1052 ,0 ,0 ,4 ,1 ,0 ,1 ,0 ,6 ,0 ,1 ,0 ,1,41070 , 0 
70801.36,20,83 ,12 ,1201 ,0 ,0 ,2 ,0 ,0 ,0 ,0 ,2 ,0 ,1 ,0 ,1,36081 , 0 
70801.367,16,83 ,2 ,512 ,0 ,0 ,3 ,0 ,2 ,0 ,0 ,5 ,0 ,3 ,2 ,5,75673 , 0 
70801.444,10,83 ,14 ,546 ,0 ,0 ,3 ,0 ,0 ,0 ,0 ,3 ,0 ,0 ,0 ,0,37815 , 0 
70801.482,12,83 ,5 ,785 ,0 ,0 ,0 ,0 ,0 ,0 ,0 ,0 ,0 ,3 ,0 ,3,39231 , 0 
70801.596,9,83 ,5 ,785 ,0 ,0 ,1 ,0 ,0 ,0 ,1 ,2 ,0 ,6 ,1 ,7,66228 , 0 
70801.602,5,83 ,19 ,512 ,0 ,0 ,1 ,1 ,0 ,0 ,1 ,3 ,0 ,5 ,1 ,6,63037 , 0 
70801.606,19,83 ,1 ,256 ,0 ,0 ,1 ,0 ,1 ,0 ,1 ,3 ,0 ,4 ,2 ,6,40537 , 0 
70801.696,17,83 ,6 ,772 ,0 ,0 ,2 ,0 ,0 ,0 ,0 ,2 ,0 ,3 ,0 ,3,49705 , 0 
70801.771,13,83 ,1 ,256 ,0 ,0 ,1 ,0 ,0 ,0 ,0 ,1 ,0 ,1 ,0 ,1,36315 , 0 
70801.787,3,83 ,1 ,256 ,0 ,0 ,1 ,0 ,0 ,0 ,0 ,1 ,0 ,2 ,0 ,2,25595 , 0 
70920.96,8,83 ,1 ,256 ,0 ,0 ,1 ,0 ,1 ,0 ,0 ,2 ,0 ,1 ,1 ,2,29887 , 0 
70921.078,11,83 ,5 ,785 ,0 ,0 ,0 ,0 ,0 ,0 ,0 ,0 ,0 ,5 ,0 ,5,49071 , 0 
70921.123,2,83 ,1 ,256 ,0 ,0 ,2 ,0 ,3 ,0 ,0 ,5 ,0 ,2 ,3 ,5,49990 , 0 
70921.138,6,83 ,2 ,512 ,0 ,0 ,1 ,1 ,0 ,0 ,0 ,2 ,0 ,3 ,0 ,3,62915 , 0 
70921.214,18,83 ,4 ,785 ,0 ,0 ,1 ,1 ,0 ,0 ,0 ,2 ,0 ,3 ,0 ,3,40447 , 0 
70921.236,4,83 ,8 ,518 ,0 ,0 ,1 ,0 ,1 ,0 ,0 ,2 ,0 ,1 ,1 ,2,35856 , 0 
70921.289,7,83 ,16 ,768 ,0 ,0 ,1 ,1 ,0 ,0 ,0 ,2 ,0 ,5 ,0 ,5,52351 , 0 
70921.337,14,83 ,1 ,256 ,0 ,0 ,1 ,0 ,0 ,0 ,0 ,1 ,0 ,3 ,0 ,3,33706 , 0 
70921.35,15,83 ,7 ,1052 ,0 ,0 ,4 ,0 ,0 ,0 ,0 ,4 ,0 ,1 ,0 ,1,42923 , 0 
70921.36,20,83 ,12 ,1201 ,0 ,0 ,1 ,0 ,0 ,0 ,0 ,1 ,0 ,0 ,0 ,0,39033 , 0 
70921.36,16,83 ,2 ,512 ,0 ,0 ,1 ,1 ,1 ,0 ,0 ,3 ,0 ,3 ,1 ,4,68595 , 0 
70921.444,10,83 ,14 ,546 ,0 ,0 ,1 ,0 ,0 ,0 ,0 ,1 ,0 ,1 ,0 ,1,36634 , 0 
70921.482,12,83 ,5 ,785 ,0 ,0 ,2 ,0 ,0 ,0 ,0 ,2 ,0 ,1 ,0 ,1,43203 , 0 
70921.596,9,83 ,5 ,785 ,0 ,0 ,2 ,0 ,0 ,1 ,0 ,3 ,0 ,3 ,0 ,3,63523 , 0 
70921.602,5,83 ,19 ,512 ,0 ,0 ,1 ,0 ,0 ,1 ,0 ,2 ,0 ,3 ,1 ,4,65150 , 0 
70921.606,19,83 ,1 ,256 ,0 ,0 ,1 ,0 ,0 ,1 ,0 ,2 ,0 ,1 ,1 ,2,41570 , 0 
70921.696,17,83 ,6 ,772 ,0 ,0 ,1 ,0 ,0 ,0 ,0 ,1 ,0 ,1 ,0 ,1,47330 , 0 
70921.771,13,83 ,1 ,256 ,0 ,0 ,1 ,0 ,0 ,0 ,0 ,1 ,0 ,2 ,0 ,2,36792 , 0 
70921.787,3,83 ,1 ,256 ,0 ,0 ,1 ,0 ,0 ,0 ,0 ,1 ,0 ,0 ,0 ,0,25847 , 0 
71040.96,8,83 ,1 ,256 ,0 ,0 ,1 ,0 ,0 ,1 ,1 ,3 ,0 ,0 ,2 ,2,29730 , 0 
71041.078,11,83 ,5 ,785 ,0 ,0 ,1 ,0 ,0 ,0 ,0 ,1 ,0 ,11 ,0 ,11,46095 , 0 
71041.124,2,83 ,1 ,256 ,0 ,0 ,5 ,0 ,15 ,0 ,1 ,21 ,0 ,6 ,16 ,22,53403 , 0 
71041.138,6,83 ,2 ,512 ,0 ,0 ,5 ,4 ,7 ,0 ,0 ,16 ,0 ,13 ,7 ,20,75246 , 0 
71041.214,18,83 ,19 ,512 ,0 ,0 ,5 ,1 ,0 ,1 ,0 ,7 ,0 ,1 ,0 ,1,37565 , 0 
71041.236,4,83 ,8 ,518 ,0 ,0 ,1 ,0 ,0 ,1 ,1 ,3 ,0 ,4 ,1 ,5,34481 , 0 
71041.289,7,83 ,17 ,1091 ,0 ,0 ,3 ,4 ,0 ,1 ,1 ,9 ,0 ,16 ,1 ,17,53685 , 0 
71041.337,14,83 ,1 ,256 ,0 ,0 ,1 ,0 ,0 ,0 ,0 ,1 ,0 ,7 ,0 ,7,33497 , 0 
71041.35,15,83 ,9 ,1099 ,0 ,0 ,5 ,4 ,0 ,1 ,0 ,10 ,0 ,8 ,0 ,8,41193 , 0 
71041.36,20,83 ,12 ,1185 ,0 ,0 ,2 ,1 ,0 ,0 ,0 ,3 ,0 ,2 ,0 ,2,36161 , 0 
71041.36,16,83 ,2 ,512 ,0 ,0 ,2 ,4 ,0 ,0 ,1 ,7 ,0 ,24 ,1 ,25,75824 , 1 
71041.444,10,83 ,14 ,536 ,0 ,0 ,1 ,0 ,0 ,0 ,0 ,1 ,0 ,5 ,0 ,5,37883 , 0 
71041.482,12,83 ,5 ,785 ,0 ,0 ,1 ,0 ,1 ,0 ,0 ,2 ,0 ,4 ,1 ,5,39313 , 0 
71041.596,9,83 ,5 ,785 ,0 ,0 ,5 ,0 ,4 ,0 ,0 ,9 ,0 ,8 ,4 ,12,66367 , 0 
71041.603,5,83 ,19 ,512 ,0 ,0 ,1 ,0 ,5 ,0 ,0 ,6 ,0 ,14 ,5 ,19,63193 , 0 
71041.606,19,83 ,1 ,256 ,0 ,0 ,1 ,0 ,6 ,0 ,0 ,7 ,0 ,8 ,6 ,14,40638 , 0 
71041.696,17,83 ,6 ,781 ,0 ,0 ,8 ,4 ,4 ,0 ,0 ,16 ,0 ,9 ,5 ,14,49885 , 0 
71041.771,13,83 ,1 ,256 ,0 ,0 ,1 ,0 ,0 ,0 ,0 ,1 ,0 ,3 ,0 ,3,36400 , 0 
71041.787,3,83 ,1 ,256 ,0 ,0 ,1 ,0 ,0 ,0 ,0 ,1 ,0 ,1 ,0 ,1,25656 , 0 
71160.96,8,83 ,1 ,256 ,0 ,0 ,2 ,0 ,1 ,0 ,0 ,3 ,0 ,2 ,1 ,3,29958 , 0 
71161.078,11,83 ,5 ,785 ,0 ,0 ,2 ,0 ,0 ,0 ,0 ,2 ,0 ,3 ,0 ,3,49155 , 0 
71161.123,2,83 ,1 ,256 ,0 ,0 ,2 ,0 ,5 ,0 ,0 ,7 ,0 ,1 ,6 ,7,50107 , 0 
71161.138,6,83 ,2 ,512 ,0 ,0 ,2 ,1 ,3 ,0 ,0 ,6 ,0 ,3 ,3 ,6,63022 , 0 
71161.214,18,83 ,19 ,512 ,0 ,0 ,3 ,0 ,0 ,0 ,0 ,3 ,0 ,2 ,0 ,2,40519 , 0 
71161.236,4,83 ,8 ,513 ,0 ,0 ,1 ,1 ,0 ,0 ,0 ,2 ,0 ,4 ,0 ,4,35917 , 0 
71161.289,7,83 ,17 ,1063 ,0 ,0 ,7 ,1 ,0 ,1 ,0 ,9 ,0 ,6 ,0 ,6,52458 , 0 
71161.337,14,83 ,1 ,256 ,0 ,0 ,1 ,0 ,0 ,0 ,0 ,1 ,0 ,2 ,0 ,2,33778 , 0 
71161.35,15,83 ,9 ,1093 ,0 ,0 ,3 ,1 ,0 ,0 ,0 ,4 ,0 ,7 ,0 ,7,43005 , 0 
71161.36,20,83 ,12 ,1185 ,0 ,0 ,0 ,0 ,0 ,0 ,0 ,0 ,0 ,1 ,0 ,1,39111 , 0 
71161.36,16,83 ,2 ,512 ,0 ,0 ,1 ,1 ,0 ,1 ,0 ,3 ,0 ,10 ,0 ,10,68685 , 1 
71161.444,10,83 ,14 ,536 ,0 ,0 ,2 ,0 ,0 ,0 ,0 ,2 ,0 ,1 ,0 ,1,36704 , 0 
71161.482,12,83 ,5 ,785 ,0 ,0 ,1 ,0 ,0 ,0 ,0 ,1 ,0 ,4 ,0 ,4,43318 , 0 
71161.596,9,83 ,5 ,785 ,0 ,0 ,2 ,0 ,1 ,0 ,0 ,3 ,0 ,8 ,1 ,9,63619 , 0 
71161.602,5,83 ,19 ,512 ,0 ,0 ,1 ,0 ,1 ,0 ,0 ,2 ,0 ,5 ,1 ,6,65277 , 0 
71161.606,19,83 ,1 ,256 ,0 ,0 ,1 ,0 ,1 ,0 ,0 ,2 ,0 ,6 ,1 ,7,41671 , 0 
71161.696,17,83 ,6 ,777 ,0 ,0 ,1 ,1 ,1 ,0 ,0 ,3 ,0 ,6 ,2 ,8,47421 , 0 
71161.771,13,83 ,1 ,256 ,0 ,0 ,1 ,0 ,0 ,0 ,0 ,1 ,0 ,1 ,0 ,1,36875 , 0 
71161.787,3,83 ,1 ,256 ,0 ,0 ,3 ,0 ,0 ,0 ,0 ,3 ,0 ,2 ,0 ,2,25918 , 0 
71280.96,8,83 ,1 ,256 ,0 ,0 ,1 ,0 ,0 ,0 ,0 ,1 ,0 ,1 ,0 ,1,29799 , 0 
71281.078,11,83 ,5 ,785 ,0 ,0 ,1 ,0 ,0 ,0 ,0 ,1 ,0 ,7 ,0 ,7,46158 , 0 
71281.123,2,83 ,1 ,256 ,0 ,0 ,2 ,0 ,5 ,0 ,0 ,7 ,0 ,2 ,5 ,7,53517 , 0 
71281.138,6,83 ,2 ,512 ,0 ,0 ,2 ,1 ,3 ,0 ,0 ,6 ,0 ,3 ,3 ,6,75337 , 0 
71281.214,18,83 ,19 ,512 ,0 ,0 ,0 ,0 ,0 ,0 ,0 ,0 ,0 ,1 ,0 ,1,37629 , 0 
71281.236,4,83 ,8 ,513 ,0 ,0 ,2 ,0 ,0 ,0 ,0 ,2 ,0 ,0 ,0 ,0,34565 , 0 
71281.289,7,83 ,17 ,1046 ,0 ,0 ,3 ,2 ,0 ,0 ,0 ,5 ,0 ,7 ,0 ,7,53789 , 0 
71281.337,14,83 ,1 ,256 ,0 ,0 ,1 ,0 ,0 ,0 ,0 ,1 ,0 ,1 ,0 ,1,33564 , 0 
71281.35,15,83 ,9 ,1066 ,0 ,0 ,2 ,4 ,0 ,0 ,0 ,6 ,0 ,8 ,0 ,8,41285 , 0 
71281.36,20,83 ,12 ,1185 ,0 ,0 ,2 ,0 ,0 ,0 ,0 ,2 ,0 ,0 ,0 ,0,36234 , 0 
71281.36,16,83 ,2 ,512 ,0 ,0 ,1 ,1 ,0 ,0 ,0 ,2 ,0 ,10 ,0 ,10,75921 , 1 
71281.444,10,83 ,14 ,536 ,0 ,0 ,1 ,0 ,0 ,0 ,0 ,1 ,0 ,2 ,0 ,2,37939 , 0 
71281.482,12,83 ,5 ,785 ,0 ,0 ,1 ,0 ,0 ,0 ,0 ,1 ,0 ,1 ,0 ,1,39373 , 0 
71281.596,9,83 ,5 ,785 ,0 ,0 ,5 ,0 ,4 ,0 ,0 ,9 ,0 ,4 ,4 ,8,66519 , 0 
71281.603,5,83 ,19 ,512 ,0 ,0 ,1 ,0 ,4 ,0 ,0 ,5 ,0 ,6 ,4 ,10,63311 , 0 
71281.606,19,83 ,1 ,256 ,0 ,0 ,1 ,0 ,4 ,0 ,0 ,5 ,0 ,3 ,4 ,7,40756 , 0 
71281.696,17,83 ,6 ,774 ,0 ,0 ,2 ,1 ,2 ,0 ,0 ,5 ,0 ,3 ,2 ,5,49973 , 0 
71281.771,13,83 ,1 ,256 ,0 ,0 ,1 ,0 ,0 ,0 ,0 ,1 ,0 ,3 ,0 ,3,36487 , 0 
71281.787,3,83 ,1 ,256 ,0 ,0 ,1 ,0 ,0 ,0 ,0 ,1 ,0 ,1 ,0 ,1,25720 , 0 
71400.96,8,83 ,1 ,256 ,0 ,0 ,1 ,0 ,0 ,0 ,0 ,1 ,0 ,0 ,0 ,0,30014 , 0 
71401.078,11,83 ,5 ,785 ,0 ,0 ,1 ,0 ,0 ,0 ,0 ,1 ,0 ,4 ,0 ,4,49221 , 0 
71401.123,2,83 ,1 ,256 ,0 ,0 ,1 ,0 ,2 ,0 ,0 ,3 ,0 ,0 ,2 ,2,50182 , 0 
71401.138,6,83 ,2 ,512 ,0 ,0 ,1 ,0 ,2 ,0 ,0 ,3 ,0 ,2 ,2 ,4,63110 , 0 
71401.214,18,83 ,19 ,512 ,0 ,0 ,2 ,0 ,0 ,0 ,0 ,2 ,0 ,2 ,0 ,2,40595 , 0 
71401.236,4,83 ,8 ,513 ,0 ,0 ,1 ,0 ,0 ,0 ,0 ,1 ,0 ,1 ,0 ,1,35979 , 0 
71401.289,7,83 ,17 ,1035 ,0 ,0 ,1 ,1 ,0 ,0 ,0 ,2 ,0 ,4 ,0 ,4,52518 , 0 
71401.337,14,83 ,1 ,256 ,0 ,0 ,1 ,0 ,0 ,0 ,0 ,1 ,0 ,2 ,0 ,2,33856 , 0 
71401.35,15,83 ,9 ,1060 ,0 ,0 ,0 ,2 ,0 ,0 ,0 ,2 ,0 ,2 ,0 ,2,43063 , 0 
71401.36,20,83 ,12 ,1185 ,0 ,0 ,1 ,0 ,0 ,0 ,0 ,1 ,0 ,1 ,0 ,1,39169 , 0 
71401.36,16,83 ,2 ,512 ,0 ,0 ,1 ,0 ,0 ,0 ,0 ,1 ,0 ,3 ,0 ,3,68755 , 0 
71401.444,10,83 ,14 ,536 ,0 ,0 ,1 ,0 ,0 ,0 ,0 ,1 ,0 ,0 ,0 ,0,36767 , 0 
71401.482,12,83 ,5 ,785 ,0 ,0 ,1 ,0 ,0 ,0 ,0 ,1 ,0 ,2 ,0 ,2,43383 , 0 
71401.596,9,83 ,5 ,785 ,0 ,0 ,3 ,0 ,2 ,0 ,0 ,5 ,0 ,1 ,2 ,3,63715 , 0 
71401.602,5,83 ,19 ,512 ,0 ,0 ,2 ,0 ,2 ,0 ,0 ,4 ,0 ,5 ,2 ,7,65380 , 0 
71401.606,19,83 ,1 ,256 ,0 ,0 ,1 ,0 ,2 ,0 ,0 ,3 ,0 ,3 ,2 ,5,41761 , 0 
71401.696,17,83 ,6 ,769 ,0 ,0 ,2 ,1 ,1 ,0 ,0 ,4 ,0 ,2 ,1 ,3,47509 , 0 
71401.771,13,83 ,1 ,256 ,0 ,0 ,1 ,0 ,0 ,0 ,0 ,1 ,0 ,0 ,0 ,0,36933 , 0 
71401.787,3,83 ,1 ,256 ,0 ,0 ,1 ,0 ,0 ,0 ,0 ,1 ,0 ,1 ,0 ,1,25974 , 0 
71520.96,8,83 ,1 ,256 ,0 ,0 ,1 ,0 ,0 ,0 ,0 ,1 ,0 ,2 ,0 ,2,29856 , 0 
71521.078,11,83 ,5 ,785 ,0 ,0 ,1 ,0 ,0 ,0 ,0 ,1 ,0 ,3 ,0 ,3,46255 , 0 
71521.123,2,83 ,1 ,256 ,0 ,0 ,2 ,0 ,4 ,0 ,1 ,7 ,0 ,2 ,6 ,8,53629 , 0 
71521.138,6,83 ,2 ,512 ,0 ,0 ,2 ,1 ,1 ,1 ,1 ,6 ,0 ,4 ,3 ,7,75451 , 0 
71521.214,18,83 ,19 ,512 ,0 ,0 ,1 ,0 ,0 ,0 ,0 ,1 ,0 ,0 ,0 ,0,37688 , 0 
71521.236,4,83 ,8 ,513 ,0 ,0 ,1 ,0 ,0 ,0 ,0 ,1 ,0 ,0 ,0 ,0,34621 , 0 
71521.289,7,83 ,16 ,819 ,0 ,0 ,5 ,2 ,0 ,1 ,0 ,8 ,0 ,5 ,0 ,5,53906 , 0 
71521.337,14,83 ,1 ,256 ,0 ,0 ,1 ,0 ,0 ,0 ,0 ,1 ,0 ,4 ,0 ,4,33631 , 0 
71521.35,15,83 ,9 ,1060 ,0 ,0 ,2 ,0 ,0 ,0 ,0 ,2 ,0 ,5 ,0 ,5,41357 , 0 
71521.36,20,83 ,12 ,1185 ,0 ,0 ,2 ,0 ,0 ,0 ,0 ,2 ,0 ,1 ,0 ,1,36335 , 0 
71521.36,16,83 ,2 ,512 ,0 ,0 ,2 ,1 ,1 ,0 ,0 ,4 ,0 ,7 ,1 ,8,76014 , 0 
71521.444,10,83 ,14 ,536 ,0 ,0 ,3 ,0 ,0 ,0 ,0 ,3 ,0 ,2 ,0 ,2,38020 , 0 
71521.482,12,83 ,5 ,785 ,0 ,0 ,0 ,0 ,0 ,0 ,0 ,0 ,0 ,1 ,0 ,1,39447 , 0 
71521.596,9,83 ,5 ,785 ,0 ,0 ,1 ,0 ,0 ,0 ,0 ,1 ,0 ,6 ,0 ,6,66615 , 0 
71521.602,5,83 ,19 ,512 ,0 ,0 ,1 ,0 ,0 ,0 ,0 ,1 ,0 ,2 ,0 ,2,63434 , 0 
71521.606,19,83 ,1 ,256 ,0 ,0 ,0 ,0 ,0 ,0 ,0 ,0 ,0 ,3 ,0 ,3,40847 , 0 
71521.696,17,83 ,6 ,768 ,0 ,0 ,2 ,0 ,1 ,1 ,1 ,5 ,0 ,5 ,2 ,7,50056 , 0 
71521.771,13,83 ,1 ,256 ,0 ,0 ,1 ,0 ,0 ,0 ,0 ,1 ,0 ,2 ,0 ,2,36577 , 0 
71521.787,3,83 ,1 ,256 ,0 ,0 ,1 ,0 ,0 ,0 ,0 ,1 ,0 ,1 ,0 ,1,25773 , 0 
71640.96,8,83 ,1 ,256 ,0 ,0 ,1 ,0 ,0 ,0 ,0 ,1 ,0 ,1 ,0 ,1,30095 , 0 
71641.078,11,83 ,5 ,785 ,0 ,0 ,1 ,0 ,0 ,0 ,0 ,1 ,0 ,4 ,0 ,4,49292 , 0 
71641.123,2,83 ,1 ,256 ,0 ,0 ,1 ,0 ,1 ,0 ,0 ,2 ,0 ,0 ,1 ,1,50268 , 0 
71641.138,6,83 ,2 ,512 ,0 ,0 ,1 ,0 ,1 ,0 ,0 ,2 ,0 ,0 ,1 ,1,63187 , 0 
71641.214,18,83 ,19 ,512 ,0 ,0 ,1 ,0 ,0 ,0 ,0 ,1 ,0 ,3 ,0 ,3,40663 , 0 
71641.236,4,83 ,8 ,513 ,0 ,0 ,1 ,0 ,0 ,0 ,0 ,1 ,0 ,1 ,0 ,1,36060 , 0 
71641.289,7,83 ,16 ,819 ,0 ,0 ,2 ,0 ,0 ,0 ,0 ,2 ,0 ,3 ,0 ,3,52601 , 0 
71641.337,14,83 ,1 ,256 ,0 ,0 ,1 ,0 ,0 ,0 ,0 ,1 ,0 ,1 ,0 ,1,33923 , 0 
71641.35,15,83 ,9 ,1054 ,0 ,0 ,2 ,1 ,0 ,0 ,0 ,3 ,0 ,2 ,0 ,2,43151 , 0 
71641.36,20,83 ,12 ,1134 ,0 ,0 ,1 ,0 ,0 ,0 ,0 ,1 ,0 ,1 ,0 ,1,39227 , 0 
71641.36,16,83 ,2 ,512 ,0 ,0 ,1 ,0 ,0 ,0 ,0 ,1 ,0 ,2 ,0 ,2,68837 , 0 
71641.444,10,83 ,14 ,536 ,0 ,0 ,1 ,0 ,0 ,0 ,0 ,1 ,0 ,0 ,0 ,0,36825 , 0 
71641.482,12,83 ,5 ,785 ,0 ,0 ,3 ,0 ,0 ,0 ,0 ,3 ,0 ,0 ,0 ,0,43461 , 0 
71641.596,9,83 ,5 ,785 ,0 ,0 ,2 ,0 ,1 ,0 ,0 ,3 ,0 ,4 ,1 ,5,63807 , 0 
71641.602,5,83 ,19 ,512 ,0 ,0 ,1 ,0 ,1 ,0 ,0 ,2 ,0 ,4 ,1 ,5,65469 , 0 
71641.606,19,83 ,1 ,256 ,0 ,0 ,2 ,0 ,1 ,0 ,0 ,3 ,0 ,2 ,1 ,3,41892 , 0 
71641.696,17,83 ,6 ,790 ,0 ,0 ,1 ,1 ,0 ,0 ,0 ,2 ,0 ,2 ,0 ,2,47584 , 0 
71641.771,13,83 ,1 ,256 ,0 ,0 ,1 ,0 ,0 ,0 ,0 ,1 ,0 ,1 ,0 ,1,37023 , 0 
71641.787,3,83 ,1 ,256 ,0 ,0 ,1 ,0 ,0 ,0 ,0 ,1 ,0 ,1 ,0 ,1,26036 , 0 
71760.96,8,83 ,1 ,256 ,0 ,0 ,1 ,0 ,0 ,0 ,0 ,1 ,0 ,1 ,0 ,1,29918 , 0 
71761.078,11,83 ,5 ,785 ,0 ,0 ,1 ,0 ,0 ,0 ,0 ,1 ,0 ,1 ,0 ,1,46311 , 0 
71761.123,2,83 ,1 ,256 ,0 ,0 ,1 ,0 ,0 ,0 ,0 ,1 ,0 ,2 ,0 ,2,53700 , 0 
71761.138,6,83 ,2 ,512 ,0 ,0 ,1 ,0 ,0 ,0 ,0 ,1 ,0 ,1 ,0 ,1,75524 , 0 
71761.214,18,83 ,19 ,512 ,0 ,0 ,2 ,0 ,0 ,0 ,0 ,2 ,0 ,0 ,0 ,0,37770 , 0 
71761.236,4,83 ,8 ,513 ,0 ,0 ,1 ,0 ,0 ,0 ,0 ,1 ,0 ,2 ,0 ,2,34695 , 0 
71761.289,7,83 ,16 ,819 ,0 ,0 ,1 ,0 ,0 ,0 ,0 ,1 ,0 ,1 ,0 ,1,53965 , 0 
71761.337,14,83 ,1 ,256 ,0 ,0 ,2 ,0 ,0 ,0 ,0 ,2 ,0 ,1 ,0 ,1,33718 , 0 
71761.35,15,83 ,9 ,1054 ,0 ,0 ,1 ,0 ,0 ,0 ,0 ,1 ,0 ,1 ,0 ,1,41414 , 0 
71761.36,20,83 ,12 ,1134 ,0 ,0 ,1 ,0 ,0 ,0 ,0 ,1 ,0 ,1 ,0 ,1,36386 , 0 
71761.36,16,83 ,2 ,512 ,0 ,0 ,1 ,0 ,0 ,0 ,0 ,1 ,0 ,2 ,0 ,2,76083 , 1 
71761.444,10,83 ,14 ,536 ,0 ,0 ,1 ,0 ,0 ,0 ,0 ,1 ,0 ,0 ,0 ,0,38080 , 0 
71761.482,12,83 ,5 ,785 ,0 ,0 ,0 ,0 ,0 ,0 ,0 ,0 ,0 ,2 ,0 ,2,39501 , 0 
71761.596,9,83 ,5 ,785 ,0 ,0 ,1 ,0 ,0 ,0 ,0 ,1 ,0 ,1 ,0 ,1,66672 , 0 
71761.602,5,83 ,19 ,512 ,0 ,0 ,1 ,0 ,0 ,0 ,0 ,1 ,0 ,3 ,0 ,3,63515 , 0 
71761.606,19,83 ,1 ,256 ,0 ,0 ,1 ,0 ,0 ,0 ,0 ,1 ,0 ,2 ,0 ,2,40940 , 0 
71761.696,17,83 ,6 ,790 ,0 ,0 ,0 ,0 ,0 ,0 ,0 ,0 ,0 ,2 ,0 ,2,50130 , 0 
71761.771,13,83 ,1 ,256 ,0 ,0 ,1 ,0 ,0 ,0 ,0 ,1 ,0 ,1 ,0 ,1,36639 , 0 
71761.787,3,83 ,1 ,256 ,0 ,0 ,1 ,0 ,0 ,0 ,0 ,1 ,0 ,0 ,0 ,0,25831 , 0 
71880.96,8,83 ,1 ,256 ,0 ,0 ,0 ,0 ,0 ,0 ,0 ,0 ,0 ,2 ,0 ,2,30150 , 0 
71881.078,11,83 ,5 ,785 ,0 ,0 ,2 ,0 ,0 ,0 ,0 ,2 ,0 ,3 ,0 ,3,49378 , 0 
71881.123,2,83 ,1 ,256 ,0 ,0 ,1 ,0 ,0 ,0 ,0 ,1 ,0 ,2 ,0 ,2,50347 , 0 
71881.138,6,83 ,2 ,512 ,0 ,0 ,2 ,0 ,0 ,0 ,0 ,2 ,0 ,1 ,0 ,1,63264 , 0 
71881.214,18,83 ,19 ,512 ,0 ,0 ,1 ,0 ,0 ,0 ,0 ,1 ,0 ,2 ,0 ,2,40742 , 0 
71881.236,4,83 ,8 ,513 ,0 ,0 ,2 ,0 ,0 ,0 ,0 ,2 ,0 ,0 ,0 ,0,36120 , 0 
71881.289,7,83 ,16 ,819 ,0 ,0 ,1 ,0 ,0 ,0 ,0 ,1 ,0 ,2 ,0 ,2,52704 , 0 
71881.337,14,83 ,1 ,256 ,0 ,0 ,2 ,0 ,0 ,0 ,0 ,2 ,0 ,2 ,0 ,2,33988 , 0 
71881.35,15,83 ,9 ,1054 ,0 ,0 ,2 ,0 ,0 ,0 ,0 ,2 ,0 ,2 ,0 ,2,43237 , 0 
71881.36,20,83 ,5 ,793 ,0 ,0 ,2 ,0 ,0 ,1 ,0 ,3 ,0 ,2 ,0 ,2,39332 , 0 
71881.36,16,83 ,2 ,512 ,0 ,0 ,1 ,0 ,0 ,0 ,0 ,1 ,0 ,3 ,0 ,3,68907 , 1 
71881.444,10,83 ,14 ,522 ,0 ,0 ,1 ,0 ,0 ,0 ,0 ,1 ,0 ,3 ,0 ,3,36894 , 0 
71881.482,12,83 ,5 ,787 ,0 ,0 ,1 ,1 ,0 ,0 ,1 ,3 ,0 ,3 ,1 ,4,43575 , 0 
71881.596,9,83 ,5 ,785 ,0 ,0 ,1 ,0 ,0 ,0 ,0 ,1 ,0 ,3 ,0 ,3,63897 , 0 
71881.602,5,83 ,19 ,512 ,0 ,0 ,1 ,0 ,1 ,0 ,1 ,3 ,0 ,3 ,2 ,5,65599 , 0 
71881.606,19,83 ,1 ,256 ,0 ,0 ,1 ,0 ,1 ,0 ,1 ,3 ,0 ,2 ,2 ,4,41971 , 0 
71881.696,17,83 ,6 ,783 ,0 ,0 ,2 ,0 ,0 ,0 ,0 ,2 ,0 ,1 ,0 ,1,47649 , 0 
71881.771,13,83 ,1 ,256 ,0 ,0 ,1 ,0 ,0 ,0 ,0 ,1 ,0 ,3 ,0 ,3,37097 , 0 
71881.787,3,83 ,1 ,256 ,0 ,0 ,2 ,0 ,0 ,0 ,0 ,2 ,0 ,1 ,0 ,1,26094 , 0 
72000.96,8,83 ,1 ,256 ,0 ,0 ,2 ,0 ,0 ,0 ,0 ,2 ,0 ,2 ,0 ,2,30000 , 0 
72001.078,11,83 ,5 ,785 ,0 ,0 ,1 ,0 ,0 ,0 ,0 ,1 ,0 ,8 ,0 ,8,46385 , 0 
72001.123,2,83 ,1 ,256 ,0 ,0 ,1 ,0 ,0 ,0 ,0 ,1 ,0 ,2 ,0 ,2,53797 , 0 
72001.138,6,83 ,2 ,512 ,0 ,0 ,1 ,0 ,0 ,0 ,0 ,1 ,0 ,2 ,0 ,2,75589 , 0 
72001.214,18,83 ,19 ,512 ,0 ,0 ,1 ,0 ,0 ,0 ,0 ,1 ,0 ,0 ,0 ,0,37832 , 0 
72001.236,4,83 ,8 ,512 ,0 ,0 ,1 ,0 ,0 ,0 ,0 ,1 ,0 ,3 ,0 ,3,34762 , 0 
72001.289,7,83 ,16 ,819 ,0 ,0 ,2 ,0 ,0 ,0 ,0 ,2 ,0 ,1 ,0 ,1,54039 , 0 
72001.337,14,83 ,1 ,256 ,0 ,0 ,2 ,0 ,1 ,0 ,0 ,3 ,0 ,1 ,1 ,2,33800 , 0 
72001.35,15,83 ,9 ,1054 ,0 ,0 ,1 ,0 ,0 ,0 ,0 ,1 ,0 ,1 ,0 ,1,41484 , 0 
72001.36,20,83 ,5 ,793 ,0 ,0 ,6 ,1 ,0 ,0 ,0 ,7 ,0 ,1 ,0 ,1,36485 , 0 
72001.36,16,83 ,2 ,512 ,0 ,0 ,1 ,0 ,0 ,0 ,0 ,1 ,0 ,2 ,0 ,2,76155 , 1 
72001.444,10,83 ,14 ,520 ,0 ,0 ,1 ,1 ,0 ,0 ,0 ,2 ,0 ,1 ,0 ,1,38142 , 0 
72001.482,12,83 ,5 ,787 ,0 ,0 ,1 ,0 ,0 ,1 ,0 ,2 ,0 ,6 ,0 ,6,39588 , 0 
72001.596,9,83 ,5 ,785 ,0 ,0 ,1 ,0 ,0 ,0 ,0 ,1 ,0 ,2 ,0 ,2,66748 , 0 
72001.602,5,83 ,19 ,512 ,0 ,0 ,1 ,0 ,1 ,0 ,0 ,2 ,0 ,5 ,2 ,7,63610 , 0 
72001.606,19,83 ,1 ,256 ,0 ,0 ,1 ,0 ,1 ,0 ,0 ,2 ,0 ,2 ,1 ,3,41058 , 0 
72001.696,17,83 ,6 ,779 ,0 ,0 ,1 ,0 ,0 ,0 ,0 ,1 ,0 ,3 ,0 ,3,50200 , 0 
72001.771,13,83 ,1 ,256 ,0 ,0 ,1 ,0 ,0 ,0 ,0 ,1 ,0 ,0 ,0 ,0,36718 , 0 
72001.787,3,83 ,1 ,256 ,0 ,0 ,1 ,0 ,0 ,0 ,0 ,1 ,0 ,0 ,0 ,0,25898 , 0 

